Rk,Player,Pos,Age,Tm,G,GS,MP,FG,FGA,FG%,3P,3PA,3P%,2P,2PA,2P%,eFG%,FT,FTA,FT%,ORB,DRB,TRB,AST,STL,BLK,TOV,PF,PTS
1,Tariq Abdul-Wahad\abdulta01,SG,27,TOT,24,12,441,55,147,.374,1,2,.500,54,145,.372,.378,24,33,.727,41,43,84,24,20,10,27,56,135
1,Tariq Abdul-Wahad\abdulta01,SG,27,DEN,20,12,417,55,145,.379,1,2,.500,54,143,.378,.383,24,32,.750,39,39,78,22,18,9,24,51,135
1,Tariq Abdul-Wahad\abdulta01,SG,27,DAL,4,0,24,0,2,.000,0,0,,0,2,.000,.000,0,1,.000,2,4,6,2,2,1,3,5,0
2,Shareef Abdur-Rahim\abdursh01,PF,25,ATL,77,77,2980,598,1297,.461,21,70,.300,577,1227,.470,.469,419,523,.801,198,498,696,239,98,81,250,214,1636
3,Courtney Alexander\alexaco02,SG,24,WAS,56,28,1325,223,474,.470,5,18,.278,218,456,.478,.476,98,121,.810,43,105,148,86,35,7,60,113,549
4,Victor Alexander\alexavi01,C,32,DET,15,0,97,18,51,.353,0,2,.000,18,49,.367,.353,4,8,.500,7,22,29,6,0,1,5,6,40
5,Malik Allen\allenma01,PF,23,MIA,12,2,161,22,51,.431,0,1,.000,22,50,.440,.431,8,10,.800,15,23,38,5,3,8,2,16,52
6,Ray Allen*\allenra02,SG,26,MIL,69,67,2525,530,1148,.462,229,528,.434,301,620,.485,.561,214,245,.873,81,231,312,271,88,18,159,157,1503
7,Rafer Alston\alstora01,PG,25,MIL,50,7,600,66,191,.346,27,71,.380,39,120,.325,.416,18,29,.621,10,62,72,143,32,2,40,42,177
8,John Amaechi\amaecjo01,PF,31,UTA,54,0,586,54,166,.325,0,0,,54,166,.325,.325,67,105,.638,52,57,109,29,7,10,55,64,175
9,Chris Andersen\anderch01,C,23,DEN,24,1,262,25,74,.338,0,4,.000,25,70,.357,.338,22,28,.786,38,38,76,7,7,28,13,35,72
10,Derek Anderson\anderde01,SG,27,POR,70,27,1860,247,612,.404,85,228,.373,162,384,.422,.473,178,208,.856,47,142,189,216,68,8,87,113,757
11,Kenny Anderson\anderke01,PG,31,BOS,76,76,2430,312,716,.436,9,33,.273,303,683,.444,.442,98,132,.742,57,218,275,403,141,10,119,210,731
12,Nick Anderson\anderni01,SG,34,MEM,15,0,219,21,76,.276,13,48,.271,8,28,.286,.362,5,9,.556,1,32,33,14,6,6,14,17,60
13,Shandon Anderson\andersh01,SG,28,NYK,82,6,1596,149,373,.399,39,141,.277,110,232,.474,.452,74,107,.692,57,192,249,76,48,15,97,134,411
14,Greg Anthony\anthogr01,PG,34,TOT,60,38,1514,183,475,.385,48,163,.294,135,312,.433,.436,60,91,.659,22,110,132,282,77,5,94,114,474
14,Greg Anthony\anthogr01,PG,34,CHI,36,35,961,113,287,.394,29,90,.322,84,197,.426,.444,47,70,.671,16,72,88,203,49,4,58,72,302
14,Greg Anthony\anthogr01,PG,34,MIL,24,3,553,70,188,.372,19,73,.260,51,115,.443,.423,13,21,.619,6,38,44,79,28,1,36,42,172
15,Gilbert Arenas\arenagi01,PG,20,GSW,47,30,1155,174,384,.453,39,113,.345,135,271,.498,.504,124,160,.775,41,91,132,174,69,11,97,115,511
16,Brandon Armstrong\armstbr01,SG,21,NJN,35,0,196,27,85,.318,5,17,.294,22,68,.324,.347,5,10,.500,10,6,16,8,7,1,8,26,64
17,Darrell Armstrong\armstda01,PG,33,ORL,82,79,2730,347,828,.419,139,398,.349,208,430,.484,.503,182,205,.888,83,236,319,453,157,10,175,166,1015
18,Carlos Arroyo\arroyca01,PG,22,TOT,37,1,371,49,111,.441,0,2,.000,49,109,.450,.441,13,18,.722,12,28,40,70,11,1,23,30,111
18,Carlos Arroyo\arroyca01,PG,22,TOR,17,0,96,13,29,.448,0,0,,13,29,.448,.448,4,6,.667,3,9,12,21,6,0,12,12,30
18,Carlos Arroyo\arroyca01,PG,22,DEN,20,1,275,36,82,.439,0,2,.000,36,80,.450,.439,9,12,.750,9,19,28,49,5,1,11,18,81
19,Chucky Atkins\atkinch01,PG,27,DET,79,62,2285,368,790,.466,138,336,.411,230,454,.507,.553,83,120,.692,31,127,158,263,72,11,128,177,957
20,Stacey Augmon\augmost01,SG,33,CHH,77,3,1319,140,328,.427,0,3,.000,140,325,.431,.427,77,101,.762,59,166,225,103,56,12,54,115,357
21,Isaac Austin\austiis01,C,32,MEM,21,8,307,36,92,.391,0,3,.000,36,89,.404,.391,4,4,1.000,11,60,71,13,9,5,11,36,76
22,William Avery\averywi01,PG,22,MIN,28,0,258,26,90,.289,6,35,.171,20,55,.364,.322,13,19,.684,4,20,24,36,7,0,19,17,71
23,Dalibor Bagarić\bagarda01,C,21,CHI,50,0,638,72,178,.404,0,1,.000,72,177,.407,.404,41,70,.586,55,107,162,23,17,24,46,108,185
24,Vin Baker\bakervi01,C,30,SEA,55,41,1710,315,649,.485,1,8,.125,314,641,.490,.486,143,226,.633,168,182,350,72,22,36,127,197,774
25,Erick Barkley\barkler01,PG,23,POR,19,4,228,24,68,.353,1,7,.143,23,61,.377,.360,9,10,.900,5,13,18,34,17,1,12,29,58
26,Dana Barros\barroda01,PG,34,DET,29,20,582,74,192,.385,24,71,.338,50,121,.413,.448,21,27,.778,1,56,57,78,14,2,33,37,193
27,Brent Barry\barrybr01,SG,30,SEA,81,81,3040,401,790,.508,164,387,.424,237,403,.588,.611,198,234,.846,58,383,441,426,147,37,165,182,1164
28,Jon Barry\barryjo01,SG,32,DET,82,6,1985,255,522,.489,121,258,.469,134,264,.508,.604,108,116,.931,42,192,234,274,94,20,111,134,739
29,Mengke Bateer\bateeme01,C,26,DEN,27,10,408,53,132,.402,4,12,.333,49,120,.408,.417,29,37,.784,32,64,96,22,10,5,32,94,139
30,Tony Battie\battito01,C,25,BOS,74,73,1819,211,390,.541,0,2,.000,211,388,.544,.541,88,130,.677,184,297,481,35,60,67,51,219,510
31,Shane Battier\battish01,SF,23,MEM,78,78,3097,412,961,.429,103,276,.373,309,685,.451,.482,198,283,.700,180,238,418,216,121,81,155,215,1125
32,Charlie Bell\bellch01,SG,22,TOT,7,0,44,3,11,.273,0,6,.000,3,5,.600,.273,2,2,1.000,2,3,5,2,0,0,5,3,8
32,Charlie Bell\bellch01,SG,22,PHO,5,0,42,3,11,.273,0,6,.000,3,5,.600,.273,2,2,1.000,2,2,4,2,0,0,5,3,8
32,Charlie Bell\bellch01,SG,22,DAL,2,0,2,0,0,,0,0,,0,0,,,0,0,,0,1,1,0,0,0,0,0,0
33,Raja Bell\bellra01,SG,25,PHI,74,12,890,103,240,.429,12,44,.273,91,196,.464,.454,36,48,.750,31,80,111,71,21,4,48,109,254
34,Jonathan Bender\bendejo01,SF,21,IND,78,17,1647,198,460,.430,45,125,.360,153,335,.457,.479,140,181,.773,64,180,244,62,19,49,96,147,581
35,Travis Best\besttr01,PG,29,TOT,74,21,1747,228,518,.440,21,59,.356,207,459,.451,.460,104,116,.897,20,131,151,324,89,7,99,173,581
35,Travis Best\besttr01,PG,29,IND,44,3,954,116,264,.439,13,34,.382,103,230,.448,.464,57,65,.877,10,60,70,175,57,6,59,101,302
35,Travis Best\besttr01,PG,29,CHI,30,18,793,112,254,.441,8,25,.320,104,229,.454,.457,47,51,.922,10,71,81,149,32,1,40,72,279
36,Mike Bibby\bibbymi01,PG,23,SAC,80,80,2659,446,985,.453,51,138,.370,395,847,.466,.479,155,193,.803,37,185,222,403,87,15,134,133,1098
37,Chauncey Billups\billuch01,PG,25,MIN,82,54,2355,348,823,.423,124,315,.394,224,508,.441,.498,207,234,.885,35,191,226,450,66,17,138,169,1027
38,Mookie Blaylock\blaylmo01,PG,34,GSW,35,0,599,50,146,.342,15,42,.357,35,104,.337,.394,4,8,.500,8,44,52,114,24,4,37,20,119
39,Corie Blount\blounco01,PF,33,PHI,72,21,1426,115,251,.458,0,1,.000,115,250,.460,.458,29,45,.644,149,219,368,44,49,26,52,176,259
40,Mark Blount\blounma01,C,26,BOS,44,0,415,32,76,.421,0,0,,32,76,.421,.421,30,37,.811,26,59,85,10,16,19,23,59,94
41,Calvin Booth\boothca01,C,25,SEA,15,15,279,35,82,.427,0,0,,35,82,.427,.427,23,24,.958,20,34,54,16,6,13,16,47,93
42,Ruben Boumtje-Boumtje\boumtru01,C,23,POR,33,1,245,13,32,.406,0,0,,13,32,.406,.406,13,25,.520,21,34,55,4,3,16,14,38,39
43,Cal Bowdler\bowdlca01,PF,24,ATL,52,0,585,61,174,.351,1,5,.200,60,169,.355,.353,39,47,.830,38,72,110,11,18,15,11,64,162
44,Bruce Bowen\bowenbr01,SF,30,SAS,59,59,1699,155,398,.389,56,148,.378,99,250,.396,.460,46,96,.479,42,120,162,88,62,25,66,116,412
45,Ryan Bowen\bowenry01,SF,26,DEN,75,21,1686,147,307,.479,1,12,.083,146,295,.495,.480,69,92,.750,134,165,299,52,75,41,41,171,364
46,Ira Bowman\bowmair01,SG,28,PHI,3,0,29,5,7,.714,0,1,.000,5,6,.833,.714,0,0,,0,1,1,1,2,0,0,3,10
47,Earl Boykins\boykiea01,PG,25,LAC,68,2,761,110,275,.400,13,42,.310,97,233,.416,.424,47,61,.770,27,27,54,145,20,2,44,44,280
48,Michael Bradley\bradlmi01,PF,22,TOR,26,0,118,13,25,.520,0,2,.000,13,23,.565,.520,4,8,.500,7,17,24,3,0,6,6,10,30
49,Shawn Bradley\bradlsh01,C,29,DAL,53,16,757,78,163,.479,0,1,.000,78,162,.481,.479,59,64,.922,53,123,176,20,28,64,25,128,215
50,Elton Brand\brandel01,PF,22,LAC,80,80,3020,532,1010,.527,0,0,,532,1010,.527,.527,389,524,.742,396,529,925,191,80,163,173,254,1453
51,Terrell Brandon\brandte01,PG,31,MIN,32,28,962,155,365,.425,4,23,.174,151,342,.442,.430,83,84,.988,17,76,93,264,52,6,43,49,397
52,Jamison Brewer\breweja01,SG,21,IND,13,0,43,2,5,.400,0,1,.000,2,4,.500,.400,0,0,,2,6,8,9,2,0,3,3,4
53,Primož Brezec\brezepr01,C,22,IND,22,4,160,14,29,.483,0,0,,14,29,.483,.483,15,25,.600,16,12,28,6,0,7,6,28,43
54,Chucky Brown\brownch01,SF,33,SAC,18,0,92,10,27,.370,0,0,,10,27,.370,.370,1,2,.500,10,23,33,6,2,4,5,12,21
55,Damone Brown\brownda02,SF,22,PHI,17,0,67,8,21,.381,0,1,.000,8,20,.400,.381,7,8,.875,2,2,4,2,1,1,9,11,23
56,Dee Brown\brownde01,PG,33,ORL,7,0,65,3,20,.150,1,12,.083,2,8,.250,.175,0,0,,0,9,9,2,3,1,4,4,7
57,Ernest Brown\browner01,C,22,MIA,3,0,21,1,6,.167,0,0,,1,6,.167,.167,1,4,.250,1,5,6,0,0,1,3,4,3
58,Kedrick Brown\brownke01,SF,20,BOS,29,5,245,23,70,.329,5,27,.185,18,43,.419,.364,12,20,.600,11,39,50,15,18,7,7,18,63
59,Kwame Brown\brownkw01,PF,19,WAS,57,3,817,94,243,.387,0,1,.000,94,242,.388,.387,70,99,.707,63,135,198,43,16,26,43,105,258
60,P.J. Brown\brownpj01,C,32,CHH,80,80,2563,250,527,.474,0,0,,250,527,.474,.474,169,197,.858,273,513,786,107,59,78,85,222,669
61,Randy Brown\brownra02,PG,33,BOS,1,0,6,0,1,.000,0,0,,0,1,.000,.000,0,0,,0,0,0,2,0,1,0,1,0
62,Tierre Brown\brownti01,SG,22,HOU,40,1,403,49,115,.426,4,12,.333,45,103,.437,.443,21,28,.750,12,30,42,70,19,3,40,26,123
63,Rick Brunson\brunsri01,PG,29,POR,59,2,520,45,113,.398,6,11,.545,39,102,.382,.425,29,41,.707,23,45,68,114,25,2,47,51,125
64,Kobe Bryant*\bryanko01,SG,23,LAL,80,80,3063,749,1597,.469,33,132,.250,716,1465,.489,.479,488,589,.829,112,329,441,438,118,35,223,228,2019
65,Mark Bryant\bryanma01,PF,36,SAS,30,3,206,25,55,.455,0,0,,25,55,.455,.455,6,8,.750,25,19,44,10,7,2,6,38,56
66,Greg Buckner\buckngr01,SG,25,DAL,44,16,885,104,198,.525,5,16,.313,99,182,.544,.538,40,58,.690,67,106,173,48,31,19,27,124,253
67,Jud Buechler\buechju01,SF,33,TOT,66,2,684,44,118,.373,21,60,.350,23,58,.397,.462,2,4,.500,29,87,116,32,21,8,15,53,111
67,Jud Buechler\buechju01,SF,33,PHO,6,0,54,2,6,.333,2,6,.333,0,0,,.500,0,0,,2,6,8,3,1,0,1,7,6
67,Jud Buechler\buechju01,SF,33,ORL,60,2,630,42,112,.375,19,54,.352,23,58,.397,.460,2,4,.500,27,81,108,29,20,8,14,46,105
68,Rodney Buford\buforro01,SG,24,MEM,63,21,1769,258,593,.435,17,70,.243,241,523,.461,.449,58,80,.725,52,220,272,71,42,12,63,110,591
69,Matt Bullard\bullama01,PF,34,CHH,31,0,350,39,115,.339,16,57,.281,23,58,.397,.409,11,12,.917,10,37,47,16,2,2,12,29,105
70,Mitchell Butler\butlemi02,SG,31,POR,11,0,90,10,23,.435,1,3,.333,9,20,.450,.457,8,12,.667,6,8,14,5,0,1,5,10,29
71,Jason Caffey\caffeja01,PF,28,MIL,23,0,283,36,72,.500,0,1,.000,36,71,.507,.500,27,43,.628,24,26,50,12,4,5,19,39,99
72,Marcus Camby\cambyma01,C,27,NYK,29,29,1007,130,290,.448,0,1,.000,130,289,.450,.448,62,99,.626,89,233,322,33,34,50,42,107,322
73,Elden Campbell\campbel01,PF,33,CHH,77,74,2156,384,794,.484,0,2,.000,384,792,.485,.484,306,384,.797,133,397,530,102,60,137,138,264,1074
74,Brian Cardinal\cardibr01,PF,24,DET,8,0,43,6,13,.462,3,7,.429,3,6,.500,.577,2,2,1.000,2,4,6,2,1,0,0,5,17
75,Anthony Carter\cartean01,PG,26,MIA,46,18,1050,89,260,.342,1,19,.053,88,241,.365,.344,19,36,.528,19,98,117,214,50,3,72,85,198
76,Vince Carter\cartevi01,SG,25,TOR,60,60,2385,559,1307,.428,121,313,.387,438,994,.441,.474,245,307,.798,138,175,313,239,94,43,154,191,1484
77,Sam Cassell\cassesa01,PG,32,MIL,74,73,2605,554,1197,.463,71,204,.348,483,993,.486,.492,282,328,.860,54,258,312,493,90,12,177,208,1461
78,Kelvin Cato\catoke01,C,27,HOU,75,73,1917,190,326,.583,0,1,.000,190,325,.585,.583,113,194,.582,176,349,525,29,40,95,53,208,493
79,Tyson Chandler\chandty01,C,19,CHI,71,31,1389,151,304,.497,0,0,,151,304,.497,.497,134,222,.604,114,229,343,54,28,93,99,179,436
80,Calbert Cheaney\cheanca01,SG,30,DEN,68,47,1631,224,466,.481,0,4,.000,224,462,.485,.481,46,67,.687,57,183,240,110,34,21,70,156,494
81,Chris Childs\childch01,PG,34,TOR,69,4,1576,97,296,.328,33,120,.275,64,176,.364,.383,58,71,.817,18,136,154,351,56,5,123,177,285
82,Doug Christie\chrisdo01,SG,31,SAC,81,81,2798,338,735,.460,90,256,.352,248,479,.518,.521,206,242,.851,74,300,374,340,160,25,164,209,972
83,Keon Clark\clarkke01,C,26,TOR,81,31,2185,380,775,.490,0,5,.000,380,770,.494,.490,155,230,.674,182,421,603,88,58,122,140,258,915
84,Speedy Claxton\claxtsp01,PG,23,PHI,67,18,1528,181,452,.400,4,33,.121,177,419,.422,.405,114,136,.838,46,114,160,198,95,6,95,145,480
85,Mateen Cleaves\cleavma01,PG,24,SAC,32,0,153,30,68,.441,2,8,.250,28,60,.467,.456,8,9,.889,1,7,8,25,7,0,27,9,70
86,Derrick Coleman\colemde01,PF,34,PHI,58,58,2080,331,735,.450,28,83,.337,303,652,.465,.469,185,227,.815,167,342,509,98,42,51,119,158,875
87,Bimbo Coles\colesbi01,PG,33,CLE,47,1,693,56,146,.384,4,20,.200,52,126,.413,.397,33,37,.892,12,43,55,107,13,4,31,59,149
88,Jason Collier\collija02,C,24,HOU,25,2,365,41,95,.432,0,1,.000,41,94,.436,.432,24,32,.750,31,51,82,9,6,4,13,40,106
89,Jarron Collins\collija03,C,23,UTA,70,68,1440,158,343,.461,0,1,.000,158,342,.462,.461,134,181,.740,138,158,296,58,29,22,56,234,450
90,Jason Collins\collija04,C,23,NJN,77,9,1407,117,278,.421,1,2,.500,116,276,.420,.423,115,164,.701,132,169,301,81,29,47,72,173,350
91,Chris Crawford\crawfch01,PF,26,ATL,7,4,131,21,45,.467,0,1,.000,21,44,.477,.467,11,15,.733,9,16,25,5,2,5,10,21,53
92,Jamal Crawford\crawfja01,PG,21,CHI,23,6,481,89,187,.476,26,58,.448,63,129,.488,.545,10,13,.769,5,29,34,55,18,5,32,18,214
93,Joe Crispin\crispjo01,PG,22,TOT,21,0,156,26,68,.382,15,39,.385,11,29,.379,.493,12,13,.923,2,9,11,26,5,0,10,10,79
93,Joe Crispin\crispjo01,PG,22,LAL,6,0,27,3,12,.250,0,4,.000,3,8,.375,.250,4,5,.800,0,1,1,2,1,0,1,2,10
93,Joe Crispin\crispjo01,PG,22,PHO,15,0,129,23,56,.411,15,35,.429,8,21,.381,.545,8,8,1.000,2,8,10,24,4,0,9,8,69
94,Austin Croshere\croshau01,PF,26,IND,76,1,1286,185,448,.413,49,145,.338,136,303,.449,.468,97,114,.851,74,220,294,77,26,29,67,106,516
95,John Crotty\crottjo01,PG,32,UTA,41,0,802,98,208,.471,31,69,.449,67,139,.482,.546,57,66,.864,16,59,75,141,19,1,51,77,284
96,Vonteego Cummings\cummivo01,PG,25,PHI,58,1,501,78,187,.417,12,46,.261,66,141,.468,.449,24,32,.750,14,38,52,60,18,5,36,53,192
97,Dell Curry\curryde01,SG,37,TOR,56,4,886,141,347,.406,45,131,.344,96,216,.444,.471,33,37,.892,23,58,81,61,22,6,41,50,360
98,Eddy Curry\curryed01,C,19,CHI,72,31,1150,189,377,.501,0,0,,189,377,.501,.501,105,160,.656,111,161,272,25,16,53,69,173,483
99,Michael Curry\currymi01,SG,33,DET,82,75,1912,125,276,.453,7,26,.269,118,250,.472,.466,72,91,.791,15,153,168,127,47,10,60,207,329
100,Samuel Dalembert\dalemsa01,C,20,PHI,34,0,177,22,50,.440,0,0,,22,50,.440,.440,7,18,.389,25,43,68,5,6,13,14,30,51
101,Erick Dampier\dampier01,C,26,GSW,73,46,1740,209,480,.435,0,0,,209,480,.435,.435,136,211,.645,167,220,387,87,17,167,156,235,554
102,Antonio Daniels\daniean01,SG,26,SAS,82,13,2175,269,612,.440,57,196,.291,212,416,.510,.486,158,210,.752,23,153,176,228,48,12,70,104,753
103,Antonio Davis\davisan01,PF,33,TOR,77,77,2978,410,963,.426,0,1,.000,410,962,.426,.426,293,358,.818,254,486,740,155,54,83,159,225,1113
104,Baron Davis\davisba01,PG,22,CHH,82,82,3318,559,1341,.417,170,478,.356,389,863,.451,.480,196,338,.580,93,256,349,698,172,47,246,241,1484
105,Dale Davis\davisda01,C,32,POR,78,77,2447,296,580,.510,0,0,,296,580,.510,.510,150,212,.708,262,426,688,96,62,83,62,193,742
106,Emanual Davis\davisem01,PG,33,ATL,28,20,774,70,198,.354,29,85,.341,41,113,.363,.427,16,18,.889,19,55,74,68,27,5,52,68,185
107,Hubert Davis\davishu01,SG,31,WAS,51,17,1231,146,326,.448,57,126,.452,89,200,.445,.535,16,21,.762,7,70,77,107,28,3,44,58,365
108,Ricky Davis\davisri01,SF,22,CLE,82,8,1954,376,781,.481,11,35,.314,365,746,.489,.488,196,248,.790,63,180,243,178,69,23,148,145,959
109,Andrew DeClercq\declean01,C,28,ORL,61,14,633,67,149,.450,0,0,,67,149,.450,.450,28,50,.560,74,89,163,22,23,24,34,130,162
110,Vinny Del Negro\delnevi01,PG,35,PHO,2,0,6,1,4,.250,0,0,,1,4,.250,.250,0,0,,0,0,0,2,0,0,0,0,2
111,Tony Delk\delkto01,SG,28,TOT,63,17,1447,226,588,.384,67,214,.313,159,374,.425,.441,78,97,.804,58,145,203,132,53,10,59,98,597
111,Tony Delk\delkto01,SG,28,PHO,41,1,877,166,416,.399,47,147,.320,119,269,.442,.456,56,67,.836,38,86,124,81,31,4,40,60,435
111,Tony Delk\delkto01,SG,28,BOS,22,16,570,60,172,.349,20,67,.299,40,105,.381,.407,22,30,.733,20,59,79,51,22,6,19,38,162
112,Derrick Dial\dialde01,SG,26,TOT,32,0,299,41,120,.342,1,11,.091,40,109,.367,.346,18,24,.750,14,42,56,35,10,4,16,13,101
112,Derrick Dial\dialde01,SG,26,NJN,25,0,249,30,94,.319,0,7,.000,30,87,.345,.319,13,18,.722,12,33,45,31,8,4,13,12,73
112,Derrick Dial\dialde01,SG,26,TOR,7,0,50,11,26,.423,1,4,.250,10,22,.455,.442,5,6,.833,2,9,11,4,2,0,3,1,28
113,Michael Dickerson\dickemi01,SG,26,MEM,4,4,124,15,48,.313,8,21,.381,7,27,.259,.396,5,6,.833,3,9,12,9,3,1,8,12,43
114,DeSagana Diop\diopde01,C,20,CLE,18,1,109,12,29,.414,0,0,,12,29,.414,.414,1,5,.200,5,12,17,5,1,10,12,19,25
115,Vlade Divac*\divacvl01,C,33,SAC,80,80,2420,338,716,.472,3,13,.231,335,703,.477,.474,209,340,.615,205,466,671,297,79,94,158,229,888
116,Michael Doleac\doleami01,C,24,CLE,42,15,705,78,187,.417,0,0,,78,187,.417,.417,38,46,.826,47,121,168,25,15,11,37,98,194
117,Keyon Dooling\doolike01,PG,21,LAC,14,0,155,22,57,.386,4,14,.286,18,43,.419,.421,10,12,.833,0,3,3,12,4,3,10,20,58
118,Bryce Drew\drewbr01,PG,27,CHH,61,0,774,78,182,.429,31,73,.425,47,109,.431,.514,23,29,.793,14,58,72,101,32,2,33,49,210
119,Predrag Drobnjak\drobnpr01,C,26,SEA,64,12,1174,191,414,.461,0,2,.000,191,412,.464,.461,55,73,.753,75,144,219,51,20,31,51,109,437
120,Chris Dudley\dudlech02,C,36,POR,43,2,327,20,50,.400,0,2,.000,20,48,.417,.400,8,15,.533,27,53,80,13,3,14,14,42,48
121,Tim Duncan*\duncati01,PF,25,SAS,82,82,3329,764,1504,.508,1,10,.100,763,1494,.511,.508,560,701,.799,268,774,1042,307,61,203,263,217,2089
122,Howard Eisley\eisleho01,PG,29,NYK,39,0,609,59,175,.337,14,58,.241,45,117,.385,.377,39,49,.796,9,40,49,100,24,3,53,55,171
123,Obinna Ekezie\ekeziob01,PF,26,LAC,29,1,152,13,39,.333,0,0,,13,39,.333,.333,28,40,.700,12,22,34,3,2,6,10,16,54
124,LaPhonso Ellis\ellisla01,SF,31,MIA,66,14,1684,189,452,.418,38,124,.306,151,328,.460,.460,53,84,.631,107,180,287,56,30,37,73,196,469
125,Evan Eschmeyer\eschmev01,C,26,DAL,31,6,299,21,50,.420,0,0,,21,50,.420,.420,20,33,.606,35,63,98,9,10,9,16,60,62
126,Maurice Evans\evansma01,SG,23,MIN,10,0,45,9,19,.474,0,3,.000,9,16,.563,.474,3,4,.750,3,1,4,4,0,0,2,9,21
127,Patrick Ewing*\ewingpa01,C,39,ORL,65,4,901,148,333,.444,0,1,.000,148,332,.446,.444,94,134,.701,60,203,263,35,22,45,65,129,390
128,Danny Ferry\ferryda01,SF,35,SAS,50,2,799,76,177,.429,43,99,.434,33,78,.423,.551,34,36,.944,15,75,90,48,16,9,22,70,229
129,Michael Finley\finlemi01,SF,28,DAL,69,69,2754,569,1228,.463,76,224,.339,493,1004,.491,.494,210,251,.837,90,270,360,230,65,25,117,144,1424
130,Derek Fisher\fishede01,PG,27,LAL,70,35,1974,274,666,.411,144,349,.413,130,317,.410,.520,94,111,.847,15,131,146,181,66,9,62,121,786
131,Marcus Fizer\fizerma01,PF,23,CHI,76,20,1963,371,848,.438,7,41,.171,364,807,.451,.442,189,283,.668,128,299,427,120,49,24,131,186,938
132,Isaac Fontaine\fontais01,SG,26,MEM,6,0,75,3,14,.214,1,5,.200,2,9,.222,.250,4,6,.667,0,5,5,4,0,0,4,6,11
133,Alton Ford\fordal02,PF,20,PHO,53,0,452,61,118,.517,0,0,,61,118,.517,.517,42,57,.737,32,75,107,7,6,7,32,99,164
134,Joseph Forte\fortejo01,SG,20,BOS,8,0,39,1,12,.083,0,3,.000,1,9,.111,.083,4,4,1.000,1,5,6,6,2,0,3,1,6
135,Danny Fortson\fortsda01,PF,25,GSW,77,76,2216,309,722,.428,1,4,.250,308,718,.429,.429,245,308,.795,290,609,899,127,44,17,160,255,864
136,Greg Foster\fostegr01,PF,33,MIL,6,0,24,2,9,.222,0,4,.000,2,5,.400,.222,3,4,.750,0,8,8,1,0,0,0,4,7
137,Jeff Foster\fosteje01,C,25,IND,82,48,1786,177,394,.449,2,15,.133,175,379,.462,.452,111,182,.610,206,350,556,70,71,38,79,232,467
138,Antonis Fotsis\fotsian01,PF,20,MEM,28,1,320,42,104,.404,7,23,.304,35,81,.432,.438,17,20,.850,25,37,62,10,9,11,21,22,108
139,Tremaine Fowlkes\fowlktr01,SF,25,LAC,22,17,343,25,64,.391,0,0,,25,64,.391,.391,24,31,.774,32,32,64,17,11,1,13,39,74
140,Rick Fox\foxri01,SF,32,LAL,82,82,2289,255,605,.421,65,208,.313,190,397,.479,.475,70,85,.824,90,299,389,283,67,21,132,244,645
141,Adonal Foyle\foylead01,C,26,GSW,79,36,1485,171,385,.444,0,0,,171,385,.444,.444,37,93,.398,150,234,384,41,36,168,76,179,379
142,Steve Francis\francst01,PG,24,HOU,57,56,2343,420,1007,.417,68,210,.324,352,797,.442,.451,326,422,.773,102,299,401,362,71,25,221,172,1234
143,Lawrence Funderburke\fundela01,PF,31,SAC,56,1,722,115,245,.469,0,3,.000,115,242,.475,.469,34,56,.607,76,122,198,32,11,18,33,65,264
144,Kevin Garnett*\garneke01,PF,25,MIN,81,81,3175,659,1401,.470,37,116,.319,622,1285,.484,.484,359,448,.801,243,738,981,422,96,126,229,184,1714
145,Dean Garrett\garrede01,C,35,TOT,34,0,183,18,55,.327,0,0,,18,55,.327,.327,0,3,.000,16,41,57,5,7,10,10,32,36
145,Dean Garrett\garrede01,C,35,MIN,29,0,152,14,40,.350,0,0,,14,40,.350,.350,0,3,.000,13,34,47,4,5,9,7,26,28
145,Dean Garrett\garrede01,C,35,GSW,5,0,31,4,15,.267,0,0,,4,15,.267,.267,0,0,,3,7,10,1,2,1,3,6,8
146,Pat Garrity\garripa01,PF,25,ORL,80,43,2406,327,767,.426,169,396,.427,158,371,.426,.537,61,73,.836,77,261,338,99,61,28,68,230,884
147,Pau Gasol\gasolpa01,PF,21,MEM,82,79,3007,551,1064,.518,1,5,.200,550,1059,.519,.518,338,477,.709,238,492,730,223,41,169,224,195,1441
148,Chris Gatling\gatlich01,PF,34,MIA,54,1,809,131,293,.447,1,8,.125,130,285,.456,.449,82,117,.701,71,135,206,25,17,11,58,109,345
149,Matt Geiger\geigema01,C,32,PHI,4,0,36,1,8,.125,0,0,,1,8,.125,.125,1,2,.500,3,3,6,0,0,2,2,2,3
150,Devean George\georgde01,SF,24,LAL,82,1,1759,215,523,.411,66,178,.371,149,345,.432,.474,85,126,.675,78,225,303,111,71,42,66,190,581
151,Eddie Gill\gilled01,PG,23,MEM,23,5,384,39,92,.424,7,22,.318,32,70,.457,.462,31,39,.795,7,21,28,49,11,3,34,38,116
152,Kendall Gill\gillke01,SG,33,MIA,65,49,1410,162,422,.384,6,44,.136,156,378,.413,.391,42,62,.677,29,155,184,100,44,8,55,140,372
153,Dion Glover\glovedi01,SG,23,ATL,55,25,1156,192,456,.421,30,91,.330,162,365,.444,.454,78,103,.757,36,133,169,84,45,14,76,89,492
154,Steve Goodrich\goodrst01,SF,25,NJN,9,0,50,2,10,.200,0,0,,2,10,.200,.200,1,2,.500,1,4,5,5,1,2,3,10,5
155,Brian Grant\grantbr01,PF,29,MIA,72,72,2256,286,610,.469,0,2,.000,286,608,.470,.469,101,119,.849,168,407,575,137,48,31,122,236,673
156,Horace Grant\grantho01,C,36,ORL,76,76,2210,264,515,.513,0,0,,264,515,.513,.513,80,111,.721,159,322,481,104,57,49,51,118,608
157,Adrian Griffin\griffad01,SG,27,DAL,58,34,1383,179,359,.499,16,54,.296,163,305,.534,.521,41,49,.837,68,161,229,106,75,12,42,142,415
158,Eddie Griffin\griffed01,PF,19,HOU,73,24,1896,244,666,.366,90,273,.330,154,393,.392,.434,64,86,.744,117,299,416,53,17,134,47,117,642
159,Tom Gugliotta\guglito01,PF,32,PHO,44,40,1129,127,301,.422,3,9,.333,124,292,.425,.427,28,37,.757,59,162,221,77,39,30,61,116,285
160,A.J. Guyton\guytoaj01,PG,23,CHI,45,6,607,88,244,.361,46,123,.374,42,121,.347,.455,22,27,.815,12,32,44,81,10,7,37,23,244
161,Darvin Ham\hamda01,SF,28,MIL,70,2,1208,120,211,.569,1,7,.143,119,204,.583,.571,62,123,.504,91,111,202,73,25,37,83,175,303
162,Richard Hamilton\hamilri01,SG,23,WAS,63,57,2203,472,1084,.435,16,42,.381,456,1042,.438,.443,300,337,.890,73,143,216,171,38,14,132,136,1260
163,Tang Hamilton\hamilta01,SF,23,MIA,9,2,98,10,19,.526,0,1,.000,10,18,.556,.526,0,1,.000,6,12,18,5,4,0,2,10,20
164,Zendon Hamilton\hamilze01,PF,26,DEN,54,15,848,103,245,.420,0,0,,103,245,.420,.420,118,181,.652,110,143,253,14,21,18,60,104,324
165,Anfernee Hardaway\hardaan01,SG,30,PHO,80,55,2462,389,931,.418,23,83,.277,366,848,.432,.430,158,195,.810,98,252,350,324,122,32,189,184,959
166,Tim Hardaway*\hardati01,PG,35,TOT,68,16,1601,226,620,.365,123,354,.347,103,266,.387,.464,77,97,.794,14,110,124,278,57,10,111,109,652
166,Tim Hardaway*\hardati01,PG,35,DAL,54,2,1276,179,494,.362,95,279,.341,84,215,.391,.459,65,78,.833,13,84,97,201,40,8,73,84,518
166,Tim Hardaway*\hardati01,PG,35,DEN,14,14,325,47,126,.373,28,75,.373,19,51,.373,.484,12,19,.632,1,26,27,77,17,2,38,25,134
167,Matt Harpring\harprma01,SF,25,PHI,81,81,2541,386,838,.461,21,69,.304,365,769,.475,.473,165,222,.743,203,370,573,107,70,5,127,201,958
168,Al Harrington\harrial01,PF,21,IND,44,1,1313,230,484,.475,1,3,.333,229,481,.476,.476,115,144,.799,96,180,276,54,41,21,78,166,576
169,Othella Harrington\harriot01,PF,28,NYK,77,4,1563,237,450,.527,0,2,.000,237,448,.529,.527,122,172,.709,125,224,349,37,30,36,95,250,596
170,Lucious Harris\harrilu01,SG,31,NJN,74,0,1553,249,537,.464,44,118,.373,205,419,.489,.505,133,158,.842,49,158,207,116,53,6,61,99,675
171,Jason Hart\hartja01,PG,23,SAS,10,0,92,10,19,.526,0,2,.000,10,17,.588,.526,6,6,1.000,4,9,13,12,7,1,8,16,26
172,Antonio Harvey\harvean01,PF,31,SEA,5,3,47,4,12,.333,0,0,,4,12,.333,.333,1,2,.500,5,4,9,5,1,3,3,8,9
173,Donnell Harvey\harvedo01,PF,21,TOT,47,4,841,108,217,.498,0,0,,108,217,.498,.498,54,90,.600,80,147,227,37,21,24,33,115,270
173,Donnell Harvey\harvedo01,PF,21,DAL,18,0,162,14,26,.538,0,0,,14,26,.538,.538,10,22,.455,12,34,46,5,4,5,8,27,38
173,Donnell Harvey\harvedo01,PF,21,DEN,29,4,679,94,191,.492,0,0,,94,191,.492,.492,44,68,.647,68,113,181,32,17,19,25,88,232
174,Trenton Hassell\hassetr01,SG,22,CHI,78,47,2237,267,628,.425,60,165,.364,207,463,.447,.473,87,114,.763,65,190,255,172,55,44,101,184,681
175,Kirk Haston\hastoki01,PF,22,CHH,15,0,77,11,39,.282,0,3,.000,11,36,.306,.282,4,8,.500,5,15,20,5,0,1,3,9,26
176,Brendan Haywood\haywobr01,C,22,WAS,62,2,1266,109,221,.493,0,0,,109,221,.493,.493,97,160,.606,143,179,322,29,21,91,50,158,315
177,Alan Henderson\hendeal01,PF,29,ATL,26,1,422,59,116,.509,1,1,1.000,58,115,.504,.513,24,45,.533,31,66,97,11,11,15,21,40,143
178,Cedric Henderson\hendece02,SF,26,GSW,12,0,70,15,31,.484,2,4,.500,13,27,.481,.516,4,7,.571,1,2,3,4,6,2,8,4,36
179,Grant Hill*\hillgr01,SF,29,ORL,14,14,512,83,195,.426,0,2,.000,83,193,.430,.426,69,80,.863,29,96,125,64,8,4,37,40,235
180,Tyrone Hill\hillty01,PF,33,CLE,26,26,810,71,182,.390,0,1,.000,71,181,.392,.390,67,103,.650,79,195,274,23,17,13,48,102,209
181,Fred Hoiberg\hoibefr01,SG,29,CHI,79,8,1408,121,291,.416,24,92,.261,97,199,.487,.457,79,94,.840,18,192,210,136,61,5,32,87,345
182,Robert Horry\horryro01,PF,31,LAL,81,23,2140,183,460,.398,76,203,.374,107,257,.416,.480,108,138,.783,130,349,479,232,77,89,88,208,550
183,Eddie House\houseed01,PG,23,MIA,64,3,1230,209,524,.399,54,157,.344,155,367,.422,.450,42,49,.857,17,93,110,123,43,5,80,98,514
184,Allan Houston\houstal01,SG,30,NYK,77,77,2914,568,1301,.437,136,346,.393,432,955,.452,.489,295,339,.870,37,215,252,190,54,10,170,182,1567
185,Juwan Howard\howarju01,PF,28,TOT,81,72,2635,462,1005,.460,0,2,.000,462,1003,.461,.460,261,343,.761,223,389,612,169,46,47,152,265,1185
185,Juwan Howard\howarju01,PF,28,DAL,53,44,1659,270,585,.462,0,1,.000,270,584,.462,.462,144,191,.754,138,252,390,93,28,30,78,170,684
185,Juwan Howard\howarju01,PF,28,DEN,28,28,976,192,420,.457,0,1,.000,192,419,.458,.457,117,152,.770,85,137,222,76,18,17,74,95,501
186,Troy Hudson\hudsotr01,PG,25,ORL,81,4,1854,354,815,.434,66,187,.353,288,628,.459,.475,176,201,.876,30,115,145,255,57,6,163,119,950
187,Larry Hughes\hughela01,SG,23,GSW,73,56,2049,343,810,.423,18,93,.194,325,717,.453,.435,191,259,.737,83,162,245,316,113,23,171,150,895
188,Lindsey Hunter\hunteli01,PG,31,LAL,82,47,1616,187,490,.382,79,208,.380,108,282,.383,.462,20,40,.500,18,103,121,129,66,19,55,120,473
189,Steven Hunter\huntest01,C,20,ORL,53,21,516,67,147,.456,0,0,,67,147,.456,.456,55,94,.585,40,57,97,5,5,43,16,81,189
190,Zydrunas Ilgauskas\ilgauzy01,C,26,CLE,62,23,1329,241,567,.425,0,5,.000,241,562,.429,.425,208,276,.754,136,198,334,70,17,84,94,187,690
191,Allen Iverson*\iversal01,SG,26,PHI,60,59,2622,665,1669,.398,78,268,.291,587,1401,.419,.422,475,585,.812,44,225,269,331,168,13,237,102,1883
192,Bobby Jackson\jacksbo01,PG,28,SAC,81,3,1750,334,754,.443,79,219,.361,255,535,.477,.495,149,184,.810,82,169,251,164,73,11,93,145,896
193,Jaren Jackson\jacksja01,SG,34,ORL,9,0,144,15,37,.405,7,20,.350,8,17,.471,.500,2,4,.500,1,16,17,8,5,0,8,13,39
194,Jermaine Jackson\jacksje01,SG,25,TOR,24,0,280,20,42,.476,1,2,.500,19,40,.475,.488,16,24,.667,3,24,27,57,9,1,14,24,57
195,Jim Jackson\jacksji01,SF,31,MIA,55,19,1825,238,538,.442,38,81,.469,200,457,.438,.478,75,87,.862,54,236,290,140,42,14,106,145,589
196,Marc Jackson\jacksma02,C,27,TOT,39,0,495,60,164,.366,0,1,.000,60,163,.368,.366,66,80,.825,48,80,128,14,11,6,30,69,186
196,Marc Jackson\jacksma02,C,27,GSW,17,0,169,22,65,.338,0,0,,22,65,.338,.338,40,48,.833,17,26,43,7,5,3,12,25,84
196,Marc Jackson\jacksma02,C,27,MIN,22,0,326,38,99,.384,0,1,.000,38,98,.388,.384,26,32,.813,31,54,85,7,6,3,18,44,102
197,Mark Jackson\jacksma01,PG,36,NYK,82,82,2367,260,592,.439,79,195,.405,181,397,.456,.506,87,110,.791,56,253,309,605,74,1,150,162,686
198,Stephen Jackson\jacksst02,SF,23,SAS,23,1,227,34,91,.374,9,36,.250,25,55,.455,.423,12,17,.706,3,23,26,11,15,3,23,29,89
199,Jerome James\jamesje01,C,26,SEA,56,40,949,134,273,.491,0,0,,134,273,.491,.491,30,60,.500,89,143,232,24,25,86,74,174,298
200,Mike James\jamesmi01,PG,26,MIA,15,0,119,15,43,.349,8,21,.381,7,22,.318,.442,4,7,.571,2,12,14,19,6,1,13,17,42
201,Tim James\jamesti01,SF,25,PHI,9,0,41,5,13,.385,0,0,,5,13,.385,.385,2,6,.333,5,2,7,1,0,1,3,5,12
202,Antawn Jamison\jamisan01,SF,25,GSW,82,82,3033,614,1375,.447,68,210,.324,546,1165,.469,.471,323,440,.734,211,345,556,161,70,45,161,187,1619
203,Harold Jamison\jamisha01,PF,25,LAC,25,2,176,22,43,.512,0,0,,22,43,.512,.512,10,15,.667,24,15,39,6,5,1,6,23,54
204,Richard Jefferson\jefferi01,SF,21,NJN,79,9,1917,270,591,.457,13,56,.232,257,535,.480,.468,189,265,.713,85,208,293,140,64,48,107,211,742
205,Anthony Johnson\johnsan02,SG,27,NJN,34,0,366,37,90,.411,4,12,.333,33,78,.423,.433,16,25,.640,10,19,29,48,31,1,20,30,94
206,Avery Johnson\johnsav01,PG,36,TOT,68,13,1352,207,432,.479,0,5,.000,207,427,.485,.479,121,163,.742,14,55,69,286,40,9,76,86,535
206,Avery Johnson\johnsav01,PG,36,DEN,51,13,1200,186,383,.486,0,5,.000,186,378,.492,.486,109,146,.747,14,50,64,258,35,8,67,69,481
206,Avery Johnson\johnsav01,PG,36,DAL,17,0,152,21,49,.429,0,0,,21,49,.429,.429,12,17,.706,0,5,5,28,5,1,9,17,54
207,DerMarr Johnson\johnsde03,SF,21,ATL,72,46,1727,214,540,.396,89,247,.360,125,293,.427,.479,85,105,.810,59,188,247,81,62,56,102,163,602
208,Ervin Johnson\johnser02,C,34,MIL,81,9,1660,89,193,.461,0,1,.000,89,192,.464,.461,30,66,.455,142,324,466,27,37,82,52,219,208
209,Joe Johnson\johnsjo02,SG,20,TOT,77,60,1916,251,584,.430,38,130,.292,213,454,.469,.462,41,53,.774,75,182,257,179,59,20,71,114,581
209,Joe Johnson\johnsjo02,SG,20,BOS,48,33,1003,130,296,.439,24,88,.273,106,208,.510,.480,20,26,.769,40,99,139,74,33,9,28,59,304
209,Joe Johnson\johnsjo02,SG,20,PHO,29,27,913,121,288,.420,14,42,.333,107,246,.435,.444,21,27,.778,35,83,118,105,26,11,43,55,277
210,Alvin Jones\jonesal01,C,23,PHI,23,2,126,8,20,.400,0,0,,8,20,.400,.400,10,20,.500,13,23,36,3,3,9,11,35,26
211,Damon Jones\jonesda01,PG,25,DET,67,0,1083,114,284,.401,69,186,.371,45,98,.459,.523,43,59,.729,13,90,103,140,23,1,61,83,340
212,Eddie Jones\jonesed02,SG,30,MIA,81,81,3156,517,1198,.432,149,382,.390,368,816,.451,.494,297,355,.837,61,317,378,262,117,77,148,258,1480
213,Jumaine Jones\jonesju01,PF,22,CLE,81,36,2142,287,640,.448,52,168,.310,235,472,.498,.489,45,68,.662,125,365,490,116,75,46,79,184,671
214,Popeye Jones\jonespo01,PF,31,WAS,79,40,1920,222,508,.437,4,11,.364,218,497,.439,.441,106,130,.815,233,345,578,127,50,19,88,209,554
215,Michael Jordan*\jordami01,SF,38,WAS,60,53,2093,551,1324,.416,10,53,.189,541,1271,.426,.420,263,333,.790,50,289,339,310,85,26,162,119,1375
216,Shawn Kemp\kempsh01,PF,32,POR,75,5,1232,175,407,.430,0,4,.000,175,403,.434,.430,104,131,.794,90,198,288,52,43,33,81,184,454
217,Steve Kerr\kerrst01,PG,36,POR,65,0,775,102,217,.470,26,66,.394,76,151,.503,.530,39,40,.975,6,54,60,63,13,1,24,49,269
218,Jason Kidd*\kiddja01,PG,28,NJN,82,82,3056,445,1138,.391,117,364,.321,328,774,.424,.442,201,247,.814,130,465,595,808,175,20,286,136,1208
219,Andrei Kirilenko\kirilan01,SF,20,UTA,82,40,2151,285,633,.450,25,100,.250,260,533,.488,.470,285,371,.768,149,253,402,94,116,159,108,156,880
220,Kerry Kittles\kittlke01,SG,27,NJN,82,82,2601,438,940,.466,98,242,.405,340,698,.487,.518,128,172,.744,68,207,275,216,130,31,109,108,1102
221,Brevin Knight\knighbr01,PG,26,MEM,53,11,1151,141,334,.422,2,8,.250,139,326,.426,.425,87,115,.757,11,98,109,302,79,7,111,135,371
222,Travis Knight\knightr01,C,27,NYK,49,0,429,41,113,.363,0,0,,41,113,.363,.363,16,21,.762,48,56,104,8,11,10,27,95,98
223,Toni Kukoč*\kukocto01,SF,33,ATL,59,9,1494,211,504,.419,53,171,.310,158,333,.474,.471,109,153,.712,43,175,218,210,48,17,113,91,584
224,Christian Laettner\laettch01,PF,32,WAS,57,48,1441,168,362,.464,2,10,.200,166,352,.472,.467,66,76,.868,74,227,301,151,60,25,85,129,404
225,Raef LaFrentz\lafrera01,C,25,TOT,78,76,2455,421,920,.458,104,268,.388,317,652,.486,.514,105,151,.695,176,403,579,89,55,213,94,281,1051
225,Raef LaFrentz\lafrera01,C,25,DEN,51,51,1668,307,659,.466,75,173,.434,232,486,.477,.523,70,105,.667,117,262,379,60,31,153,60,173,759
225,Raef LaFrentz\lafrera01,C,25,DAL,27,25,787,114,261,.437,29,95,.305,85,166,.512,.492,35,46,.761,59,141,200,29,24,60,34,108,292
226,Trajan Langdon\langdtr01,SG,25,CLE,44,0,477,70,176,.398,27,74,.365,43,102,.422,.474,42,46,.913,13,42,55,60,13,5,40,49,209
227,Dan Langhi\langhda01,SF,24,HOU,34,8,434,49,125,.392,1,4,.250,48,121,.397,.396,8,11,.727,22,45,67,14,8,5,9,25,107
228,Rusty LaRue\larueru01,PG,28,UTA,33,0,542,73,185,.395,17,50,.340,56,135,.415,.441,30,35,.857,11,38,49,71,17,7,43,58,193
229,Voshon Lenard\lenarvo01,SG,28,DEN,71,19,1665,315,769,.410,89,240,.371,226,529,.427,.467,94,120,.783,38,145,183,130,59,25,91,105,813
230,Quincy Lewis\lewisqu01,SG,24,UTA,36,19,490,64,143,.448,3,18,.167,61,125,.488,.458,13,20,.650,10,33,43,36,23,9,32,89,144
231,Rashard Lewis\lewisra02,SF,22,SEA,71,70,2585,455,972,.468,123,316,.389,332,656,.506,.531,162,200,.810,139,359,498,123,104,40,97,174,1195
232,Randy Livingston\livinra01,PG,26,SEA,13,0,176,15,54,.278,1,8,.125,14,46,.304,.287,10,11,.909,9,16,25,26,9,2,2,11,41
233,Art Long\longar01,PF,29,SEA,63,27,989,120,244,.492,0,0,,120,244,.492,.492,45,85,.529,107,144,251,41,22,28,63,180,285
234,Grant Long\longgr01,PF,35,MEM,66,56,1868,164,385,.426,3,17,.176,161,368,.438,.430,86,123,.699,31,200,231,136,63,12,103,123,417
235,Felipe López\lopezfe01,SG,27,MIN,67,0,581,59,156,.378,14,33,.424,45,123,.366,.423,37,55,.673,29,51,80,39,18,1,36,73,169
236,Tyronn Lue\luety01,PG,24,WAS,71,0,1458,222,520,.427,63,141,.447,159,379,.420,.488,48,63,.762,14,108,122,246,49,0,96,120,555
237,George Lynch\lynchge01,SF,31,CHH,45,18,893,73,198,.369,1,6,.167,72,192,.375,.371,25,40,.625,70,116,186,54,40,14,41,75,172
238,Todd MacCulloch\maccuto01,C,26,NJN,62,61,1502,247,465,.531,0,0,,247,465,.531,.531,110,164,.671,157,221,378,78,24,89,66,181,604
239,Sam Mack\macksa01,SF,31,MIA,12,1,159,14,49,.286,7,28,.250,7,21,.333,.357,5,7,.714,2,12,14,4,5,1,7,17,40
240,Mark Madsen\madsema01,PF,26,LAL,59,5,650,66,146,.452,0,2,.000,66,144,.458,.452,35,54,.648,89,73,162,44,16,13,22,104,167
241,Corey Maggette\maggeco01,SG,22,LAC,63,52,1615,235,530,.443,46,139,.331,189,391,.483,.487,201,251,.801,54,177,231,112,41,19,116,155,717
242,Jamaal Magloire\magloja01,C,23,CHH,82,8,1549,228,414,.551,0,1,.000,228,413,.552,.551,243,333,.730,153,308,461,31,27,86,118,201,699
243,Dan Majerle\majerda01,SG,36,PHO,65,1,1180,99,289,.343,79,235,.336,20,54,.370,.479,23,39,.590,28,148,176,90,48,15,35,104,300
244,Karl Malone*\malonka01,PF,38,UTA,80,80,3040,635,1399,.454,9,25,.360,626,1374,.456,.457,509,639,.797,142,544,686,341,152,59,263,229,1788
245,Danny Manning\mannida01,PF,35,DAL,41,10,552,71,149,.477,1,7,.143,70,142,.493,.480,22,33,.667,25,83,108,30,21,21,25,80,165
246,Stephon Marbury\marbust01,PG,24,PHO,82,80,3187,625,1413,.442,71,248,.286,554,1165,.476,.467,353,452,.781,75,191,266,666,77,13,284,186,1674
247,Shawn Marion\mariosh01,SF,23,PHO,81,81,3109,654,1395,.469,48,122,.393,606,1273,.476,.486,191,226,.845,211,592,803,162,149,86,144,214,1547
248,Sean Marks\marksse01,C,26,MIA,21,6,319,38,88,.432,0,0,,38,88,.432,.432,20,34,.588,19,56,75,8,5,10,19,40,96
249,Donny Marshall\marshdo02,SF,29,NJN,20,0,118,8,29,.276,2,4,.500,6,25,.240,.310,12,18,.667,8,13,21,5,3,0,2,14,30
250,Donyell Marshall\marshdo01,SF,28,UTA,58,42,1750,343,661,.519,13,42,.310,330,619,.533,.529,160,226,.708,158,285,443,101,50,67,124,150,859
251,Darrick Martin\martida01,PG,30,DAL,3,0,22,0,10,.000,0,2,.000,0,8,.000,.000,1,2,.500,0,1,1,3,2,0,1,4,1
252,Kenyon Martin\martike01,PF,24,NJN,73,73,2504,445,962,.463,15,67,.224,430,895,.480,.470,181,267,.678,113,275,388,192,90,121,172,261,1086
253,Jamal Mashburn\mashbja01,SF,29,CHH,40,40,1601,303,744,.407,41,112,.366,262,632,.415,.435,211,241,.876,31,211,242,171,45,6,110,80,858
254,Anthony Mason\masonan01,PF,35,MIL,82,82,3143,316,626,.505,1,1,1.000,315,625,.504,.506,154,221,.697,124,522,646,346,57,22,130,187,787
255,Desmond Mason\masonde01,SF,24,SEA,75,20,2420,357,769,.464,16,59,.271,341,710,.480,.475,201,237,.848,92,259,351,104,67,27,104,170,931
256,Tony Massenburg\masseto01,PF,34,MEM,73,31,1247,159,349,.456,1,1,1.000,158,348,.454,.457,84,117,.718,100,224,324,26,30,31,65,174,403
257,Walter McCarty\mccarwa01,PF,27,BOS,56,0,718,80,180,.444,39,99,.394,41,81,.506,.553,13,19,.684,32,96,128,41,18,7,22,83,212
258,Amal McCaskill\mccasam01,C,28,SAS,27,0,153,20,49,.408,0,0,,20,49,.408,.408,12,26,.462,16,20,36,4,6,10,14,23,52
259,George McCloud\mccloge01,SF,34,DEN,69,26,1830,206,576,.358,60,222,.270,146,354,.412,.410,132,163,.810,67,184,251,204,58,19,144,175,604
260,Jelani McCoy\mccoyje01,C,24,LAL,21,0,104,12,21,.571,0,0,,12,21,.571,.571,2,8,.250,8,17,25,7,0,5,8,14,26
261,Antonio McDyess\mcdyean01,PF,27,DEN,10,10,236,43,75,.573,0,0,,43,75,.573,.573,27,33,.818,18,37,55,18,10,8,20,20,113
262,Tracy McGrady*\mcgratr01,SG,22,ORL,76,76,2912,715,1586,.451,103,283,.364,612,1303,.470,.483,415,555,.748,150,447,597,400,119,73,189,139,1948
263,Jeff McInnis\mcinnje01,PG,27,LAC,81,80,3030,463,1121,.413,75,234,.321,388,887,.437,.446,183,219,.836,45,168,213,500,63,6,147,202,1184
264,Derrick McKey\mckeyde01,SF,35,PHI,41,1,784,52,122,.426,5,12,.417,47,110,.427,.447,10,14,.714,48,79,127,45,41,4,22,90,119
265,Aaron McKie\mckieaa01,SG,29,PHI,48,16,1471,220,490,.449,51,128,.398,169,362,.467,.501,96,122,.787,26,166,192,179,56,14,93,74,587
266,Stanislav Medvedenko\medvest01,C,22,LAL,71,6,729,145,304,.477,0,4,.000,145,300,.483,.477,41,62,.661,85,73,158,43,29,11,42,119,331
267,Ron Mercer\mercero01,SG,25,TOT,53,41,1716,311,784,.397,18,62,.290,293,722,.406,.408,95,119,.798,50,128,178,128,32,13,88,108,735
267,Ron Mercer\mercero01,SG,25,CHI,40,40,1503,286,717,.399,17,57,.298,269,660,.408,.411,84,108,.778,44,111,155,118,30,10,79,86,673
267,Ron Mercer\mercero01,SG,25,IND,13,1,213,25,67,.373,1,5,.200,24,62,.387,.381,11,11,1.000,6,17,23,10,2,3,9,22,62
268,Chris Mihm\mihmch01,C,22,CLE,74,60,1659,221,526,.420,3,7,.429,218,519,.420,.423,124,179,.693,133,259,392,24,18,89,97,260,569
269,Darius Miles\milesda01,SF,20,LAC,82,6,2227,309,642,.481,3,19,.158,306,623,.491,.484,158,255,.620,109,344,453,184,71,103,160,184,779
270,Andre Miller\millean02,PG,25,CLE,81,81,3023,474,1045,.454,22,87,.253,452,958,.472,.464,365,447,.817,108,271,379,882,126,34,245,228,1335
271,Brad Miller\millebr01,C,25,TOT,76,75,2263,366,733,.499,3,7,.429,363,726,.500,.501,297,383,.775,252,369,621,152,76,41,115,244,1032
271,Brad Miller\millebr01,C,25,CHI,48,47,1391,208,452,.460,2,4,.500,206,448,.460,.462,190,253,.751,176,225,401,101,52,29,74,156,608
271,Brad Miller\millebr01,C,25,IND,28,28,872,158,281,.562,1,3,.333,157,278,.565,.564,107,130,.823,76,144,220,51,24,12,41,88,424
272,Mike Miller\millemi01,SF,21,ORL,63,53,2123,351,802,.438,116,303,.383,235,499,.471,.510,138,181,.762,49,224,273,198,47,23,108,145,956
273,Reggie Miller*\millere01,SG,36,IND,79,79,2889,414,913,.453,180,443,.406,234,470,.498,.552,296,325,.911,23,196,219,253,88,10,120,143,1304
274,Chris Mills\millsch01,SF,32,GSW,66,0,1237,178,427,.417,48,127,.378,130,300,.433,.473,85,107,.794,51,139,190,72,31,13,56,120,489
275,Sam Mitchell\mitchsa01,SF,38,MIN,74,10,726,98,227,.432,10,35,.286,88,192,.458,.454,38,49,.776,18,64,82,45,12,4,26,79,244
276,Cuttino Mobley\moblecu01,SG,26,HOU,74,74,3116,595,1358,.438,149,377,.395,446,981,.455,.493,267,314,.850,63,237,300,187,109,37,180,189,1606
277,Nazr Mohammed\mohamna01,C,24,ATL,82,73,2168,329,713,.461,0,1,.000,329,712,.462,.461,137,222,.617,242,409,651,33,63,61,118,252,795
278,Jérôme Moïso\moisoje01,C,23,CHH,15,0,76,8,20,.400,0,0,,8,20,.400,.400,0,0,,4,21,25,4,3,2,8,12,16
279,Eric Montross\montrer01,C,30,TOR,49,24,655,53,132,.402,0,1,.000,53,131,.405,.402,10,31,.323,36,104,140,16,12,23,25,92,116
280,Mikki Moore\mooremi01,C,26,DET,30,0,217,29,61,.475,1,2,.500,28,59,.475,.484,20,26,.769,22,31,53,11,7,9,14,35,79
281,Terence Morris\morrite01,SF,23,HOU,68,12,1110,111,289,.384,15,78,.192,96,211,.455,.410,18,28,.643,77,134,211,64,21,27,45,72,255
282,Hanno Möttölä\mottoha01,C,25,ATL,82,14,1371,169,384,.440,1,13,.077,168,371,.453,.441,57,76,.750,81,187,268,50,20,19,70,174,396
283,Alonzo Mourning*\mournal01,C,31,MIA,75,74,2455,447,866,.516,1,3,.333,446,863,.517,.517,283,431,.657,182,450,632,87,27,186,182,258,1178
284,Troy Murphy\murphtr01,PF,21,GSW,82,4,1448,178,423,.421,3,9,.333,175,414,.423,.424,121,156,.776,99,223,322,70,36,21,84,217,480
285,Lamond Murray\murrala01,SF,28,CLE,71,68,2312,430,986,.436,101,238,.424,329,748,.440,.487,215,263,.817,81,291,372,157,70,43,141,148,1176
286,Tracy Murray\murratr01,SF,30,TOR,40,3,473,85,207,.411,40,104,.385,45,103,.437,.507,17,21,.810,18,35,53,19,11,8,25,38,227
287,Dikembe Mutombo*\mutomdi01,C,35,PHI,80,80,2907,321,641,.501,0,0,,321,641,.501,.501,278,364,.764,254,609,863,83,29,190,156,242,920
288,Mamadou N'Diaye\ndiayma02,C,26,TOR,5,0,46,6,10,.600,0,0,,6,10,.600,.600,8,10,.800,6,5,11,0,0,2,1,6,20
289,Lee Nailon\nailole01,SF,26,CHH,79,41,1912,369,764,.483,1,2,.500,368,762,.483,.484,112,150,.747,103,188,291,94,59,17,96,175,851
290,Eduardo Nájera\najered01,PF,25,DAL,62,11,1357,150,300,.500,0,2,.000,150,298,.503,.500,100,148,.676,149,193,342,38,56,30,40,156,400
291,Steve Nash*\nashst01,PG,27,DAL,82,82,2837,525,1088,.483,156,343,.455,369,745,.495,.554,260,293,.887,50,204,254,634,53,4,229,164,1466
292,Tyrone Nesby\nesbyty01,SF,26,WAS,70,9,1498,183,421,.435,13,47,.277,170,374,.455,.450,64,93,.688,105,213,318,91,61,22,49,164,443
293,Rasho Nesterović\nestera01,C,25,MIN,82,82,2218,324,657,.493,0,1,.000,324,656,.494,.493,39,71,.549,200,334,534,75,45,109,94,262,687
294,Ira Newble\newblir01,SF,27,ATL,42,35,1273,131,263,.498,1,7,.143,130,256,.508,.500,75,88,.852,80,142,222,45,38,20,49,117,338
295,Johnny Newman\newmajo01,SF,38,DAL,47,17,724,67,148,.453,22,57,.386,45,91,.495,.527,42,58,.724,9,40,49,14,29,4,21,88,198
296,Moochie Norris\norrimo01,PG,28,HOU,82,26,2249,251,631,.398,36,134,.269,215,497,.433,.426,127,169,.751,73,173,246,403,81,4,156,130,665
297,Dirk Nowitzki\nowitdi01,C,23,DAL,76,76,2891,600,1258,.477,139,350,.397,461,908,.508,.532,440,516,.853,120,635,755,186,83,77,145,222,1779
298,Jermaine O'Neal\onealje01,PF,23,IND,72,72,2707,543,1133,.479,1,14,.071,542,1119,.484,.480,284,413,.688,188,569,757,118,45,166,174,269,1371
299,Shaquille O'Neal*\onealsh01,C,29,LAL,67,66,2422,712,1229,.579,0,1,.000,712,1228,.580,.579,398,717,.555,235,480,715,200,41,137,171,199,1822
300,Charles Oakley\oaklech01,PF,38,CHI,57,36,1383,97,263,.369,1,6,.167,96,257,.374,.371,21,28,.750,72,271,343,114,49,11,87,175,216
301,Lamar Odom\odomla01,SF,22,LAC,29,25,999,151,360,.419,16,84,.190,135,276,.489,.442,61,93,.656,31,145,176,171,23,36,97,91,379
302,Hakeem Olajuwon*\olajuha01,C,39,TOR,61,37,1378,194,418,.464,0,2,.000,194,416,.466,.464,47,84,.560,98,268,366,66,74,90,98,147,435
303,Dean Oliver\olivede01,PG,23,GSW,20,0,139,17,46,.370,2,13,.154,15,33,.455,.391,6,9,.667,0,8,8,21,3,0,11,16,42
304,Kevin Ollie\ollieke01,PG,29,TOT,81,17,1723,137,353,.388,1,2,.500,136,351,.387,.390,187,227,.824,25,159,184,291,62,2,106,97,462
304,Kevin Ollie\ollieke01,PG,29,CHI,52,17,1146,97,253,.383,1,2,.500,96,251,.382,.385,109,130,.838,18,110,128,193,36,1,80,64,304
304,Kevin Ollie\ollieke01,PG,29,IND,29,0,577,40,100,.400,0,0,,40,100,.400,.400,78,97,.804,7,49,56,98,26,1,26,33,158
305,Michael Olowokandi\olowomi01,C,26,LAC,80,79,2568,384,886,.433,0,0,,384,886,.433,.433,117,188,.622,164,547,711,90,55,145,175,217,885
306,Greg Ostertag\ostergr01,C,28,UTA,74,14,1107,91,201,.453,0,0,,91,201,.453,.453,63,130,.485,125,188,313,50,15,109,51,152,245
307,Bo Outlaw\outlabo01,PF,30,TOT,83,36,1928,166,299,.555,1,2,.500,165,297,.556,.557,43,102,.422,147,217,364,127,70,92,96,205,376
307,Bo Outlaw\outlabo01,PF,30,ORL,10,0,160,13,21,.619,0,0,,13,21,.619,.619,8,18,.444,15,14,29,5,9,9,11,23,34
307,Bo Outlaw\outlabo01,PF,30,PHO,73,36,1768,153,278,.550,1,2,.500,152,276,.551,.552,35,84,.417,132,203,335,122,61,83,85,182,342
308,Doug Overton\overtdo01,PG,32,LAC,18,0,130,14,44,.318,7,27,.259,7,17,.412,.398,4,7,.571,1,11,12,13,3,1,12,10,39
309,Olumide Oyedeji\oyedeol01,C,20,SEA,36,1,221,22,41,.537,0,0,,22,41,.537,.537,11,18,.611,27,52,79,4,4,2,14,36,55
310,Robert Pack\packro01,PG,32,MIN,16,0,252,25,68,.368,1,4,.250,24,64,.375,.375,11,15,.733,7,16,23,49,13,0,20,32,62
311,Scott Padgett\padgesc01,PF,25,UTA,75,1,1295,188,395,.476,49,113,.434,139,282,.493,.538,75,102,.735,111,174,285,82,43,13,69,140,500
312,Milt Palacio\palacmi01,PG-SG,23,TOT,69,1,790,82,214,.383,13,41,.317,69,173,.399,.414,54,74,.730,11,62,73,83,30,4,40,61,231
312,Milt Palacio\palacmi01,PG,23,BOS,41,0,518,52,135,.385,12,34,.353,40,101,.396,.430,36,51,.706,8,42,50,54,21,3,24,38,152
312,Milt Palacio\palacmi01,SG,23,PHO,28,1,272,30,79,.380,1,7,.143,29,72,.403,.386,18,23,.783,3,20,23,29,9,1,16,23,79
313,Tony Parker\parketo01,PG,19,SAS,77,72,2267,268,639,.419,61,189,.323,207,450,.460,.467,108,160,.675,33,164,197,334,89,7,151,166,705
314,Cherokee Parks\parksch02,C,29,SAS,42,1,234,30,83,.361,0,0,,30,83,.361,.361,3,8,.375,24,34,58,10,7,8,14,34,63
315,Ruben Patterson\patteru01,SF,26,POR,75,13,1765,319,619,.515,9,36,.250,310,583,.532,.523,192,274,.701,155,143,298,107,79,37,114,140,839
316,Gary Payton*\paytoga01,PG,33,SEA,82,82,3301,737,1578,.467,74,236,.314,663,1342,.494,.490,267,335,.797,80,316,396,737,131,26,209,179,1815
317,Anthony Peeler\peelean01,SG,32,MIN,82,0,2060,288,684,.421,111,283,.392,177,401,.441,.502,50,58,.862,37,169,206,177,61,11,76,137,737
318,Mike Penberthy\penbemi01,PG,27,LAL,3,0,12,1,2,.500,0,0,,1,2,.500,.500,3,4,.750,0,2,2,2,2,0,0,0,5
319,Elliot Perry\perryel01,PG,32,MEM,2,0,48,5,10,.500,0,0,,5,10,.500,.500,1,2,.500,0,4,4,7,3,0,7,6,11
320,Wesley Person\persowe01,SG,30,CLE,78,78,2793,467,944,.495,143,322,.444,324,622,.521,.570,99,124,.798,50,244,294,173,77,37,74,93,1176
321,Morris Peterson\petermo01,SF,24,TOR,63,56,1988,336,768,.438,84,231,.364,252,537,.469,.492,127,169,.751,91,132,223,153,73,11,86,174,883
322,Eric Piatkowski\piatker01,SG,31,LAC,71,64,1718,207,471,.439,111,238,.466,96,233,.412,.557,101,113,.894,43,141,184,112,41,12,64,110,626
323,Paul Pierce*\piercpa01,SG,24,BOS,82,82,3302,707,1598,.442,210,520,.404,497,1078,.461,.508,520,643,.809,81,485,566,261,154,86,241,237,2144
324,Scottie Pippen*\pippesc01,SF,36,POR,62,60,1996,246,599,.411,54,177,.305,192,422,.455,.456,113,146,.774,77,244,321,363,101,35,171,162,659
325,Scot Pollard\pollasc01,C,26,SAC,80,29,1881,197,358,.550,0,0,,197,358,.550,.550,115,166,.693,188,377,565,53,70,76,68,202,509
326,Mark Pope\popema01,PF,29,MIL,45,12,426,36,91,.396,4,25,.160,32,66,.485,.418,11,21,.524,20,53,73,17,11,11,15,47,87
327,Terry Porter\portete01,PG,38,SAS,72,0,1294,136,321,.424,59,142,.415,77,179,.430,.516,68,83,.819,12,152,164,205,45,16,85,89,399
328,James Posey\poseyja01,SF,25,DEN,73,63,2238,277,736,.376,67,237,.283,210,499,.421,.422,161,203,.793,109,320,429,180,114,39,127,224,782
329,Lavor Postell\postela01,SG,23,NYK,23,0,179,28,84,.333,6,26,.231,22,58,.379,.369,31,41,.756,2,14,16,5,6,0,11,7,93
330,Vitaly Potapenko\potapvi01,C,26,BOS,79,9,1343,137,301,.455,0,0,,137,301,.455,.455,89,120,.742,167,180,347,30,37,18,63,174,363
331,Brent Price\pricebr01,PG,33,SAC,20,0,89,9,27,.333,4,15,.267,5,12,.417,.407,9,13,.692,4,4,8,9,3,1,10,13,31
332,Joel Przybilla\przybjo01,C,22,MIL,71,62,1128,76,142,.535,0,1,.000,76,141,.539,.535,38,90,.422,78,205,283,21,20,118,43,199,190
333,Vladimir Radmanović\radmavl01,PF,21,SEA,61,16,1230,146,354,.412,66,157,.420,80,197,.406,.506,49,72,.681,45,185,230,81,56,24,72,119,407
334,Zach Randolph\randoza01,PF,20,POR,41,0,238,48,107,.449,0,0,,48,107,.449,.449,18,27,.667,31,38,69,13,7,4,15,29,114
335,Theo Ratliff\ratlith01,C,28,ATL,3,2,82,10,20,.500,0,0,,10,20,.500,.500,6,11,.545,5,11,16,1,1,8,7,8,26
336,Željko Rebrača\rebraze01,C,29,DET,74,4,1179,189,374,.505,0,0,,189,374,.505,.505,135,175,.771,84,206,290,38,28,73,84,192,513
337,Eldridge Recasner\recasel01,PG-SG,34,TOT,6,0,33,2,6,.333,0,1,.000,2,5,.400,.333,1,1,1.000,0,0,0,5,1,0,1,4,5
337,Eldridge Recasner\recasel01,SG,34,CHH,1,0,2,0,0,,0,0,,0,0,,,0,0,,0,0,0,0,0,0,0,1,0
337,Eldridge Recasner\recasel01,PG,34,LAC,5,0,31,2,6,.333,0,1,.000,2,5,.400,.333,1,1,1.000,0,0,0,5,1,0,1,3,5
338,Michael Redd\reddmi01,SG,22,MIL,67,8,1417,294,609,.483,88,198,.444,206,411,.501,.555,91,115,.791,77,147,224,91,42,7,57,96,767
339,Don Reid\reiddo01,PF,28,ORL,68,5,714,90,190,.474,0,0,,90,190,.474,.474,44,68,.647,65,111,176,27,20,44,54,180,224
340,Glen Rice\ricegl01,SF,34,HOU,20,20,606,65,167,.389,18,64,.281,47,103,.456,.443,24,30,.800,5,42,47,31,12,3,24,34,172
341,Jason Richardson\richaja01,SG,21,GSW,80,75,2629,464,1090,.426,82,246,.333,382,844,.453,.463,141,210,.671,124,216,340,236,106,31,160,195,1151
342,Norm Richardson\richano01,SG,22,TOT,11,0,67,10,26,.385,4,8,.500,6,18,.333,.462,6,9,.667,3,5,8,2,0,0,3,5,30
342,Norm Richardson\richano01,SG,22,IND,3,0,4,0,3,.000,0,0,,0,3,.000,.000,0,0,,1,0,1,1,0,0,0,0,0
342,Norm Richardson\richano01,SG,22,CHI,8,0,63,10,23,.435,4,8,.500,6,15,.400,.522,6,9,.667,2,5,7,1,0,0,3,5,30
343,Quentin Richardson\richaqu01,SG,21,LAC,81,0,2152,400,926,.432,133,349,.381,267,577,.463,.504,143,187,.765,113,221,334,128,78,21,102,142,1076
344,Mitch Richmond*\richmmi01,SG,36,LAL,64,2,709,100,247,.405,18,62,.290,82,185,.443,.441,42,44,.955,14,80,94,57,18,6,40,61,260
345,Isaiah Rider\rideris01,SG,30,DEN,10,1,173,37,81,.457,6,15,.400,31,66,.470,.494,13,17,.765,10,23,33,12,3,2,14,11,93
346,Clifford Robinson\robincl02,PF,35,DET,80,80,2855,454,1069,.425,115,304,.378,339,765,.443,.478,143,206,.694,79,307,386,202,89,95,151,243,1166
347,David Robinson*\robinda01,C,36,SAS,78,78,2303,341,672,.507,0,0,,341,672,.507,.507,269,395,.681,191,456,647,94,86,140,104,193,951
348,Eddie Robinson\robined01,SF,25,CHI,29,12,653,112,247,.453,2,5,.400,110,242,.455,.457,36,48,.750,24,54,78,37,23,11,36,35,262
349,Glenn Robinson\robingl01,SF,29,MIL,66,63,2346,536,1147,.467,58,178,.326,478,969,.493,.493,236,282,.837,70,336,406,168,97,41,174,173,1366
350,Larry Robinson\robinla01,SG,34,NYK,2,0,10,1,4,.250,1,2,.500,0,2,.000,.375,0,0,,0,2,2,0,0,0,0,1,3
351,Carlos Rogers\rogerca01,C,30,IND,22,1,168,24,43,.558,1,6,.167,23,37,.622,.570,10,19,.526,14,24,38,3,5,6,5,17,59
352,Rodney Rogers\rogerro01,SF,30,TOT,77,8,1880,356,756,.471,88,235,.374,268,521,.514,.529,117,149,.785,129,219,348,112,66,29,108,226,917
352,Rodney Rogers\rogerro01,SF,30,PHO,50,7,1254,249,534,.466,49,140,.350,200,394,.508,.512,82,99,.828,95,146,241,72,50,17,66,148,629
352,Rodney Rogers\rogerro01,SF,30,BOS,27,1,626,107,222,.482,39,95,.411,68,127,.535,.570,35,50,.700,34,73,107,40,16,12,42,78,288
353,Sean Rooks\rooksse01,C,32,LAC,61,2,728,81,194,.418,0,0,,81,194,.418,.418,21,29,.724,32,92,124,25,12,21,20,114,183
354,Jalen Rose\roseja01,SF,29,TOT,83,83,3153,663,1458,.455,89,246,.362,574,1212,.474,.485,281,335,.839,43,330,373,355,78,45,201,251,1696
354,Jalen Rose\roseja01,SF,29,IND,53,53,1937,387,871,.444,52,146,.356,335,725,.462,.474,156,186,.839,29,220,249,197,45,29,105,148,982
354,Jalen Rose\roseja01,SF,29,CHI,30,30,1216,276,587,.470,37,100,.370,239,487,.491,.502,125,149,.839,14,110,124,158,33,16,96,103,714
355,Malik Rose\rosema01,PF,27,SAS,82,1,1725,293,633,.463,1,12,.083,292,621,.470,.464,185,257,.720,172,320,492,61,70,42,140,208,772
356,Michael Ruffin\ruffimi01,PF,25,PHI,15,0,169,7,26,.269,0,0,,7,26,.269,.269,2,8,.250,23,28,51,5,5,8,11,23,16
357,Bryon Russell\russebr01,SG,31,UTA,66,40,1998,222,584,.380,77,226,.341,145,358,.405,.446,115,140,.821,79,216,295,136,64,19,110,205,636
358,Daniel Santiago\santida01,C,25,PHO,3,0,24,4,8,.500,0,0,,4,8,.500,.500,0,0,,0,7,7,2,0,1,2,4,8
359,Jeryl Sasser\sasseje01,SG,22,ORL,7,0,36,3,14,.214,0,0,,3,14,.214,.214,4,5,.800,3,4,7,2,3,0,2,3,10
360,Kenny Satterfield\satteke01,PG,20,DEN,36,4,560,73,199,.367,7,27,.259,66,172,.384,.384,36,46,.783,17,35,52,108,31,1,53,43,189
361,Brian Scalabrine\scalabr01,PF,23,NJN,28,0,290,23,67,.343,3,10,.300,20,57,.351,.366,11,15,.733,12,39,51,21,9,2,24,39,60
362,Shawnelle Scott\scottsh01,C,29,DEN,21,10,252,37,75,.493,0,0,,37,75,.493,.493,8,20,.400,53,50,103,8,3,6,15,49,82
363,Ansu Sesay\sesayan01,SF,25,SEA,9,0,142,22,44,.500,0,0,,22,44,.500,.500,14,20,.700,7,13,20,8,3,2,2,18,58
364,Brian Shaw\shawbr01,PG,35,LAL,58,0,631,61,173,.353,29,88,.330,32,85,.376,.436,18,26,.692,19,93,112,89,25,3,32,43,169
365,Bobby Simmons\simmobo01,SF,21,WAS,30,3,343,43,95,.453,4,14,.286,39,81,.481,.474,22,30,.733,25,27,52,17,13,5,14,31,112
366,Dickey Simpkins\simpkdi01,PF,29,ATL,1,0,3,0,0,,0,0,,0,0,,,0,0,,0,0,0,1,0,0,0,0,0
367,Brian Skinner\skinnbr01,PF,25,CLE,65,8,1107,88,162,.543,0,0,,88,162,.543,.543,48,79,.608,93,188,281,17,24,61,42,130,224
368,Reggie Slater\slatere01,PF,31,TOT,8,0,47,7,15,.467,0,0,,7,15,.467,.467,7,10,.700,5,4,9,1,1,1,1,3,21
368,Reggie Slater\slatere01,PF,31,NJN,4,0,10,2,2,1.000,0,0,,2,2,1.000,1.000,1,1,1.000,0,2,2,0,0,0,1,1,5
368,Reggie Slater\slatere01,PF,31,ATL,4,0,37,5,13,.385,0,0,,5,13,.385,.385,6,9,.667,5,2,7,1,1,1,0,2,16
369,Charles Smith\smithch04,SG,26,SAS,60,22,1141,182,428,.425,35,131,.267,147,297,.495,.466,42,65,.646,34,99,133,80,52,44,59,114,441
370,Jabari Smith\smithja01,C,24,TOT,23,0,181,26,63,.413,0,3,.000,26,60,.433,.413,21,32,.656,8,20,28,11,6,6,5,31,73
370,Jabari Smith\smithja01,C,24,SAC,12,0,71,6,21,.286,0,1,.000,6,20,.300,.286,6,12,.500,2,12,14,6,2,4,2,12,18
370,Jabari Smith\smithja01,C,24,PHI,11,0,110,20,42,.476,0,2,.000,20,40,.500,.476,15,20,.750,6,8,14,5,4,2,3,19,55
371,Joe Smith\smithjo02,C,26,MIN,72,63,1922,297,581,.511,2,3,.667,295,578,.510,.513,171,206,.830,152,301,453,82,39,59,86,250,767
372,Leon Smith\smithle01,C,21,ATL,14,0,100,10,26,.385,0,0,,10,26,.385,.385,11,17,.647,10,21,31,3,5,1,3,12,31
373,Steve Smith\smithst01,SG,32,SAS,77,76,2211,310,682,.455,116,246,.472,194,436,.445,.540,159,181,.878,45,148,193,151,54,15,108,158,895
374,Eric Snow\snower01,PG,28,PHI,61,61,2225,276,624,.442,3,27,.111,273,597,.457,.445,183,227,.806,33,182,215,400,95,9,138,167,738
375,Will Solomon\solomwi01,SG,23,MEM,62,4,872,113,331,.341,46,162,.284,67,169,.396,.411,49,73,.671,12,56,68,92,35,7,62,76,321
376,Felton Spencer\spencfe01,C,34,NYK,32,8,248,6,26,.231,0,0,,6,26,.231,.231,17,33,.515,16,34,50,3,7,8,12,73,29
377,Latrell Sprewell\sprewla01,SF,31,NYK,81,81,3326,573,1419,.404,145,403,.360,428,1016,.421,.455,284,346,.821,59,239,298,313,94,14,223,161,1575
378,Jerry Stackhouse\stackje01,SF,27,DET,76,76,2685,524,1319,.397,86,300,.287,438,1019,.430,.430,495,577,.858,77,238,315,403,77,37,266,163,1629
379,John Starks\starkjo01,SG,36,UTA,66,1,929,114,310,.368,29,95,.305,85,215,.395,.415,33,41,.805,15,53,68,70,33,0,52,126,290
380,Vladimir Stepania\stepavl01,C,25,MIA,67,4,884,117,249,.470,1,2,.500,116,247,.470,.472,50,104,.481,100,170,270,16,24,44,52,103,285
381,DeShawn Stevenson\stevede01,SG,20,UTA,67,23,1134,143,371,.385,2,25,.080,141,346,.408,.388,37,53,.698,44,87,131,116,29,24,68,82,325
382,Michael Stewart\stewami01,C,26,TOR,11,0,93,8,23,.348,0,0,,8,23,.348,.348,6,11,.545,12,13,25,3,4,3,4,22,22
383,Bryant Stith\stithbr01,SG,31,CLE,50,5,665,70,188,.372,24,68,.353,46,120,.383,.436,44,52,.846,20,65,85,42,29,6,30,42,208
384,John Stockton*\stockjo01,PG,39,UTA,82,82,2566,401,775,.517,25,78,.321,376,697,.539,.534,275,321,.857,59,204,263,674,152,24,208,209,1102
385,Peja Stojaković\stojape01,SF,24,SAC,71,71,2649,547,1130,.484,129,310,.416,418,820,.510,.541,283,323,.876,72,301,373,175,81,14,140,120,1506
386,Damon Stoudamire\stoudda01,PG,28,POR,75,71,2796,369,918,.402,104,295,.353,265,623,.425,.459,174,196,.888,78,214,292,490,67,7,149,153,1016
387,Erick Strickland\stricer01,PG,28,BOS,79,4,1643,190,488,.389,95,247,.385,95,241,.394,.487,131,155,.845,22,191,213,184,56,1,94,145,606
388,Mark Strickland\stricma01,SF,31,ATL,46,10,654,91,204,.446,1,4,.250,90,200,.450,.449,25,44,.568,41,90,131,20,19,17,28,48,208
389,Rod Strickland\stricro02,PG,35,MIA,76,64,2294,316,714,.443,8,26,.308,308,688,.448,.448,154,201,.766,49,183,232,463,82,11,159,114,794
390,Bruno Šundov\sundobr01,C,21,IND,22,0,88,16,40,.400,0,1,.000,16,39,.410,.400,0,2,.000,7,14,21,3,3,3,4,16,32
391,Bob Sura\surabo01,PG,28,GSW,78,5,1780,250,590,.424,42,133,.316,208,457,.455,.459,236,328,.720,89,167,256,275,88,17,133,160,778
392,Stromile Swift\swiftst01,PF,22,MEM,68,14,1805,293,611,.480,0,3,.000,293,608,.482,.480,217,305,.711,161,269,430,50,53,113,122,178,803
393,Wally Szczerbiak\szczewa02,SF,24,MIN,82,82,3117,609,1200,.508,87,191,.455,522,1009,.517,.544,226,272,.831,120,271,391,257,66,21,181,188,1531
394,Jason Terry\terryja01,SG,24,ATL,78,78,2967,524,1219,.430,172,444,.387,352,775,.454,.500,284,340,.835,40,230,270,444,144,13,181,156,1504
395,Etan Thomas\thomaet01,C,23,WAS,47,0,618,81,151,.536,0,0,,81,151,.536,.536,41,74,.554,55,126,181,6,17,35,26,76,203
396,Kenny Thomas\thomake01,PF,24,HOU,72,71,2484,396,829,.478,0,16,.000,396,813,.487,.478,223,336,.664,158,358,516,137,85,66,143,195,1015
397,Kurt Thomas\thomaku01,C,29,NYK,82,82,2771,463,938,.494,1,6,.167,462,932,.496,.494,216,265,.815,214,533,747,87,71,79,153,341,1143
398,Tim Thomas\thomati01,SF,24,MIL,74,22,1987,316,753,.420,95,291,.326,221,462,.478,.483,142,179,.793,64,236,300,105,65,32,127,200,869
399,Jamaal Tinsley\tinslja01,PG,23,IND,80,78,2442,289,760,.380,42,175,.240,247,585,.422,.408,131,186,.704,78,220,298,647,138,40,270,248,751
400,Óscar Torres\torreos01,SG,25,HOU,65,13,1075,135,341,.396,37,126,.294,98,215,.456,.450,82,105,.781,47,75,122,40,25,9,49,64,389
401,Robert Traylor\traylro01,PF,24,CHH,61,1,678,87,204,.426,1,1,1.000,86,203,.424,.429,53,84,.631,67,120,187,37,24,37,45,127,228
402,Gary Trent\trentga01,PF,27,MIN,64,10,1140,193,381,.507,0,2,.000,193,379,.509,.507,92,144,.639,104,166,270,60,21,27,58,160,478
403,Jeff Trepagnier\trepaje01,SG,22,CLE,12,0,77,7,23,.304,0,1,.000,7,22,.318,.304,4,7,.571,3,9,12,12,8,4,11,8,18
404,Jake Tsakalidis\tsakaja01,C,22,PHO,67,47,1582,190,400,.475,0,1,.000,190,399,.476,.475,111,159,.698,130,244,374,23,23,69,78,193,491
405,Hedo Türkoğlu\turkohe01,SF,22,SAC,80,10,1970,290,687,.422,63,171,.368,227,516,.440,.468,167,230,.726,63,300,363,163,57,31,81,184,810
406,Nick Van Exel\vanexni01,PG-SG,30,TOT,72,46,2496,501,1226,.409,119,350,.340,382,876,.436,.457,201,251,.801,28,226,254,478,44,11,156,104,1322
406,Nick Van Exel\vanexni01,PG,30,DEN,45,44,1739,372,912,.408,85,252,.337,287,660,.435,.454,136,174,.782,19,150,169,365,30,7,116,69,965
406,Nick Van Exel\vanexni01,SG,30,DAL,27,2,757,129,314,.411,34,98,.347,95,216,.440,.465,65,77,.844,9,76,85,113,14,4,40,35,357
407,Keith Van Horn\vanhoke01,SF,26,NJN,81,81,2465,471,1089,.433,101,293,.345,370,796,.465,.479,156,195,.800,137,472,609,164,63,42,146,221,1199
408,Ratko Varda\vardara01,C,22,DET,1,0,6,2,3,.667,0,0,,2,3,.667,.667,1,1,1.000,0,1,1,0,0,0,1,3,5
409,Jacque Vaughn\vaughja01,PG,26,ATL,82,16,1856,206,438,.470,24,54,.444,182,384,.474,.498,104,126,.825,18,150,168,349,65,2,112,183,540
410,Jake Voskuhl\voskuja01,C,24,PHO,59,34,900,107,193,.554,0,0,,107,193,.554,.554,82,109,.752,103,147,250,18,11,23,48,139,296
411,Antoine Walker\walkean02,PF,25,BOS,81,81,3406,666,1689,.394,222,645,.344,444,1044,.425,.460,240,324,.741,150,564,714,407,122,38,251,237,1794
412,Samaki Walker\walkesa01,PF,25,LAL,69,63,1655,187,365,.512,0,0,,187,365,.512,.512,86,129,.667,129,352,481,64,28,88,53,170,460
413,Ben Wallace*\wallabe01,C,27,DET,80,80,2921,255,480,.531,0,3,.000,255,477,.535,.531,99,234,.423,318,721,1039,115,138,278,70,178,609
414,Gerald Wallace\wallage01,SF,19,SAC,54,1,430,75,175,.429,0,7,.000,75,168,.446,.429,23,46,.500,49,40,89,27,19,6,22,46,173
415,John Wallace\wallajo01,SF,27,PHO,46,0,490,93,214,.435,5,13,.385,88,201,.438,.446,40,46,.870,27,58,85,29,11,9,29,60,231
416,Rasheed Wallace\wallara01,PF,27,POR,79,79,2963,603,1287,.469,114,317,.360,489,970,.504,.513,201,274,.734,136,509,645,152,101,101,131,212,1521
417,Charlie Ward\wardch01,PG,31,NYK,63,0,1058,113,303,.373,53,164,.323,60,139,.432,.460,47,58,.810,15,112,127,203,68,14,75,100,326
418,Earl Watson\watsoea01,PG,22,SEA,64,0,964,96,212,.453,16,44,.364,80,168,.476,.491,23,36,.639,31,52,83,125,60,5,51,93,231
419,Clarence Weatherspoon\weathcl01,PF,31,NYK,56,41,1728,189,452,.418,0,0,,189,452,.418,.418,116,146,.795,149,311,460,60,37,48,47,132,494
420,Chris Webber*\webbech01,PF,28,SAC,54,54,2071,532,1075,.495,5,19,.263,527,1056,.499,.497,253,338,.749,150,396,546,258,90,76,158,181,1322
421,Bonzi Wells\wellsbo01,SG,25,POR,74,69,2348,487,1039,.469,66,172,.384,421,867,.486,.500,215,290,.741,121,323,444,204,113,25,191,208,1255
422,David Wesley\wesleda01,SG,31,CHH,67,63,2487,364,910,.400,85,256,.332,279,654,.427,.447,138,188,.734,44,99,143,236,74,15,119,147,951
423,Jahidi White\whiteja01,C,25,WAS,71,69,1346,150,279,.538,0,0,,150,279,.538,.538,83,154,.539,159,285,444,17,25,75,65,163,383
424,Rodney White\whitero02,SF,21,DET,16,0,129,21,60,.350,2,9,.222,19,51,.373,.367,12,14,.857,2,16,18,12,9,2,14,6,56
425,Chris Whitney\whitnch01,PG,30,WAS,82,81,2171,274,656,.418,131,323,.406,143,333,.429,.518,154,175,.880,11,141,152,314,72,6,85,182,833
426,Aaron Williams\williaa01,PF,30,NJN,82,13,1546,231,439,.526,0,2,.000,231,437,.529,.526,130,186,.699,115,224,339,77,29,76,79,212,592
427,Alvin Williams\willial02,PG,27,TOR,82,82,2927,403,971,.415,62,193,.321,341,778,.438,.447,103,140,.736,58,223,281,468,135,26,150,191,971
428,Eric Williams\willier01,SF,29,BOS,74,30,1747,144,385,.374,24,86,.279,120,299,.401,.405,160,219,.731,58,163,221,109,77,8,95,179,472
429,Jason Williams\willija02,PG,26,MEM,65,65,2236,376,985,.382,127,430,.295,249,555,.449,.446,80,101,.792,22,173,195,519,111,7,214,102,959
430,Jerome Williams\willije01,PF,28,TOR,68,32,1641,190,388,.490,0,0,,190,388,.490,.490,138,204,.676,165,221,386,75,78,25,68,153,518
431,Monty Williams\willimo01,SF,30,ORL,68,19,1284,198,362,.547,0,4,.000,198,358,.553,.547,88,134,.657,80,155,235,96,49,17,86,134,484
432,Scott Williams\willisc01,PF,33,DEN,41,16,737,86,217,.396,0,2,.000,86,215,.400,.396,30,41,.732,82,127,209,13,17,33,35,98,202
433,Shammond Williams\willish01,SG,26,SEA,50,2,603,81,193,.420,28,75,.373,53,118,.449,.492,31,39,.795,16,47,63,83,21,2,35,35,221
434,Walt Williams\williwa02,SF,31,HOU,48,25,1117,166,396,.419,78,183,.426,88,213,.413,.518,40,51,.784,37,125,162,69,18,10,53,106,450
435,Corliss Williamson\willico02,SF,28,DET,78,7,1701,411,806,.510,1,5,.200,410,801,.512,.511,240,298,.805,117,202,319,94,49,26,137,226,1063
436,Kevin Willis\willike02,PF,39,HOU,52,5,865,125,284,.440,0,1,.000,125,283,.442,.440,65,87,.747,105,194,299,14,25,23,41,98,315
437,Loren Woods\woodslo01,C,23,MIN,60,0,516,33,96,.344,0,2,.000,33,94,.351,.344,44,60,.733,46,76,122,22,17,34,36,60,110
438,Metta World Peace\artesro01,SF,22,TOT,55,50,1642,269,636,.423,53,170,.312,216,466,.464,.465,136,204,.667,73,198,271,127,141,39,118,217,727
438,Metta World Peace\artesro01,SF,22,CHI,27,26,823,152,351,.433,36,91,.396,116,260,.446,.484,81,129,.628,40,91,131,77,75,23,69,108,421
438,Metta World Peace\artesro01,SF,22,IND,28,24,819,117,285,.411,17,79,.215,100,206,.485,.440,55,75,.733,33,107,140,50,66,16,49,109,306
439,Lorenzen Wright\wrighlo02,C,26,MEM,43,33,1251,223,486,.459,0,2,.000,223,484,.461,.459,70,123,.569,130,275,405,44,30,23,72,126,516
440,Wang Zhizhi\zhizhwa01,C,24,DAL,55,0,600,109,248,.440,48,116,.414,61,132,.462,.536,42,57,.737,19,92,111,22,11,18,25,84,308