Rk,Player,Pos,Age,Tm,G,GS,MP,FG,FGA,FG%,3P,3PA,3P%,2P,2PA,2P%,eFG%,FT,FTA,FT%,ORB,DRB,TRB,AST,STL,BLK,TOV,PF,PTS
1,Tariq Abdul-Wahad\abdulta01,SG,28,DAL,14,0,204,27,58,.466,0,1,.000,27,57,.474,.466,3,6,.500,14,26,40,21,6,3,7,26,57
2,Shareef Abdur-Rahim\abdursh01,PF,26,ATL,81,81,3087,566,1183,.478,21,60,.350,545,1123,.485,.487,455,541,.841,175,502,677,242,87,38,212,240,1608
3,Courtney Alexander\alexaco02,PG,25,NOH,66,7,1360,193,505,.382,19,57,.333,174,448,.388,.401,118,146,.808,39,79,118,79,31,6,68,125,523
4,Malik Allen\allenma01,PF,24,MIA,80,73,2318,335,790,.424,0,4,.000,335,786,.426,.424,97,121,.802,134,291,425,54,37,78,128,234,767
5,Ray Allen*\allenra02,SG,27,TOT,76,75,2880,598,1363,.439,201,533,.377,397,830,.478,.512,316,345,.916,94,287,381,334,103,14,198,220,1713
5,Ray Allen*\allenra02,SG,27,MIL,47,46,1683,351,803,.437,123,311,.395,228,492,.463,.514,178,195,.913,45,173,218,164,57,11,117,149,1003
5,Ray Allen*\allenra02,SG,27,SEA,29,29,1197,247,560,.441,78,222,.351,169,338,.500,.511,138,150,.920,49,114,163,170,46,3,81,71,710
6,Rafer Alston\alstora01,PG,26,TOR,47,4,980,139,335,.415,51,130,.392,88,205,.429,.491,37,54,.685,21,86,107,192,38,15,86,120,366
7,John Amaechi\amaecjo01,C,32,UTA,50,1,474,37,118,.314,0,0,,37,118,.314,.314,25,52,.481,26,51,77,21,14,7,34,50,99
8,Chris Andersen\anderch01,C,24,DEN,59,3,907,114,285,.400,0,1,.000,114,284,.401,.400,77,140,.550,109,165,274,32,30,60,60,90,305
9,Derek Anderson\anderde01,PG,28,POR,76,76,2556,355,832,.427,116,331,.350,239,501,.477,.496,231,269,.859,53,211,264,325,90,16,128,141,1057
10,Kenny Anderson\anderke01,PG,32,TOT,61,2,1135,163,382,.427,1,7,.143,162,375,.432,.428,45,57,.789,31,101,132,198,58,5,75,106,372
10,Kenny Anderson\anderke01,PG,32,SEA,38,1,689,102,232,.440,0,5,.000,102,227,.449,.440,29,35,.829,17,70,87,121,40,1,33,63,233
10,Kenny Anderson\anderke01,PG,32,NOH,23,1,446,61,150,.407,1,2,.500,60,148,.405,.410,16,22,.727,14,31,45,77,18,4,42,43,139
11,Shandon Anderson\andersh01,SF,29,NYK,82,9,1731,248,537,.462,52,140,.371,196,397,.494,.510,139,190,.732,64,190,254,87,73,20,114,177,687
12,Robert Archibald\archiro01,PF,22,MEM,12,0,72,6,20,.300,0,0,,6,20,.300,.300,7,18,.389,6,11,17,3,0,3,7,9,19
13,Gilbert Arenas\arenagi01,PG,21,GSW,82,82,2866,509,1180,.431,109,313,.348,400,867,.461,.478,370,468,.791,97,289,386,514,124,17,290,260,1497
14,Brandon Armstrong\armstbr01,SG,22,NJN,17,0,69,9,27,.333,1,6,.167,8,21,.381,.352,5,6,.833,0,4,4,2,3,1,5,8,24
15,Darrell Armstrong\armstda01,PG,34,ORL,82,23,2350,263,643,.409,78,232,.336,185,411,.450,.470,165,188,.878,91,204,295,323,135,13,160,167,769
16,Carlos Arroyo\arroyca01,PG,23,UTA,44,0,287,50,109,.459,3,7,.429,47,102,.461,.472,18,22,.818,11,15,26,53,12,1,30,28,121
17,Chucky Atkins\atkinch01,PG,28,DET,65,7,1398,168,465,.361,86,242,.355,82,223,.368,.454,40,49,.816,21,75,96,175,27,4,77,108,462
18,Stacey Augmon\augmost01,SG,34,NOH,70,3,862,79,192,.411,0,7,.000,79,185,.427,.411,54,72,.750,26,93,119,69,27,9,40,80,212
19,Dalibor Bagarić\bagarda01,C,22,CHI,10,0,76,8,26,.308,0,0,,8,26,.308,.308,3,4,.750,7,13,20,4,3,3,5,11,19
20,Vin Baker\bakervi01,C,31,BOS,52,9,942,99,207,.478,0,4,.000,99,203,.488,.478,72,107,.673,90,108,198,29,22,30,61,146,270
21,Brent Barry\barrybr01,SG,31,SEA,75,68,2480,264,577,.458,118,293,.403,146,284,.514,.560,128,161,.795,48,253,301,384,113,15,142,199,774
22,Jon Barry\barryjo01,SG,33,DET,80,0,1473,191,424,.450,87,214,.407,104,210,.495,.553,86,100,.860,33,147,180,206,63,14,81,104,555
23,Maceo Baston\bastoma01,PF,27,TOR,16,0,106,15,25,.600,0,0,,15,25,.600,.600,10,12,.833,4,19,23,0,4,11,6,16,40
24,Mengke Bateer\bateeme01,C,27,SAS,12,0,46,4,17,.235,1,3,.333,3,14,.214,.265,0,2,.000,2,8,10,4,0,0,6,14,9
25,Mike Batiste\batismi01,PF,25,MEM,75,2,1248,197,467,.422,18,81,.222,179,386,.464,.441,69,88,.784,82,175,257,52,42,16,69,120,481
26,Tony Battie\battito01,C,26,BOS,67,62,1683,199,369,.539,1,5,.200,198,364,.544,.541,88,118,.746,148,285,433,49,33,81,48,197,487
27,Shane Battier\battish01,SF,24,MEM,78,47,2383,275,569,.483,86,216,.398,189,353,.535,.559,120,145,.828,128,217,345,105,102,88,68,207,756
28,Lonny Baxter\baxtelo01,C,24,CHI,55,0,682,96,206,.466,0,2,.000,96,204,.471,.466,70,103,.680,65,100,165,16,9,22,46,135,262
29,Raja Bell\bellra01,SG,26,DAL,75,32,1173,93,211,.441,21,51,.412,72,160,.450,.491,23,34,.676,47,98,145,57,52,8,43,134,230
30,Jonathan Bender\bendejo01,SF,22,IND,46,2,819,112,254,.441,19,53,.358,93,201,.463,.478,60,84,.714,42,91,133,42,8,56,42,86,303
31,Corey Benjamin\benjaco01,SG,24,ATL,9,0,152,13,43,.302,2,13,.154,11,30,.367,.326,12,16,.750,10,21,31,10,1,2,6,20,40
32,Travis Best\besttr01,PG,30,MIA,72,52,1807,231,583,.396,36,109,.330,195,474,.411,.427,105,123,.854,26,121,147,255,44,7,106,174,603
33,Mike Bibby\bibbymi01,PG,24,SAC,55,55,1835,329,700,.470,56,137,.409,273,563,.485,.510,161,187,.861,34,113,147,285,72,8,127,93,875
34,Chauncey Billups\billuch01,PG,26,DET,74,74,2327,366,870,.421,149,380,.392,217,490,.443,.506,318,362,.878,38,235,273,287,63,15,134,136,1199
35,Corie Blount\blounco01,C,34,CHI,50,3,836,65,134,.485,0,0,,65,134,.485,.485,20,35,.571,68,137,205,50,33,19,43,121,150
36,Mark Blount\blounma01,C,27,TOT,81,31,1403,150,347,.432,0,0,,150,347,.432,.432,101,139,.727,111,197,308,56,42,68,103,187,401
36,Mark Blount\blounma01,C,27,DEN,54,24,885,105,267,.393,0,0,,105,267,.393,.393,71,99,.717,62,121,183,35,22,51,70,112,281
36,Mark Blount\blounma01,C,27,BOS,27,7,518,45,80,.563,0,0,,45,80,.563,.563,30,40,.750,49,76,125,21,20,17,33,75,120
37,Calvin Booth\boothca01,C,26,SEA,47,0,575,52,119,.437,0,2,.000,52,117,.444,.437,34,47,.723,32,77,109,12,11,33,22,74,138
38,Carlos Boozer\boozeca01,PF,21,CLE,81,54,2049,331,618,.536,0,1,.000,331,617,.536,.536,148,192,.771,202,407,609,106,59,50,103,224,810
39,Ruben Boumtje-Boumtje\boumtru01,C,24,POR,2,0,5,0,1,.000,0,0,,0,1,.000,.000,0,0,,1,0,1,1,1,0,0,0,0
40,Bruce Bowen\bowenbr01,SF,31,SAS,82,82,2566,223,479,.466,101,229,.441,122,250,.488,.571,36,89,.404,59,180,239,113,66,42,72,195,583
41,Ryan Bowen\bowenry01,SG,27,DEN,62,31,996,97,197,.492,2,7,.286,95,190,.500,.497,27,41,.659,78,79,157,54,65,29,43,82,223
42,Earl Boykins\boykiea01,PG,26,GSW,68,0,1321,199,464,.429,29,77,.377,170,387,.439,.460,173,200,.865,35,53,88,221,38,4,73,75,600
43,Michael Bradley\bradlmi01,PF,23,TOR,67,11,1314,151,314,.481,1,6,.167,150,308,.487,.482,35,67,.522,162,247,409,67,16,32,76,125,338
44,Shawn Bradley\bradlsh01,C,30,DAL,81,39,1731,201,375,.536,0,1,.000,201,374,.537,.536,141,175,.806,151,325,476,54,65,170,67,242,543
45,Elton Brand\brandel01,PF,23,LAC,62,61,2454,451,899,.502,0,1,.000,451,898,.502,.502,244,356,.685,283,420,703,157,71,158,161,204,1146
46,J.R. Bremer\bremejr01,PG,22,BOS,64,41,1503,171,464,.369,101,286,.353,70,178,.393,.477,85,111,.766,18,127,145,164,38,3,59,80,528
47,Jamison Brewer\breweja01,PG,22,IND,10,0,80,9,17,.529,0,2,.000,9,15,.600,.529,4,9,.444,5,4,9,18,2,1,6,11,22
48,Primož Brezec\brezepr01,C,23,IND,22,1,111,15,38,.395,0,1,.000,15,37,.405,.395,12,20,.600,13,10,23,4,2,4,7,16,42
49,Damone Brown\brownda02,PF,23,TOR,5,3,115,11,35,.314,0,2,.000,11,33,.333,.314,6,8,.750,3,12,15,3,1,0,6,14,28
50,Devin Brown\brownde02,SG,24,TOT,10,2,93,12,35,.343,0,1,.000,12,34,.353,.343,6,8,.750,8,10,18,7,4,1,9,14,30
50,Devin Brown\brownde02,SG,24,SAS,7,0,22,5,10,.500,0,0,,5,10,.500,.500,2,2,1.000,4,3,7,2,0,0,5,3,12
50,Devin Brown\brownde02,SG,24,DEN,3,2,71,7,25,.280,0,1,.000,7,24,.292,.280,4,6,.667,4,7,11,5,4,1,4,11,18
51,Kedrick Brown\brownke01,SF,21,BOS,51,5,666,61,171,.357,3,39,.077,58,132,.439,.365,20,32,.625,45,95,140,20,34,13,23,68,145
52,Kwame Brown\brownkw01,C,20,WAS,80,20,1773,224,502,.446,0,3,.000,224,499,.449,.446,145,217,.668,128,298,426,58,50,80,110,159,593
53,P.J. Brown\brownpj01,PF,33,NOH,78,78,2609,319,601,.531,0,3,.000,319,598,.533,.531,194,232,.836,243,458,701,147,67,80,98,203,832
54,Randy Brown\brownra02,PG,34,PHO,32,0,262,16,43,.372,0,0,,16,43,.372,.372,9,12,.750,3,23,26,35,17,2,17,36,41
55,Tierre Brown\brownti01,PG,23,CLE,15,0,168,27,59,.458,0,1,.000,27,58,.466,.458,11,14,.786,8,22,30,39,13,0,22,9,65
56,Rick Brunson\brunsri01,PG,30,CHI,17,0,196,23,50,.460,4,6,.667,19,44,.432,.500,10,12,.833,4,15,19,36,10,3,17,20,60
57,Kobe Bryant*\bryanko01,SG,24,LAL,82,82,3401,868,1924,.451,124,324,.383,744,1600,.465,.483,601,713,.843,106,458,564,481,181,67,288,218,2461
58,Mark Bryant\bryanma01,PF,37,TOT,16,0,100,5,19,.263,0,0,,5,19,.263,.263,3,4,.750,8,12,20,4,1,1,7,18,13
58,Mark Bryant\bryanma01,PF,37,PHI,11,0,77,5,17,.294,0,0,,5,17,.294,.294,2,2,1.000,7,9,16,1,1,1,5,12,12
58,Mark Bryant\bryanma01,PF,37,DEN,3,0,14,0,1,.000,0,0,,0,1,.000,.000,1,2,.500,1,1,2,2,0,0,2,4,1
58,Mark Bryant\bryanma01,PF,37,BOS,2,0,9,0,1,.000,0,0,,0,1,.000,.000,0,0,,0,2,2,1,0,0,0,2,0
59,Greg Buckner\buckngr01,SG,26,PHI,75,5,1514,185,398,.465,15,55,.273,170,343,.496,.484,65,81,.802,72,144,216,96,72,16,62,203,450
60,Pat Burke\burkepa01,C,29,ORL,62,8,783,113,296,.382,1,7,.143,112,289,.388,.383,40,58,.690,57,89,146,23,19,25,47,99,267
61,Caron Butler\butleca01,SF,22,MIA,78,78,2858,429,1032,.416,34,107,.318,395,925,.427,.432,309,375,.824,135,262,397,213,137,31,192,230,1201
62,Rasual Butler\butlera01,SG,23,MIA,72,28,1514,207,572,.362,50,171,.292,157,401,.392,.406,76,104,.731,29,157,186,93,21,43,77,105,540
63,Jason Caffey\caffeja01,PF,29,MIL,51,16,894,113,248,.456,0,0,,113,248,.456,.456,69,106,.651,68,108,176,38,19,15,56,122,295
64,Marcus Camby\cambyma01,C,28,DEN,29,9,616,93,227,.410,2,5,.400,91,222,.410,.414,33,50,.660,75,133,208,47,20,40,27,69,221
65,Elden Campbell\campbel01,C,34,TOT,56,1,869,117,295,.397,0,1,.000,117,294,.398,.397,109,136,.801,47,134,181,51,33,39,50,129,343
65,Elden Campbell\campbel01,C,34,NOH,41,1,685,101,247,.409,0,1,.000,101,246,.411,.409,93,115,.809,34,108,142,42,24,31,42,102,295
65,Elden Campbell\campbel01,C,34,SEA,15,0,184,16,48,.333,0,0,,16,48,.333,.333,16,21,.762,13,26,39,9,9,8,8,27,48
66,Brian Cardinal\cardibr01,PF,25,WAS,5,0,15,1,4,.250,0,1,.000,1,3,.333,.250,2,2,1.000,3,2,5,1,0,0,1,0,4
67,Anthony Carter\cartean01,PG,27,MIA,49,26,912,83,233,.356,0,8,.000,83,225,.369,.356,33,50,.660,12,71,83,203,45,5,81,70,199
68,Vince Carter\cartevi01,SG,26,TOR,43,42,1471,355,760,.467,45,131,.344,310,629,.493,.497,129,160,.806,59,129,188,143,48,41,74,121,884
69,Sam Cassell\cassesa01,PG,33,MIL,78,77,2700,546,1162,.470,59,163,.362,487,999,.487,.495,385,447,.861,57,285,342,450,88,14,177,216,1536
70,Kelvin Cato\catoke01,C,28,HOU,73,5,1247,133,256,.520,0,4,.000,133,252,.528,.520,66,124,.532,132,296,428,20,38,85,56,176,332
71,Tyson Chandler\chandty01,C,20,CHI,75,68,1827,257,484,.531,0,0,,257,484,.531,.531,177,291,.608,169,345,514,76,37,106,135,220,691
72,Calbert Cheaney\cheanca01,SG,31,UTA,81,74,2351,325,651,.499,10,25,.400,315,626,.503,.507,40,69,.580,73,211,284,163,65,13,108,225,700
73,Chris Childs\childch01,PG,35,NJN,12,0,106,6,20,.300,1,6,.167,5,14,.357,.325,2,3,.667,3,2,5,16,8,1,6,17,15
74,Doug Christie\chrisdo01,SG,32,SAC,80,80,2710,267,557,.479,73,185,.395,194,372,.522,.545,141,174,.810,61,281,342,376,180,37,144,186,748
75,Keon Clark\clarkke01,C,27,SAC,80,11,1780,226,451,.501,0,4,.000,226,447,.506,.501,84,128,.656,138,313,451,80,38,150,94,227,536
76,Speedy Claxton\claxtsp01,PG,24,SAS,30,0,471,67,145,.462,0,11,.000,67,134,.500,.462,39,57,.684,22,34,56,75,22,7,35,43,173
77,Mateen Cleaves\cleavma01,PG,25,SAC,12,0,55,6,23,.261,1,1,1.000,5,22,.227,.283,3,4,.750,1,7,8,10,2,0,14,6,16
78,Derrick Coleman\colemde01,C,35,PHI,64,35,1742,223,498,.448,22,67,.328,201,431,.466,.470,134,171,.784,151,299,450,87,53,69,96,171,602
79,Bimbo Coles\colesbi01,PG,34,TOT,35,11,691,56,168,.333,7,32,.219,49,136,.360,.354,35,42,.833,11,48,59,72,17,4,28,60,154
79,Bimbo Coles\colesbi01,PG,34,CLE,21,11,516,34,119,.286,7,25,.280,27,94,.287,.315,27,34,.794,10,38,48,56,11,4,18,43,102
79,Bimbo Coles\colesbi01,PG,34,BOS,14,0,175,22,49,.449,0,7,.000,22,42,.524,.449,8,8,1.000,1,10,11,16,6,0,10,17,52
80,Jason Collier\collija02,C,25,HOU,13,3,104,17,36,.472,0,0,,17,36,.472,.472,2,2,1.000,12,17,29,1,2,1,2,10,36
81,Jarron Collins\collija03,C,24,UTA,22,7,421,38,86,.442,0,1,.000,38,85,.447,.442,44,62,.710,32,28,60,14,5,6,19,70,120
82,Jason Collins\collija04,C,24,NJN,81,66,1900,140,338,.414,0,4,.000,140,334,.419,.414,180,236,.763,136,232,368,87,47,44,85,252,460
83,Chris Crawford\crawfch01,PF,27,ATL,5,0,38,8,13,.615,1,3,.333,7,10,.700,.654,7,8,.875,3,4,7,1,2,3,2,7,24
84,Jamal Crawford\crawfja01,PG,22,CHI,80,31,1992,334,808,.413,86,242,.355,248,566,.438,.467,104,129,.806,21,164,185,334,77,25,134,126,858
85,Austin Croshere\croshau01,PF,27,IND,49,0,633,86,209,.411,27,69,.391,59,140,.421,.476,53,65,.815,40,115,155,56,6,13,28,48,252
86,John Crotty\crottjo01,PG,33,DEN,12,0,180,14,41,.341,4,13,.308,10,28,.357,.390,9,15,.600,1,14,15,29,3,0,9,16,41
87,Eddy Curry\curryed01,C,20,CHI,81,48,1571,335,573,.585,0,0,,335,573,.585,.585,179,287,.624,116,237,353,37,18,62,137,226,849
88,Michael Curry\currymi01,SF,34,DET,78,77,1555,92,229,.402,16,54,.296,76,175,.434,.437,36,45,.800,16,111,127,104,44,4,43,163,236
89,Erick Dampier\dampier01,C,27,GSW,82,82,1978,259,522,.496,0,2,.000,259,520,.498,.496,155,222,.698,248,295,543,58,27,154,112,242,673
90,Antonio Daniels\daniean01,SG,27,POR,67,2,872,84,186,.452,18,59,.305,66,127,.520,.500,65,76,.855,11,61,72,85,33,9,32,43,251
91,Antonio Davis\davisan01,C,34,TOR,53,52,1894,261,641,.407,0,0,,261,641,.407,.407,216,280,.771,130,307,437,131,23,62,118,150,738
92,Baron Davis\davisba01,PG,23,NOH,50,47,1889,332,798,.416,99,283,.350,233,515,.452,.478,93,131,.710,56,130,186,320,91,22,140,148,856
93,Dale Davis\davisda01,C,33,POR,78,78,2282,237,438,.541,0,0,,237,438,.541,.541,105,166,.633,233,331,564,94,51,70,71,189,579
94,Emanual Davis\davisem01,SG,34,ATL,24,1,340,32,88,.364,7,29,.241,25,59,.424,.403,17,22,.773,5,38,43,36,12,2,25,28,88
95,Hubert Davis\davishu01,SG,32,DET,43,1,328,31,79,.392,12,36,.333,19,43,.442,.468,5,6,.833,6,30,36,29,5,0,11,23,79
96,Ricky Davis\davisri01,SG,23,CLE,79,76,3131,602,1470,.410,74,204,.363,528,1266,.417,.435,348,465,.748,97,293,390,436,125,36,277,180,1626
97,Andrew DeClercq\declean01,C,29,ORL,77,21,1327,149,279,.534,0,0,,149,279,.534,.534,67,104,.644,142,197,339,52,39,36,84,258,365
98,Tony Delk\delkto01,PG,29,BOS,67,39,1873,233,560,.416,120,304,.395,113,256,.441,.523,68,87,.782,41,191,232,146,72,10,69,124,654
99,Dan Dickau\dickada01,PG,24,ATL,50,0,515,70,170,.412,22,61,.361,48,109,.440,.476,21,26,.808,9,34,43,85,14,2,53,66,183
100,Michael Dickerson\dickemi01,SG,27,MEM,6,1,87,10,24,.417,4,11,.364,6,13,.462,.500,5,5,1.000,1,5,6,8,5,1,6,16,29
101,DeSagana Diop\diopde01,PF,21,CLE,80,1,943,54,154,.351,0,0,,54,154,.351,.351,11,30,.367,63,152,215,43,33,81,56,148,119
102,Vlade Divac*\divacvl01,C,34,SAC,80,80,2384,305,655,.466,6,25,.240,299,630,.475,.470,179,251,.713,157,417,574,274,83,105,152,239,795
103,Juan Dixon\dixonju01,PG,24,WAS,42,3,647,104,271,.384,25,84,.298,79,187,.422,.430,37,46,.804,13,59,72,40,26,3,42,54,270
104,Michael Doleac\doleami01,C,25,NYK,75,0,1041,146,343,.426,0,0,,146,343,.426,.426,36,46,.783,65,154,219,42,16,16,49,150,328
105,Keyon Dooling\doolike01,SG,22,LAC,55,1,969,128,329,.389,50,139,.360,78,190,.411,.465,44,57,.772,9,63,72,89,24,6,60,93,350
106,Bryce Drew\drewbr01,PG,28,NOH,13,0,79,8,27,.296,3,7,.429,5,20,.250,.352,0,0,,4,9,13,11,2,0,3,2,19
107,Predrag Drobnjak\drobnpr01,C,27,SEA,82,69,1984,325,789,.412,30,85,.353,295,704,.419,.431,91,115,.791,111,209,320,86,48,38,65,180,771
108,Chris Dudley\dudlech02,C,37,POR,3,0,11,0,1,.000,0,0,,0,1,.000,.000,0,0,,2,0,2,0,0,0,0,3,0
109,Tim Duncan*\duncati01,PF,26,SAS,81,81,3181,714,1392,.513,6,22,.273,708,1370,.517,.515,450,634,.710,259,784,1043,316,55,237,248,231,1884
110,Mike Dunleavy\dunlemi02,SF,22,GSW,82,3,1305,168,417,.403,52,150,.347,116,267,.434,.465,78,100,.780,66,148,214,106,53,19,86,120,466
111,Howard Eisley\eisleho01,PG,30,NYK,82,76,2243,262,628,.417,131,337,.389,131,291,.450,.521,89,105,.848,24,162,186,444,71,9,149,222,744
112,LaPhonso Ellis\ellisla01,PF,32,MIA,55,3,784,100,262,.382,27,107,.252,73,155,.471,.433,50,66,.758,44,113,157,15,15,15,31,88,277
113,Melvin Ely\elyme01,C,24,LAC,52,7,802,92,186,.495,0,0,,92,186,.495,.495,52,74,.703,64,110,174,15,10,32,50,95,236
114,Evan Eschmeyer\eschmev01,C,27,DAL,17,3,135,7,19,.368,0,0,,7,19,.368,.368,3,4,.750,10,19,29,6,10,7,6,35,17
115,Reggie Evans\evansre01,PF,22,SEA,67,60,1365,66,140,.471,0,0,,66,140,.471,.471,80,154,.519,167,278,445,34,38,11,52,173,212
116,Danny Ferry\ferryda01,SF,36,SAS,64,1,601,44,124,.355,21,60,.350,23,64,.359,.440,10,13,.769,20,55,75,21,7,9,27,55,119
117,Michael Finley\finlemi01,SF,29,DAL,69,69,2642,507,1193,.425,119,322,.370,388,871,.445,.475,198,230,.861,107,295,402,205,76,21,114,105,1331
118,Derek Fisher\fishede01,PG,28,LAL,82,82,2829,339,775,.437,85,212,.401,254,563,.451,.492,100,125,.800,40,199,239,298,93,15,94,195,863
119,Marcus Fizer\fizerma01,PF,24,CHI,38,0,809,178,383,.465,1,6,.167,177,377,.469,.466,88,134,.657,80,136,216,48,14,17,57,89,445
120,Alton Ford\fordal02,PF,21,PHO,11,0,31,3,9,.333,0,0,,3,9,.333,.333,1,3,.333,0,6,6,1,0,0,2,7,7
121,Joseph Forte\fortejo01,SG,21,SEA,17,0,86,10,35,.286,0,3,.000,10,32,.313,.286,4,6,.667,4,7,11,11,4,0,10,6,24
122,Danny Fortson\fortsda01,PF,26,GSW,17,0,223,20,54,.370,0,1,.000,20,53,.377,.370,19,29,.655,28,45,73,12,9,0,15,43,59
123,Greg Foster\fostegr01,C,34,TOR,29,9,539,47,122,.385,1,4,.250,46,118,.390,.389,26,32,.813,30,72,102,13,1,9,30,82,121
124,Jeff Foster\fosteje01,C,26,IND,77,2,802,64,178,.360,0,2,.000,64,176,.364,.360,34,63,.540,118,161,279,51,28,21,34,103,162
125,Tremaine Fowlkes\fowlktr01,SF,26,LAC,37,10,573,56,128,.438,2,9,.222,54,119,.454,.445,50,59,.847,41,62,103,23,25,2,20,63,164
126,Rick Fox\foxri01,SF,33,LAL,76,75,2181,262,621,.422,105,280,.375,157,341,.460,.506,52,69,.754,64,259,323,253,69,14,121,215,681
127,Adonal Foyle\foylead01,C,27,GSW,82,0,1787,185,345,.536,0,1,.000,185,344,.538,.536,70,104,.673,176,314,490,37,40,205,73,214,440
128,Steve Francis\francst01,PG,25,HOU,81,81,3318,571,1312,.435,85,240,.354,486,1072,.453,.468,476,595,.800,159,340,499,502,141,41,299,251,1703
129,Lawrence Funderburke\fundela01,PF,32,SAC,27,0,229,32,72,.444,0,0,,32,72,.444,.444,10,17,.588,17,38,55,8,1,11,6,25,74
130,Dan Gadzuric\gadzuda01,C,24,MIL,49,30,760,70,145,.483,0,1,.000,70,144,.486,.483,29,56,.518,66,131,197,9,22,52,27,125,169
131,Kevin Garnett*\garneke01,PF,26,MIN,82,82,3321,743,1481,.502,20,71,.282,723,1410,.513,.508,377,502,.751,244,858,1102,495,113,129,229,199,1883
132,Pat Garrity\garripa01,PF,26,ORL,81,53,2584,312,744,.419,161,407,.396,151,337,.448,.528,83,100,.830,72,234,306,121,62,20,77,255,868
133,Pau Gasol\gasolpa01,PF,22,MEM,82,82,2948,569,1116,.510,1,10,.100,568,1106,.514,.510,416,565,.736,192,528,720,229,34,148,213,220,1555
134,Devean George\georgde01,SF,25,LAL,71,7,1613,180,461,.390,49,132,.371,131,329,.398,.444,83,105,.790,91,195,286,92,56,38,65,180,492
135,Kendall Gill\gillke01,SG,34,MIN,82,34,2068,286,677,.422,19,59,.322,267,618,.432,.436,123,161,.764,51,197,248,156,78,15,108,176,714
136,Manu Ginóbili*\ginobma01,SG,25,SAS,69,5,1431,174,397,.438,51,148,.345,123,249,.494,.503,126,171,.737,47,114,161,138,96,17,100,170,525
137,Gordan Giriček\giricgo01,SG-SF,25,TOT,76,62,2148,350,803,.436,85,249,.341,265,554,.478,.489,150,183,.820,36,202,238,137,52,8,145,159,935
137,Gordan Giriček\giricgo01,SG,25,MEM,49,35,1187,207,478,.433,46,130,.354,161,348,.463,.481,88,107,.822,18,90,108,70,22,6,94,104,548
137,Gordan Giriček\giricgo01,SF,25,ORL,27,27,961,143,325,.440,39,119,.328,104,206,.505,.500,62,76,.816,18,112,130,67,30,2,51,55,387
138,Dion Glover\glovedi01,SG,24,ATL,76,42,1890,277,648,.427,56,158,.354,221,490,.451,.471,127,162,.784,62,220,282,141,71,15,108,146,737
139,Anthony Goldwire\goldwan01,PG,31,TOT,15,0,85,9,25,.360,3,9,.333,6,16,.375,.420,4,7,.571,0,6,6,4,3,0,6,6,25
139,Anthony Goldwire\goldwan01,PG,31,SAS,10,0,51,5,18,.278,2,8,.250,3,10,.300,.333,0,2,.000,0,3,3,3,3,0,2,5,12
139,Anthony Goldwire\goldwan01,PG,31,WAS,5,0,34,4,7,.571,1,1,1.000,3,6,.500,.643,4,5,.800,0,3,3,1,0,0,4,1,13
140,Drew Gooden\goodedr01,SF-PF,21,TOT,70,47,1873,355,777,.457,14,48,.292,341,729,.468,.466,151,212,.712,163,292,455,83,53,35,150,172,875
140,Drew Gooden\goodedr01,SF,21,MEM,51,29,1329,255,576,.443,14,46,.304,241,530,.455,.455,92,132,.697,105,190,295,63,38,22,105,121,616
140,Drew Gooden\goodedr01,PF,21,ORL,19,18,544,100,201,.498,0,2,.000,100,199,.503,.498,59,80,.738,58,102,160,20,15,13,45,51,259
141,Brian Grant\grantbr01,C,30,MIA,82,82,2641,344,676,.509,0,0,,344,676,.509,.509,158,205,.771,241,596,837,104,63,47,129,300,846
142,Horace Grant\grantho01,PF,37,ORL,5,1,85,13,25,.520,0,0,,13,25,.520,.520,0,0,,2,6,8,7,3,0,1,5,26
143,Adrian Griffin\griffad01,SG,28,DAL,74,48,1373,146,337,.433,6,24,.250,140,313,.447,.442,27,32,.844,88,176,264,105,77,6,47,157,325
144,Eddie Griffin\griffed01,PF,20,HOU,77,66,1890,271,678,.400,64,192,.333,207,486,.426,.447,58,94,.617,138,323,461,86,52,111,76,136,664
145,Tom Gugliotta\guglito01,PF,33,PHO,27,11,447,60,132,.455,0,1,.000,60,131,.458,.455,9,9,1.000,25,75,100,31,14,5,31,35,129
146,A.J. Guyton\guytoaj01,PG,24,GSW,2,0,9,0,4,.000,0,1,.000,0,3,.000,.000,0,0,,0,0,0,2,1,0,1,0,0
147,Marcus Haislip\haislma01,PF,22,MIL,39,8,441,66,153,.431,3,12,.250,63,141,.447,.441,26,38,.684,21,32,53,9,7,18,21,55,161
148,Darvin Ham\hamda01,SG,29,ATL,75,1,926,71,159,.447,0,3,.000,71,156,.455,.447,38,79,.481,73,80,153,38,16,19,65,127,180
149,Richard Hamilton\hamilri01,SG,24,DET,82,82,2640,570,1286,.443,32,119,.269,538,1167,.461,.456,440,528,.833,88,230,318,208,64,13,200,249,1612
150,Zendon Hamilton\hamilze01,C,27,TOR,3,0,12,2,5,.400,0,0,,2,5,.400,.400,2,2,1.000,1,3,4,0,1,0,1,2,6
151,Anfernee Hardaway\hardaan01,SG,31,PHO,58,51,1777,256,573,.447,26,73,.356,230,500,.460,.469,77,97,.794,66,192,258,235,66,26,145,150,615
152,Tim Hardaway*\hardati01,PG,36,IND,10,0,127,18,49,.367,11,31,.355,7,18,.389,.480,2,4,.500,1,14,15,24,9,0,11,8,49
153,Matt Harpring\harprma01,SF,26,UTA,78,69,2557,521,1020,.511,66,160,.413,455,860,.529,.543,262,331,.792,190,324,514,133,73,17,160,217,1370
154,Adam Harrington\harriad01,SG,22,TOT,19,0,111,11,37,.297,5,14,.357,6,23,.261,.365,3,4,.750,1,7,8,12,2,1,2,8,30
154,Adam Harrington\harriad01,SG,22,DAL,13,0,37,4,17,.235,1,3,.333,3,14,.214,.265,2,2,1.000,0,2,2,2,1,1,2,2,11
154,Adam Harrington\harriad01,SG,22,DEN,6,0,74,7,20,.350,4,11,.364,3,9,.333,.450,1,2,.500,1,5,6,10,1,0,0,6,19
155,Al Harrington\harrial01,SF,22,IND,82,37,2467,389,896,.434,13,46,.283,376,850,.442,.441,211,274,.770,159,352,511,125,71,33,163,280,1002
156,Junior Harrington\harriju01,PG,22,DEN,82,51,2003,169,467,.362,7,28,.250,162,439,.369,.369,73,112,.652,44,206,250,277,80,15,157,250,418
157,Othella Harrington\harriot01,PF,29,NYK,74,64,1850,225,443,.508,0,0,,225,443,.508,.508,123,150,.820,165,311,476,62,12,23,90,231,573
158,Lucious Harris\harrilu01,SG,32,NJN,77,25,1973,298,721,.413,47,136,.346,251,585,.429,.446,152,189,.804,63,169,232,155,53,8,71,95,795
159,Antonio Harvey\harvean01,PF,32,ATL,4,0,32,2,5,.400,0,0,,2,5,.400,.400,0,0,,1,5,6,0,1,4,3,7,4
160,Donnell Harvey\harvedo01,SF,22,DEN,77,27,1613,246,551,.446,1,7,.143,245,544,.450,.447,118,176,.670,125,284,409,100,48,27,123,203,611
161,Trenton Hassell\hassetr01,SG,23,CHI,82,53,1999,144,392,.367,13,40,.325,131,352,.372,.384,41,55,.745,37,218,255,151,45,61,83,197,342
162,Kirk Haston\hastoki01,SF,23,NOH,12,0,57,2,17,.118,0,3,.000,2,14,.143,.118,2,4,.500,0,7,7,3,0,5,7,10,6
163,Juaquin Hawkins\hawkiju01,SG,29,HOU,58,10,685,57,148,.385,10,24,.417,47,124,.379,.419,10,20,.500,16,62,78,47,29,6,29,57,134
164,Brendan Haywood\haywobr01,C,23,WAS,81,69,1930,173,339,.510,0,0,,173,339,.510,.510,155,245,.633,192,212,404,29,32,119,65,225,501
165,Alan Henderson\hendeal01,C,30,ATL,82,3,1494,153,327,.468,0,2,.000,153,325,.471,.468,88,138,.638,156,242,398,41,33,32,61,168,394
166,Nenê\hilarne01,C,20,DEN,80,53,2258,321,619,.519,0,3,.000,321,616,.521,.519,197,341,.578,208,283,491,149,127,65,181,295,839
167,Grant Hill*\hillgr01,SF,30,ORL,29,29,843,151,307,.492,1,4,.250,150,303,.495,.493,118,144,.819,40,166,206,122,28,13,84,46,421
168,Tyrone Hill\hillty01,PF,34,TOT,56,43,1351,129,306,.422,0,0,,129,306,.422,.422,54,80,.675,126,265,391,41,46,26,68,172,312
168,Tyrone Hill\hillty01,PF,34,CLE,32,25,855,85,197,.431,0,0,,85,197,.431,.431,33,45,.733,70,197,267,32,31,19,52,104,203
168,Tyrone Hill\hillty01,PF,34,PHI,24,18,496,44,109,.404,0,0,,44,109,.404,.404,21,35,.600,56,68,124,9,15,7,16,68,109
169,Fred Hoiberg\hoibefr01,SG,30,CHI,63,0,784,49,126,.389,5,21,.238,44,105,.419,.409,41,50,.820,11,126,137,70,40,5,25,59,144
170,Robert Horry\horryro01,PF,32,LAL,80,26,2343,184,476,.387,51,177,.288,133,299,.445,.440,103,134,.769,181,333,514,233,96,61,112,247,522
171,Eddie House\houseed01,SG,24,MIA,55,7,1025,172,444,.387,36,120,.300,136,324,.420,.428,31,36,.861,17,84,101,87,44,1,46,73,411
172,Allan Houston\houstal01,SG,31,NYK,82,82,3108,652,1465,.445,178,450,.396,474,1015,.467,.506,363,395,.919,26,205,231,220,54,7,178,191,1845
173,Juwan Howard\howarju01,PF,29,DEN,77,77,2730,567,1261,.450,2,4,.500,565,1257,.449,.450,282,351,.803,181,404,585,234,77,27,189,239,1418
174,Troy Hudson\hudsotr01,PG,26,MIN,79,74,2600,409,956,.428,97,266,.365,312,690,.452,.479,208,231,.900,42,141,183,452,60,7,182,160,1123
175,Nate Huffman\huffmna01,C,27,TOR,7,0,76,9,25,.360,0,0,,9,25,.360,.360,5,8,.625,9,14,23,5,1,3,3,13,23
176,Larry Hughes\hughela01,PG,24,WAS,67,56,2137,346,741,.467,29,79,.367,317,662,.479,.487,136,186,.731,67,241,308,205,86,24,136,149,857
177,Ryan Humphrey\humphry01,PF,23,TOT,48,1,444,35,120,.292,0,0,,35,120,.292,.292,23,39,.590,34,65,99,11,9,18,23,75,93
177,Ryan Humphrey\humphry01,PF,23,ORL,35,1,322,23,85,.271,0,0,,23,85,.271,.271,18,28,.643,30,39,69,7,4,16,21,57,64
177,Ryan Humphrey\humphry01,PF,23,MEM,13,0,122,12,35,.343,0,0,,12,35,.343,.343,5,11,.455,4,26,30,4,5,2,2,18,29
178,Lindsey Hunter\hunteli01,PG,32,TOR,29,0,673,106,302,.351,34,107,.318,72,195,.369,.407,34,47,.723,15,44,59,71,35,5,57,50,280
179,Steven Hunter\huntest01,C,21,ORL,33,5,447,56,103,.544,0,0,,56,103,.544,.544,18,44,.409,38,55,93,6,9,36,15,56,130
180,Zydrunas Ilgauskas\ilgauzy01,C,27,CLE,81,81,2432,495,1122,.441,0,5,.000,495,1117,.443,.441,400,512,.781,240,371,611,127,56,152,210,274,1390
181,Allen Iverson*\iversal01,SG,27,PHI,82,82,3485,804,1940,.414,84,303,.277,720,1637,.440,.436,570,736,.774,68,276,344,454,225,13,286,149,2262
182,Bobby Jackson\jacksbo01,PG,29,SAC,59,26,1676,340,732,.464,89,235,.379,251,497,.505,.525,126,149,.846,57,162,219,182,71,3,106,126,895
183,Jermaine Jackson\jacksje01,SG,26,TOT,53,1,559,40,110,.364,1,10,.100,39,100,.390,.368,40,55,.727,19,38,57,74,19,6,34,51,121
183,Jermaine Jackson\jacksje01,SG,26,TOR,24,1,286,21,68,.309,1,9,.111,20,59,.339,.316,23,27,.852,10,15,25,39,9,3,19,24,66
183,Jermaine Jackson\jacksje01,SG,26,ATL,29,0,273,19,42,.452,0,1,.000,19,41,.463,.452,17,28,.607,9,23,32,35,10,3,15,27,55
184,Jim Jackson\jacksji01,SF,32,SAC,63,0,1309,204,462,.442,32,71,.451,172,391,.440,.476,47,55,.855,84,178,262,118,31,4,80,132,487
185,Marc Jackson\jacksma02,C,28,MIN,77,0,1041,153,349,.438,1,1,1.000,152,348,.437,.440,114,149,.765,86,139,225,37,24,30,59,137,421
186,Mark Jackson\jacksma01,PG,37,UTA,82,0,1467,147,369,.398,27,95,.284,120,274,.438,.435,61,80,.763,34,142,176,375,48,3,152,90,382
187,Stephen Jackson\jacksst02,SG,24,SAS,80,58,2254,356,818,.435,95,297,.320,261,521,.501,.493,139,183,.760,66,220,286,183,125,30,176,202,946
188,Casey Jacobsen\jacobca01,SF,21,PHO,72,0,1147,122,327,.373,52,165,.315,70,162,.432,.453,72,105,.686,29,54,83,73,35,6,55,90,368
189,Jerome James\jamesje01,C,27,SEA,51,16,766,111,232,.478,0,0,,111,232,.478,.478,54,92,.587,78,138,216,27,12,82,75,166,276
190,Mike James\jamesmi01,PG,27,MIA,78,8,1722,218,585,.373,67,228,.294,151,357,.423,.430,104,142,.732,26,123,149,246,64,5,108,176,607
191,Antawn Jamison\jamisan01,SF,26,GSW,82,82,3226,691,1471,.470,65,209,.311,626,1262,.496,.492,375,475,.789,195,383,578,156,76,45,177,197,1822
192,Marko Jarić\jaricma01,SF,24,LAC,66,12,1379,179,446,.401,53,166,.319,126,280,.450,.461,79,105,.752,35,125,160,193,97,11,103,125,490
193,Chris Jefferies\jeffech01,SF,22,TOR,51,10,666,75,194,.387,18,54,.333,57,140,.407,.433,29,43,.674,16,43,59,22,19,16,45,56,197
194,Richard Jefferson\jefferi01,SF,22,NJN,80,80,2879,456,911,.501,6,24,.250,450,887,.507,.504,324,436,.743,150,364,514,201,80,44,156,216,1242
195,Jared Jeffries\jeffrja01,SF,21,WAS,20,1,292,30,63,.476,3,6,.500,27,57,.474,.500,16,29,.552,26,32,58,16,8,5,21,28,79
196,Anthony Johnson\johnsan02,PG,28,NJN,66,2,842,103,231,.446,13,35,.371,90,196,.459,.474,51,74,.689,13,65,78,86,37,5,41,93,270
197,Avery Johnson\johnsav01,PG,37,DAL,48,0,430,63,150,.420,0,2,.000,63,148,.426,.420,30,39,.769,10,21,31,64,15,1,29,26,156
198,Ervin Johnson\johnser02,C,35,MIL,69,17,1170,61,135,.452,0,0,,61,135,.452,.452,30,44,.682,117,177,294,24,34,63,34,178,152
199,Joe Johnson\johnsjo02,SG,21,PHO,82,34,2255,316,796,.397,75,205,.366,241,591,.408,.444,96,124,.774,57,207,264,210,62,19,108,143,803
200,Ken Johnson\johnske03,C,24,MIA,16,0,156,15,37,.405,0,0,,15,37,.405,.405,2,6,.333,4,28,32,0,1,12,6,20,32
201,Damon Jones\jonesda01,PG,26,SAC,49,1,709,80,210,.381,44,121,.364,36,89,.404,.486,20,27,.741,11,59,70,80,18,4,23,42,224
202,Eddie Jones\jonesed02,SG,31,MIA,47,47,1789,291,688,.423,98,241,.407,193,447,.432,.494,189,230,.822,35,191,226,173,64,31,85,137,869
203,Fred Jones\jonesfr01,SG,23,IND,19,1,115,9,24,.375,2,7,.286,7,17,.412,.417,3,4,.750,4,5,9,5,6,1,6,13,23
204,Jumaine Jones\jonesju01,SF,23,CLE,80,12,2204,308,710,.434,111,314,.354,197,396,.497,.512,57,83,.687,106,299,405,112,67,22,107,176,784
205,Popeye Jones\jonespo01,PF,32,DAL,26,0,222,24,62,.387,0,0,,24,62,.387,.387,5,11,.455,29,30,59,8,5,1,15,31,53
206,Michael Jordan*\jordami01,SF,39,WAS,82,67,3031,679,1527,.445,16,55,.291,663,1472,.450,.450,266,324,.821,71,426,497,311,123,39,173,171,1640
207,Shawn Kemp\kempsh01,C,33,ORL,79,55,1633,211,505,.418,0,1,.000,211,504,.419,.418,115,155,.742,147,304,451,55,66,33,102,239,537
208,Steve Kerr\kerrst01,PG,37,SAS,75,0,952,110,256,.430,49,124,.395,61,132,.462,.525,30,34,.882,12,48,60,70,27,3,35,49,299
209,Jason Kidd*\kiddja01,PG,29,NJN,80,80,2989,515,1244,.414,126,370,.341,389,874,.445,.465,339,403,.841,110,394,504,711,179,25,296,127,1495
210,Andrei Kirilenko\kirilan01,SF,21,UTA,80,11,2213,315,642,.491,37,114,.325,278,528,.527,.519,296,370,.800,147,273,420,138,118,175,136,185,963
211,Kerry Kittles\kittlke01,SG,28,NJN,65,57,1951,332,711,.467,78,219,.356,254,492,.516,.522,106,135,.785,52,200,252,170,101,30,55,110,848
212,Brevin Knight\knighbr01,PG,27,MEM,55,4,928,97,228,.425,2,8,.250,95,220,.432,.430,20,37,.541,15,66,81,233,69,2,94,123,216
213,Travis Knight\knightr01,C,28,NYK,32,0,287,25,65,.385,0,1,.000,25,64,.391,.385,10,13,.769,18,44,62,14,8,9,10,44,60
214,Toni Kukoč*\kukocto01,PF,34,MIL,63,0,1704,249,577,.432,95,263,.361,154,314,.490,.514,137,194,.706,67,199,266,230,81,29,122,134,730
215,Christian Laettner\laettch01,PF,33,WAS,76,66,2215,255,516,.494,2,16,.125,253,500,.506,.496,120,144,.833,114,388,502,235,82,40,87,206,632
216,Raef LaFrentz\lafrera01,C,26,DAL,69,43,1611,266,514,.518,47,116,.405,219,398,.550,.563,60,88,.682,125,205,330,54,35,91,46,264,639
217,Sean Lampley\lamplse01,SF,23,MIA,35,0,487,56,129,.434,0,4,.000,56,125,.448,.434,57,82,.695,26,57,83,31,7,3,25,43,169
218,Dan Langhi\langhda01,SF,25,PHO,60,0,541,81,202,.401,9,31,.290,72,171,.421,.423,12,20,.600,19,68,87,21,15,6,16,58,183
219,Voshon Lenard\lenarvo01,SG,29,TOR,63,24,1929,325,809,.402,92,252,.365,233,557,.418,.459,156,194,.804,48,164,212,144,59,21,103,156,898
220,Rashard Lewis\lewisra02,SF,23,SEA,77,77,3044,519,1149,.452,75,217,.346,444,932,.476,.484,283,345,.820,152,351,503,133,99,35,143,205,1396
221,Randy Livingston\livinra01,PG,27,NOH,2,0,12,2,4,.500,0,0,,2,4,.500,.500,2,2,1.000,0,0,0,1,0,0,0,0,6
222,Art Long\longar01,PF,30,TOT,26,0,211,28,75,.373,2,3,.667,26,72,.361,.387,2,10,.200,21,39,60,6,5,11,20,35,60
222,Art Long\longar01,PF,30,PHI,19,0,131,19,50,.380,1,1,1.000,18,49,.367,.390,1,5,.200,13,27,40,2,2,8,9,22,40
222,Art Long\longar01,PF,30,TOR,7,0,80,9,25,.360,1,2,.500,8,23,.348,.380,1,5,.200,8,12,20,4,3,3,11,13,20
223,Grant Long\longgr01,PF,36,BOS,41,1,488,27,70,.386,0,3,.000,27,67,.403,.386,18,23,.783,24,59,83,25,9,1,19,62,72
224,Tyronn Lue\luety01,PG,25,WAS,75,24,1986,248,573,.433,60,176,.341,188,397,.474,.485,91,104,.875,22,127,149,263,47,1,77,151,647
225,George Lynch\lynchge01,SG,32,NOH,81,32,1497,147,359,.409,28,79,.354,119,280,.425,.448,41,74,.554,139,214,353,104,66,19,52,136,363
226,Todd MacCulloch\maccuto01,C,27,PHI,42,35,812,123,238,.517,0,0,,123,238,.517,.517,53,79,.671,66,130,196,20,19,32,35,107,299
227,Tito Maddox\maddoti01,SG,21,HOU,9,0,35,3,12,.250,0,3,.000,3,9,.333,.250,5,8,.625,1,6,7,5,3,1,3,4,11
228,Mark Madsen\madsema01,PF,27,LAL,54,22,781,69,163,.423,0,0,,69,163,.423,.423,36,61,.590,86,73,159,38,15,19,27,116,174
229,Corey Maggette\maggeco01,SG,23,LAC,64,57,2006,343,773,.444,62,177,.350,281,596,.471,.484,325,405,.802,77,245,322,123,55,16,147,194,1073
230,Jamaal Magloire\magloja01,C,24,NOH,82,82,2443,305,635,.480,0,3,.000,305,632,.483,.480,231,322,.717,260,464,724,88,49,111,158,276,841
231,Karl Malone*\malonka01,PF,39,UTA,81,81,2936,595,1289,.462,3,14,.214,592,1275,.464,.463,474,621,.763,113,515,628,379,136,31,210,204,1667
232,Matt Maloney\malonma01,PG,31,ATL,14,0,103,8,25,.320,5,15,.333,3,10,.300,.420,3,5,.600,1,6,7,17,4,0,5,9,24
233,Danny Manning\mannida01,PF,36,DET,13,0,89,13,32,.406,3,8,.375,10,24,.417,.453,5,6,.833,7,11,18,7,9,3,7,11,34
234,Stephon Marbury\marbust01,PG,25,PHO,81,81,3240,671,1530,.439,89,296,.301,582,1234,.472,.468,375,467,.803,53,210,263,654,108,20,263,200,1806
235,Shawn Marion\mariosh01,SF,24,PHO,81,81,3373,662,1466,.452,141,364,.387,521,1102,.473,.500,251,295,.851,199,574,773,198,185,95,157,208,1716
236,Sean Marks\marksse01,PF,27,MIA,23,0,223,22,59,.373,0,1,.000,22,58,.379,.373,10,15,.667,8,27,35,3,5,6,14,37,54
237,Donny Marshall\marshdo02,SF,30,NJN,3,0,6,0,3,.000,0,1,.000,0,2,.000,.000,0,0,,0,3,3,0,0,0,1,0,0
238,Donyell Marshall\marshdo01,PF,29,CHI,78,53,2378,421,918,.459,33,87,.379,388,831,.467,.477,167,221,.756,234,465,699,137,95,85,135,234,1042
239,Kenyon Martin\martike01,PF,25,NJN,77,77,2628,509,1082,.470,9,43,.209,500,1039,.481,.475,256,392,.653,164,476,640,185,98,70,192,294,1283
240,Jamal Mashburn\mashbja01,SF,30,NOH,82,81,3321,670,1586,.422,119,306,.389,551,1280,.430,.460,313,369,.848,66,432,498,462,83,17,230,196,1772
241,Anthony Mason\masonan01,C,36,MIL,65,58,2119,191,393,.486,0,1,.000,191,392,.487,.486,84,117,.718,90,326,416,209,32,12,79,147,466
242,Desmond Mason\masonde01,SF,25,TOT,80,40,2763,457,1017,.449,21,72,.292,436,945,.461,.460,212,283,.749,154,369,523,163,67,32,115,210,1147
242,Desmond Mason\masonde01,SF,25,SEA,52,15,1811,291,667,.436,16,55,.291,275,612,.449,.448,134,181,.740,88,247,335,95,47,21,74,136,732
242,Desmond Mason\masonde01,SF,25,MIL,28,25,952,166,350,.474,5,17,.294,161,333,.483,.481,78,102,.765,66,122,188,68,20,11,41,74,415
243,Roger Mason\masonro01,SF,22,CHI,17,0,113,11,31,.355,6,18,.333,5,13,.385,.452,2,2,1.000,2,10,12,12,4,0,5,20,30
244,Tony Massenburg\masseto01,C,35,UTA,58,1,792,104,232,.448,0,0,,104,232,.448,.448,65,84,.774,59,97,156,17,17,19,50,144,273
245,Walter McCarty\mccarwa01,SF,28,BOS,82,8,1949,173,418,.414,91,248,.367,82,170,.482,.523,61,98,.622,64,224,288,106,78,28,67,188,498
246,Amal McCaskill\mccasam01,C,29,ATL,11,0,70,4,17,.235,0,0,,4,17,.235,.235,3,4,.750,7,15,22,5,3,1,2,13,11
247,Jelani McCoy\mccoyje01,C,25,TOR,67,25,1367,194,395,.491,0,0,,194,395,.491,.491,69,126,.548,95,260,355,43,28,60,96,162,457
248,Tracy McGrady*\mcgratr01,SG,23,ORL,75,74,2954,829,1813,.457,173,448,.386,656,1365,.481,.505,576,726,.793,121,367,488,411,124,59,195,156,2407
249,Jeff McInnis\mcinnje01,PG,28,POR,75,1,1311,188,423,.444,6,35,.171,182,388,.469,.452,50,67,.746,22,75,97,170,21,2,75,117,432
250,Aaron McKie\mckieaa01,SF,30,PHI,80,40,2374,286,666,.429,37,112,.330,249,554,.449,.457,112,134,.836,61,289,350,278,131,9,109,177,721
251,Stanislav Medvedenko\medvest01,PF,23,LAL,58,10,620,112,258,.434,0,2,.000,112,256,.438,.434,31,43,.721,66,75,141,18,11,8,37,118,255
252,Ron Mercer\mercero01,SG,26,IND,72,3,1671,244,597,.409,3,16,.188,241,581,.415,.411,65,81,.802,32,122,154,112,49,14,54,123,556
253,Chris Mihm\mihmch01,C,23,CLE,52,0,809,116,287,.404,0,3,.000,116,284,.408,.404,76,105,.724,93,138,231,28,18,38,48,124,308
254,Darius Miles\milesda01,SF,21,CLE,67,62,2008,263,642,.410,0,14,.000,263,628,.419,.410,92,155,.594,113,250,363,176,67,69,178,159,618
255,Andre Miller\millean02,PG,26,LAC,80,80,2913,377,928,.406,23,108,.213,354,820,.432,.419,311,391,.795,84,232,316,537,99,11,206,203,1088
256,Brad Miller\millebr01,C,26,IND,73,72,2270,329,667,.493,5,16,.313,324,651,.498,.497,292,357,.818,185,418,603,193,65,43,118,203,955
257,Mike Miller\millemi01,SF,22,TOT,65,52,2186,373,859,.434,109,300,.363,264,559,.472,.498,156,186,.839,46,295,341,170,42,21,125,173,1011
257,Mike Miller\millemi01,SF,22,ORL,49,39,1826,296,708,.418,87,256,.340,209,452,.462,.480,127,150,.847,40,246,286,139,36,16,99,139,806
257,Mike Miller\millemi01,SF,22,MEM,16,13,360,77,151,.510,22,44,.500,55,107,.514,.583,29,36,.806,6,49,55,31,6,5,26,34,205
258,Reggie Miller*\millere01,SG,37,IND,70,70,2117,281,637,.441,113,318,.355,168,319,.527,.530,207,230,.900,21,151,172,170,62,4,66,89,882
259,Chris Mills\millsch01,PF,33,GSW,21,0,262,39,106,.368,7,25,.280,32,81,.395,.401,16,18,.889,19,31,50,22,7,3,10,29,101
260,Yao Ming*\mingya01,C,22,HOU,82,72,2382,401,805,.498,1,2,.500,400,803,.498,.499,301,371,.811,196,479,675,137,31,147,173,230,1104
261,Cuttino Mobley\moblecu01,SG,27,HOU,73,73,3044,463,1067,.434,112,318,.352,351,749,.469,.486,242,282,.858,70,233,303,208,95,36,166,185,1280
262,Nazr Mohammed\mohamna01,C,25,ATL,35,0,445,67,159,.421,0,0,,67,159,.421,.421,26,41,.634,47,82,129,6,16,21,25,79,160
263,Jérôme Moïso\moisoje01,C,24,NOH,51,1,644,89,171,.520,0,0,,89,171,.520,.520,27,41,.659,59,119,178,22,19,44,46,87,205
264,Mikki Moore\mooremi01,C,27,TOT,8,0,43,5,13,.385,0,0,,5,13,.385,.385,8,10,.800,6,2,8,3,0,4,2,7,18
264,Mikki Moore\mooremi01,C,27,BOS,3,0,12,0,1,.000,0,0,,0,1,.000,.000,0,0,,1,0,1,0,0,2,0,6,0
264,Mikki Moore\mooremi01,C,27,ATL,5,0,31,5,12,.417,0,0,,5,12,.417,.417,8,10,.800,5,2,7,3,0,2,2,1,18
265,Terence Morris\morrite01,SF,24,HOU,49,0,632,82,176,.466,7,32,.219,75,144,.521,.486,11,14,.786,40,88,128,25,8,17,29,35,182
266,Troy Murphy\murphtr01,PF,22,GSW,79,79,2510,338,749,.451,3,14,.214,335,735,.456,.453,244,290,.841,228,578,806,106,65,30,111,246,923
267,Ronald Murray\murraro01,SG,23,TOT,14,0,62,11,31,.355,0,5,.000,11,26,.423,.355,5,8,.625,0,4,4,5,4,0,8,0,27
267,Ronald Murray\murraro01,SG,23,MIL,12,0,42,9,26,.346,0,4,.000,9,22,.409,.346,5,8,.625,0,1,1,3,4,0,4,0,23
267,Ronald Murray\murraro01,SG,23,SEA,2,0,20,2,5,.400,0,1,.000,2,4,.500,.400,0,0,,0,3,3,2,0,0,4,0,4
268,Tracy Murray\murratr01,SF,31,LAL,31,0,193,23,71,.324,8,38,.211,15,33,.455,.380,7,9,.778,5,18,23,12,5,3,14,22,61
269,Dikembe Mutombo*\mutomdi01,C,36,NJN,24,16,514,49,131,.374,0,0,,49,131,.374,.374,40,55,.727,54,99,153,19,4,37,34,54,138
270,Mamadou N'Diaye\ndiayma02,C,27,TOR,22,8,364,43,96,.448,0,0,,43,96,.448,.448,34,47,.723,29,53,82,7,8,32,21,58,120
271,Boštjan Nachbar\nachbbo01,SF,22,HOU,14,1,77,11,31,.355,2,10,.200,9,21,.429,.387,5,10,.500,3,8,11,3,2,2,6,13,29
272,Lee Nailon\nailole01,SF,27,NYK,38,0,405,84,190,.442,0,1,.000,84,189,.444,.442,42,51,.824,32,38,70,26,6,3,32,46,210
273,Eduardo Nájera\najered01,SF,26,DAL,48,12,1103,129,231,.558,0,1,.000,129,230,.561,.558,62,91,.681,90,133,223,47,40,22,23,129,320
274,Steve Nash*\nashst01,PG,28,DAL,82,82,2711,518,1114,.465,111,269,.413,407,845,.482,.515,308,339,.909,63,171,234,598,85,6,192,134,1455
275,Rasho Nesterović\nestera01,C,26,MIN,77,77,2337,400,762,.525,0,2,.000,400,760,.526,.525,61,95,.642,146,358,504,114,39,116,99,256,861
276,Ira Newble\newblir01,SF,28,ATL,73,45,1931,231,467,.495,32,84,.381,199,383,.520,.529,70,90,.778,86,185,271,99,50,26,69,174,564
277,Moochie Norris\norrimo01,PG,29,HOU,82,3,1375,134,330,.406,11,45,.244,123,285,.432,.423,78,114,.684,37,122,159,196,55,4,86,72,357
278,Dirk Nowitzki\nowitdi01,PF,24,DAL,80,80,3117,690,1489,.463,148,390,.379,542,1099,.493,.513,483,548,.881,81,710,791,239,111,82,152,206,2011
279,Jermaine O'Neal\onealje01,PF,24,IND,77,76,2864,610,1260,.484,7,21,.333,603,1239,.487,.487,373,510,.731,202,594,796,155,66,178,180,277,1600
280,Shaquille O'Neal*\onealsh01,C,30,LAL,67,66,2535,695,1211,.574,0,0,,695,1211,.574,.574,451,725,.622,259,483,742,206,38,159,196,229,1841
281,Charles Oakley\oaklech01,C,39,WAS,42,1,514,23,55,.418,0,0,,23,55,.418,.418,28,34,.824,37,70,107,40,13,6,21,90,74
282,Lamar Odom\odomla01,SF,23,LAC,49,47,1679,268,611,.439,42,129,.326,226,482,.469,.473,136,175,.777,59,267,326,178,42,41,140,181,714
283,Mehmet Okur\okurme01,PF,23,DET,72,9,1366,180,423,.426,38,112,.339,142,311,.457,.470,96,131,.733,117,218,335,71,25,39,66,167,494
284,Dean Oliver\olivede01,PG,24,GSW,15,0,93,7,29,.241,1,6,.167,6,23,.261,.259,7,8,.875,8,8,16,23,7,0,10,9,22
285,Kevin Ollie\ollieke01,PG,30,TOT,82,5,1897,199,441,.451,2,6,.333,197,435,.453,.454,134,178,.753,25,157,182,291,69,5,72,122,534
285,Kevin Ollie\ollieke01,PG,30,MIL,53,4,1127,117,255,.459,1,5,.200,116,250,.464,.461,68,91,.747,12,87,99,181,37,4,36,71,303
285,Kevin Ollie\ollieke01,PG,30,SEA,29,1,770,82,186,.441,1,1,1.000,81,185,.438,.444,66,87,.759,13,70,83,110,32,1,36,51,231
286,Michael Olowokandi\olowomi01,C,27,LAC,36,36,1369,186,436,.427,0,0,,186,436,.427,.427,69,105,.657,57,271,328,47,18,79,98,110,441
287,Greg Ostertag\ostergr01,C,29,UTA,81,74,1926,169,326,.518,0,0,,169,326,.518,.518,100,196,.510,180,323,503,55,20,147,104,235,438
288,Bo Outlaw\outlabo01,C,31,PHO,80,20,1800,153,278,.550,0,2,.000,153,276,.554,.550,72,116,.621,134,234,368,112,50,71,76,194,378
289,Chris Owens\owensch01,SF,23,MEM,1,0,6,2,3,.667,0,0,,2,3,.667,.667,0,0,,1,0,1,0,0,0,1,0,4
290,Olumide Oyedeji\oyedeol01,C,21,ORL,27,3,145,10,23,.435,0,0,,10,23,.435,.435,7,11,.636,10,40,50,5,5,3,5,30,27
291,Robert Pack\packro01,PG,33,NOH,28,4,440,52,129,.403,0,5,.000,52,124,.419,.403,41,55,.745,11,40,51,81,25,0,40,35,145
292,Scott Padgett\padgesc01,PF,26,UTA,82,2,1321,170,423,.402,45,133,.338,125,290,.431,.455,81,107,.757,83,189,272,86,41,24,70,148,466
293,Milt Palacio\palacmi01,PG,24,CLE,80,46,1976,162,388,.418,8,37,.216,154,351,.439,.428,65,87,.747,48,187,235,259,68,16,131,168,397
294,Jannero Pargo\pargoja01,PG,23,LAL,34,0,342,37,93,.398,7,24,.292,30,69,.435,.435,4,4,1.000,9,28,37,39,13,2,23,45,85
295,Smush Parker\parkesm01,PG,21,CLE,66,18,1103,136,338,.402,38,118,.322,98,220,.445,.459,98,118,.831,29,90,119,162,48,12,133,106,408
296,Tony Parker\parketo01,PG,20,SAS,82,82,2774,484,1043,.464,82,243,.337,402,800,.503,.503,219,290,.755,33,183,216,432,71,4,198,174,1269
297,Cherokee Parks\parksch02,PF,30,LAC,30,18,648,82,163,.503,1,2,.500,81,161,.503,.506,23,38,.605,46,86,132,21,16,20,18,52,188
298,Ruben Patterson\patteru01,SF,27,POR,78,17,1655,254,516,.492,3,20,.150,251,496,.506,.495,138,220,.627,120,144,264,101,73,29,117,161,649
299,Gary Payton*\paytoga01,PG,34,TOT,80,80,3208,665,1466,.454,54,182,.297,611,1284,.476,.472,250,352,.710,79,255,334,663,133,20,187,181,1634
299,Gary Payton*\paytoga01,PG,34,SEA,52,52,2123,444,992,.448,34,114,.298,410,878,.467,.465,162,234,.692,56,192,248,457,93,12,131,117,1084
299,Gary Payton*\paytoga01,PG,34,MIL,28,28,1085,221,474,.466,20,68,.294,201,406,.495,.487,88,118,.746,23,63,86,206,40,8,56,64,550
300,Anthony Peeler\peelean01,SG,33,MIN,82,39,2245,252,609,.414,87,212,.410,165,397,.416,.485,39,50,.780,40,201,241,244,72,13,82,161,630
301,Wesley Person\persowe01,SG,31,MEM,66,44,1941,274,601,.456,100,231,.433,174,370,.470,.539,79,97,.814,24,168,192,112,42,19,56,64,727
302,Morris Peterson\petermo01,SF,25,TOR,82,80,2949,421,1073,.392,116,344,.337,305,729,.418,.446,195,247,.789,97,266,363,188,88,32,128,232,1153
303,Eric Piatkowski\piatker01,SG,32,LAC,62,26,1360,210,446,.471,80,201,.398,130,245,.531,.561,101,122,.828,44,112,156,70,33,9,56,92,601
304,Paul Pierce*\piercpa01,SG,25,BOS,79,79,3096,663,1592,.416,118,391,.302,545,1201,.454,.454,604,753,.802,106,472,578,349,139,62,288,227,2048
305,Scottie Pippen*\pippesc01,SF,37,POR,64,58,1911,265,597,.444,38,133,.286,227,464,.489,.476,121,148,.818,57,221,278,285,105,25,164,149,689
306,Scot Pollard\pollasc01,C,27,SAC,23,0,325,40,87,.460,0,0,,40,87,.460,.460,23,38,.605,46,60,106,6,13,15,15,50,103
307,James Posey\poseyja01,SF,26,TOT,83,71,2518,309,752,.411,70,229,.306,239,523,.457,.457,205,246,.833,90,336,426,184,106,15,144,197,893
307,James Posey\poseyja01,SF,26,DEN,25,24,872,121,324,.373,24,88,.273,97,236,.411,.410,86,102,.843,38,107,145,78,29,6,66,63,352
307,James Posey\poseyja01,SF,26,HOU,58,47,1646,188,428,.439,46,141,.326,142,287,.495,.493,119,144,.826,52,229,281,106,77,9,78,134,541
308,Lavor Postell\postela01,SG,24,NYK,12,0,98,14,38,.368,2,7,.286,12,31,.387,.395,13,15,.867,1,3,4,3,2,0,7,9,43
309,Vitaly Potapenko\potapvi01,C,27,SEA,26,2,403,41,93,.441,0,0,,41,93,.441,.441,22,29,.759,25,64,89,4,9,8,25,46,104
310,Tayshaun Prince\princta01,SF,22,DET,42,5,435,53,118,.449,20,47,.426,33,71,.465,.534,11,17,.647,5,40,45,24,10,14,21,25,137
311,Joel Przybilla\przybjo01,C,23,MIL,32,17,546,18,46,.391,0,0,,18,46,.391,.391,12,24,.500,48,97,145,12,10,45,19,85,48
312,Vladimir Radmanović\radmavl01,PF,22,SEA,72,16,1910,274,668,.410,104,293,.355,170,375,.453,.488,72,102,.706,76,247,323,97,64,22,100,136,724
313,Igor Rakočević\rakocig01,PG,24,MIN,42,0,244,22,58,.379,5,12,.417,17,46,.370,.422,29,36,.806,4,13,17,33,4,0,23,25,78
314,Zach Randolph\randoza01,PF,21,POR,77,11,1301,264,515,.513,0,5,.000,264,510,.518,.513,122,161,.758,139,204,343,41,42,14,62,141,650
315,Theo Ratliff\ratlith01,C,29,ATL,81,81,2518,276,595,.464,0,0,,276,595,.464,.464,154,214,.720,154,453,607,73,56,262,137,271,706
316,Željko Rebrača\rebraze01,C,30,DET,30,12,488,80,145,.552,0,0,,80,145,.552,.552,38,48,.792,27,65,92,9,6,17,29,79,198
317,Michael Redd\reddmi01,SG,23,MIL,82,14,2316,455,971,.469,182,416,.438,273,555,.492,.562,149,185,.805,98,273,371,117,100,13,74,143,1241
318,Don Reid\reiddo01,PF,29,DET,1,0,10,0,3,.000,0,0,,0,3,.000,.000,1,2,.500,0,0,0,0,0,0,0,4,1
319,Efthimios Rentzias\rentzef01,C,27,PHI,35,0,144,20,59,.339,4,8,.500,16,51,.314,.373,8,9,.889,10,16,26,7,6,2,4,21,52
320,Glen Rice\ricegl01,SF,35,HOU,62,26,1532,196,457,.429,101,254,.398,95,203,.468,.539,63,83,.759,28,126,154,65,23,5,55,99,556
321,Jason Richardson\richaja01,SG,22,GSW,82,82,2698,476,1161,.410,123,334,.368,353,827,.427,.463,207,271,.764,111,267,378,247,90,23,179,201,1282
322,Quentin Richardson\richaqu01,SG,22,LAC,59,13,1368,203,546,.372,61,198,.308,142,348,.408,.428,85,124,.685,98,183,281,52,35,10,64,92,552
323,Antoine Rigaudeau\rigauan01,SG,31,DAL,11,0,91,8,35,.229,1,5,.200,7,30,.233,.243,0,0,,4,4,8,6,3,0,6,11,17
324,Clifford Robinson\robincl02,PF,36,DET,81,69,2825,372,935,.398,87,259,.336,285,676,.422,.444,161,238,.676,81,237,318,268,87,88,158,259,992
325,David Robinson*\robinda01,C,37,SAS,64,64,1676,197,420,.469,0,0,,197,420,.469,.469,152,214,.710,163,345,508,61,52,111,83,126,546
326,Eddie Robinson\robined01,SF,26,CHI,64,18,1355,155,315,.492,3,14,.214,152,301,.505,.497,51,63,.810,76,124,200,66,62,13,52,120,364
327,Glenn Robinson\robingl01,SF,30,ATL,69,68,2591,539,1248,.432,90,263,.342,449,985,.456,.468,268,306,.876,86,371,457,205,91,26,248,183,1436
328,Rodney Rogers\rogerro01,PF,31,NJN,68,0,1303,183,455,.402,44,132,.333,139,323,.430,.451,68,90,.756,61,202,263,107,50,31,91,192,478
329,Sean Rooks\rooksse01,C,33,LAC,70,38,1344,125,297,.421,0,1,.000,125,296,.422,.421,47,58,.810,53,163,216,69,34,44,66,174,297
330,Jalen Rose\roseja01,SF,30,CHI,82,82,3351,642,1583,.406,133,359,.370,509,1224,.416,.448,399,467,.854,68,283,351,395,72,23,285,271,1816
331,Malik Rose\rosema01,PF,28,SAS,79,13,1933,289,630,.459,2,5,.400,287,625,.459,.460,242,306,.791,148,358,506,124,57,40,170,206,822
332,Guy Rucker\ruckegu01,PF,25,GSW,3,0,4,0,0,,0,0,,0,0,,,0,0,,0,1,1,1,0,0,0,1,0
333,Kareem Rush\rushka01,PG,22,LAL,76,0,872,96,244,.393,19,68,.279,77,176,.438,.432,16,23,.696,26,68,94,68,10,11,63,71,227
334,Bryon Russell\russebr01,SF,32,WAS,70,23,1388,108,306,.353,46,140,.329,62,166,.373,.428,53,69,.768,43,165,208,72,70,7,55,130,315
335,Arvydas Sabonis*\sabonar01,C,38,POR,78,1,1209,172,361,.476,3,6,.500,169,355,.476,.481,129,164,.787,88,247,335,142,61,49,75,141,476
336,John Salmons\salmojo01,PG,23,PHI,64,1,504,48,116,.414,10,31,.323,38,85,.447,.457,26,35,.743,16,43,59,47,17,6,29,53,132
337,Soumaila Samake\samakso01,C,24,LAL,13,1,77,10,24,.417,0,0,,10,24,.417,.417,2,2,1.000,10,13,23,4,0,5,2,13,22
338,Jamal Sampson\sampsja01,PF,19,MIL,5,0,8,0,2,.000,0,0,,0,2,.000,.000,0,0,,1,1,2,1,1,0,0,0,0
339,Pepe Sánchez\sanchpe01,PG,25,DET,9,0,37,0,5,.000,0,0,,0,5,.000,.000,0,0,,4,2,6,8,5,0,2,3,0
340,Jeryl Sasser\sasseje01,SG,23,ORL,75,4,1025,64,207,.309,13,44,.295,51,163,.313,.341,53,78,.679,64,120,184,65,45,12,39,91,194
341,Kenny Satterfield\satteke01,PG,21,TOT,39,6,502,55,183,.301,5,28,.179,50,155,.323,.314,17,25,.680,16,27,43,68,20,2,43,36,132
341,Kenny Satterfield\satteke01,PG,21,DEN,22,6,420,51,165,.309,5,28,.179,46,137,.336,.324,16,23,.696,12,23,35,53,18,2,36,30,123
341,Kenny Satterfield\satteke01,PG,21,PHI,17,0,82,4,18,.222,0,0,,4,18,.222,.222,1,2,.500,4,4,8,15,2,0,7,6,9
342,Predrag Savović\savovpr01,SG,26,DEN,27,0,256,29,93,.312,4,26,.154,25,67,.373,.333,21,29,.724,9,16,25,22,14,1,21,33,83
343,Brian Scalabrine\scalabr01,PF,24,NJN,59,7,724,68,169,.402,14,39,.359,54,130,.415,.444,30,36,.833,40,101,141,46,16,18,46,77,180
344,Ansu Sesay\sesayan01,SF,26,SEA,45,4,448,41,107,.383,0,0,,41,107,.383,.383,12,21,.571,34,39,73,23,14,5,25,62,94
345,Brian Shaw\shawbr01,PG,36,LAL,72,0,900,101,261,.387,38,109,.349,63,152,.414,.460,10,15,.667,20,99,119,103,32,13,54,62,250
346,Paul Shirley\shirlpa01,PF,25,ATL,2,0,5,0,4,.000,0,0,,0,4,.000,.000,0,0,,0,1,1,0,0,0,0,0,0
347,Bobby Simmons\simmobo01,SG,22,WAS,36,2,378,44,112,.393,0,5,.000,44,107,.411,.393,32,35,.914,33,44,77,20,10,3,8,51,120
348,Brian Skinner\skinnbr01,PF,26,PHI,77,9,1381,182,331,.550,0,0,,182,331,.550,.550,97,161,.602,136,230,366,19,47,53,62,176,461
349,Reggie Slater\slatere01,PF,32,MIN,26,0,141,27,50,.540,0,0,,27,50,.540,.540,27,45,.600,18,13,31,4,6,1,9,31,81
350,Tamar Slay\slayta01,SG,22,NJN,36,0,274,39,103,.379,7,25,.280,32,78,.410,.413,7,10,.700,8,23,31,14,14,3,20,31,92
351,Charles Smith\smithch04,SG,27,POR,3,0,13,1,4,.250,0,1,.000,1,3,.333,.250,3,4,.750,0,0,0,1,1,0,1,3,5
352,Joe Smith\smithjo02,SF,27,MIN,54,21,1117,151,328,.460,0,2,.000,151,326,.463,.460,102,131,.779,111,159,270,38,14,55,43,171,404
353,Steve Smith\smithst01,SG,33,SAS,53,18,1032,113,291,.388,39,118,.331,74,173,.428,.455,95,114,.833,21,78,99,70,28,9,43,79,360
354,Eric Snow\snower01,PG,29,PHI,82,82,3108,361,799,.452,7,32,.219,354,767,.462,.456,325,379,.858,71,230,301,544,133,11,194,235,1054
355,Latrell Sprewell\sprewla01,SF,32,NYK,74,73,2859,454,1127,.403,134,360,.372,320,767,.417,.462,173,218,.794,45,240,285,332,102,22,172,134,1215
356,Jerry Stackhouse\stackje01,SG,28,WAS,70,70,2747,491,1201,.409,71,245,.290,420,956,.439,.438,455,518,.878,61,197,258,316,65,28,193,130,1508
357,Vladimir Stepania\stepavl01,C,26,MIA,79,6,1594,185,427,.433,0,0,,185,427,.433,.433,71,134,.530,211,343,554,24,45,40,69,169,441
358,DeShawn Stevenson\stevede01,SG,21,UTA,61,8,760,114,284,.401,4,12,.333,110,272,.404,.408,47,68,.691,22,63,85,40,22,8,49,57,279
359,Michael Stewart\stewami01,PF,27,CLE,47,0,251,14,37,.378,0,0,,14,37,.378,.378,8,12,.667,19,36,55,6,2,15,10,42,36
360,John Stockton*\stockjo01,PG,40,UTA,82,82,2275,309,640,.483,29,80,.363,280,560,.500,.505,237,287,.826,51,150,201,629,137,16,182,184,884
361,Peja Stojaković\stojape01,SF,25,SAC,72,72,2450,497,1034,.481,155,406,.382,342,628,.545,.556,231,264,.875,61,336,397,141,72,5,101,143,1380
362,Damon Stoudamire\stoudda01,PG,29,POR,59,27,1315,156,415,.376,44,114,.386,112,301,.372,.429,53,67,.791,40,115,155,204,39,6,82,67,409
363,Amar'e Stoudemire\stoudam01,PF,20,PHO,82,71,2570,392,830,.472,2,10,.200,390,820,.476,.473,320,484,.661,250,471,721,78,62,87,189,269,1106
364,Erick Strickland\stricer01,SG,29,IND,71,10,1275,163,380,.429,62,160,.388,101,220,.459,.511,70,87,.805,23,122,145,209,38,7,98,111,458
365,Mark Strickland\stricma01,SF,32,DAL,4,0,13,2,5,.400,0,0,,2,5,.400,.400,0,0,,5,2,7,0,0,0,1,1,4
366,Rod Strickland\stricro02,PG,36,MIN,47,8,956,120,278,.432,1,11,.091,119,267,.446,.433,79,107,.738,20,75,95,215,46,6,76,55,320
367,Bruno Šundov\sundobr01,C,22,BOS,26,0,138,14,56,.250,4,16,.250,10,40,.250,.286,0,2,.000,8,20,28,7,6,3,9,24,32
368,Bob Sura\surabo01,SG,29,GSW,55,0,1130,135,328,.412,28,85,.329,107,243,.440,.454,103,148,.696,58,109,167,177,45,2,82,108,401
369,Stromile Swift\swiftst01,PF,23,MEM,67,26,1478,235,489,.481,0,2,.000,235,487,.483,.481,177,245,.722,114,270,384,45,55,104,99,152,647
370,Wally Szczerbiak\szczewa02,SF,25,MIN,52,42,1836,351,729,.481,61,145,.421,290,584,.497,.523,150,173,.867,53,188,241,136,44,22,87,123,913
371,Maurice Taylor\tayloma01,PF,26,HOU,67,9,1377,231,535,.432,0,2,.000,231,533,.433,.432,100,138,.725,95,143,238,66,22,22,100,151,562
372,Jason Terry\terryja01,PG,25,ATL,81,81,3081,488,1141,.428,160,431,.371,328,710,.462,.498,259,292,.887,37,242,279,600,126,14,249,175,1395
373,Etan Thomas\thomaet01,PF,24,WAS,38,0,513,61,124,.492,0,0,,61,124,.492,.492,60,94,.638,70,95,165,3,8,23,33,66,182
374,Kenny Thomas\thomake01,PF,25,TOT,66,42,1978,260,559,.465,0,0,,260,559,.465,.465,147,197,.746,185,344,529,112,62,28,116,169,667
374,Kenny Thomas\thomake01,PF,25,HOU,20,14,586,82,190,.432,0,0,,82,190,.432,.432,33,45,.733,45,92,137,39,16,6,40,49,197
374,Kenny Thomas\thomake01,PF,25,PHI,46,28,1392,178,369,.482,0,0,,178,369,.482,.482,114,152,.750,140,252,392,73,46,22,76,120,470
375,Kurt Thomas\thomaku01,C,30,NYK,81,81,2577,497,1028,.483,2,3,.667,495,1025,.483,.484,138,184,.750,160,477,637,162,81,97,138,344,1134
376,Tim Thomas\thomati01,SF,25,MIL,80,70,2358,412,930,.443,97,265,.366,315,665,.474,.495,145,186,.780,97,292,389,102,70,49,133,257,1066
377,Jamaal Tinsley\tinslja01,PG,24,IND,73,69,2237,220,556,.396,46,166,.277,174,390,.446,.437,80,112,.714,58,202,260,548,125,18,192,201,566
378,Óscar Torres\torreos01,SG,26,GSW,17,0,109,16,36,.444,7,13,.538,9,23,.391,.542,14,20,.700,3,9,12,3,4,2,8,9,53
379,Robert Traylor\traylro01,C,25,NOH,69,0,851,105,237,.443,1,3,.333,104,234,.444,.445,57,88,.648,108,154,262,50,45,37,53,153,268
380,Gary Trent\trentga01,SF,28,MIN,80,22,1222,208,389,.535,0,2,.000,208,387,.537,.535,60,101,.594,106,185,291,77,32,23,59,142,476
381,Jeff Trepagnier\trepaje01,SG,23,DEN,8,0,97,17,40,.425,4,8,.500,13,32,.406,.475,7,7,1.000,8,8,16,6,8,0,8,5,45
382,Cezary Trybański\trybace01,C,23,MEM,15,0,86,5,20,.250,0,0,,5,20,.250,.250,4,10,.400,6,8,14,1,0,6,8,13,14
383,Jake Tsakalidis\tsakaja01,C,23,PHO,33,27,543,61,135,.452,0,0,,61,135,.452,.452,39,58,.672,45,77,122,13,6,17,26,80,161
384,Nikoloz Tskitishvili\tskitni01,SF,19,DEN,81,16,1320,115,393,.293,37,152,.243,78,241,.324,.340,48,65,.738,64,117,181,91,31,29,84,136,315
385,Hedo Türkoğlu\turkohe01,SF,23,SAC,67,11,1175,165,391,.422,29,78,.372,136,313,.435,.459,88,110,.800,35,153,188,87,25,12,50,125,447
386,Nick Van Exel\vanexni01,SG,31,DAL,73,1,2026,342,831,.412,118,312,.378,224,519,.432,.483,110,144,.764,35,173,208,312,42,4,123,86,912
387,Keith Van Horn\vanhoke01,PF,27,PHI,74,73,2337,459,952,.482,65,176,.369,394,776,.508,.516,193,240,.804,159,365,524,93,63,30,150,251,1176
388,Jacque Vaughn\vaughja01,PG,27,ORL,80,48,1686,184,411,.448,8,34,.235,176,377,.467,.457,97,125,.776,26,92,118,232,64,2,97,169,473
389,Jake Voskuhl\voskuja01,C,25,PHO,65,1,947,92,163,.564,0,0,,92,163,.564,.564,64,96,.667,97,128,225,36,18,29,48,172,248
390,Dajuan Wagner\wagneda02,SG,19,CLE,47,24,1385,223,605,.369,55,174,.316,168,431,.390,.414,128,160,.800,20,62,82,130,38,7,85,107,629
391,Antoine Walker\walkean02,PF,26,BOS,78,78,3235,603,1554,.388,188,582,.323,415,972,.427,.449,176,286,.615,99,464,563,373,116,31,260,221,1570
392,Samaki Walker\walkesa01,C,26,LAL,67,39,1243,115,274,.420,0,1,.000,115,273,.421,.420,66,101,.653,115,253,368,64,20,55,56,143,296
393,Ben Wallace*\wallabe01,C,28,DET,73,73,2873,210,437,.481,1,6,.167,209,431,.485,.482,85,189,.450,293,833,1126,120,104,230,88,179,506
394,Gerald Wallace\wallage01,SF,20,SAC,47,7,571,90,183,.492,1,4,.250,89,179,.497,.495,39,74,.527,38,90,128,23,24,15,44,68,220
395,Rasheed Wallace\wallara01,PF,28,POR,74,74,2684,515,1094,.471,110,307,.358,405,787,.515,.521,200,272,.735,113,435,548,153,70,77,140,223,1340
396,Charlie Ward\wardch01,PG,32,NYK,66,6,1465,165,414,.399,101,267,.378,64,147,.435,.521,41,53,.774,25,152,177,306,78,11,95,146,472
397,Earl Watson\watsoea01,PG,23,MEM,79,2,1366,170,391,.435,31,91,.341,139,300,.463,.474,62,86,.721,46,118,164,225,89,14,88,138,433
398,Clarence Weatherspoon\weathcl01,PF,32,NYK,79,19,2024,186,414,.449,0,0,,186,414,.449,.449,149,194,.768,214,385,599,68,69,36,63,174,521
399,Chris Webber*\webbech01,PF,29,SAC,67,67,2622,661,1433,.461,5,21,.238,656,1412,.465,.463,215,354,.607,160,544,704,364,106,88,215,204,1542
400,Bonzi Wells\wellsbo01,SG,26,POR,75,65,2396,437,990,.441,38,130,.292,399,860,.464,.461,226,313,.722,98,296,394,246,123,18,215,220,1138
401,Jiří Welsch\welscji01,SF,23,GSW,37,0,234,19,75,.253,1,4,.250,18,71,.254,.260,22,29,.759,12,16,28,27,8,2,19,32,61
402,David Wesley\wesleda01,SG,32,NOH,73,73,2710,449,1037,.433,134,316,.424,315,721,.437,.498,185,237,.781,38,137,175,251,109,9,132,173,1217
403,Jahidi White\whiteja01,C,26,WAS,16,8,230,25,53,.472,0,0,,25,53,.472,.472,17,25,.680,37,36,73,2,1,12,9,33,67
404,Rodney White\whitero02,SG,22,DEN,72,19,1563,260,638,.408,32,134,.239,228,504,.452,.433,98,125,.784,43,170,213,121,45,32,156,134,650
405,Chris Whitney\whitnch01,PG,31,TOT,51,21,1052,124,349,.355,50,164,.305,74,185,.400,.427,57,69,.826,3,64,67,145,29,2,71,92,355
405,Chris Whitney\whitnch01,PG,31,DEN,29,20,762,94,261,.360,43,128,.336,51,133,.383,.443,46,57,.807,1,45,46,124,17,1,55,77,277
405,Chris Whitney\whitnch01,PG,31,ORL,22,1,290,30,88,.341,7,36,.194,23,52,.442,.381,11,12,.917,2,19,21,21,12,1,16,15,78
406,Chris Wilcox\wilcoch01,PF,20,LAC,46,3,479,73,140,.521,0,0,,73,140,.521,.521,25,50,.500,32,72,104,21,7,12,26,65,171
407,Mike Wilks\wilksmi01,PG-SG,23,TOT,46,7,688,50,148,.338,10,35,.286,40,113,.354,.372,37,47,.787,20,51,71,92,27,4,28,69,147
407,Mike Wilks\wilksmi01,SG,23,ATL,15,7,364,29,81,.358,6,17,.353,23,64,.359,.395,21,29,.724,9,32,41,42,16,1,16,38,85
407,Mike Wilks\wilksmi01,PG,23,MIN,31,0,324,21,67,.313,4,18,.222,17,49,.347,.343,16,18,.889,11,19,30,50,11,3,12,31,62
408,Aaron Williams\williaa01,C,31,NJN,81,0,1597,199,439,.453,0,1,.000,199,438,.454,.453,102,130,.785,137,194,331,88,27,57,85,206,500
409,Alvin Williams\willial02,PG,28,TOR,78,78,2638,396,905,.438,48,146,.329,348,759,.458,.464,187,239,.782,55,190,245,416,111,21,128,170,1027
410,Brandon Williams\willibr01,SF,27,ATL,6,0,19,1,7,.143,0,1,.000,1,6,.167,.143,0,0,,2,0,2,0,2,0,3,4,2
411,Eric Williams\willier01,SF,30,BOS,82,79,2350,254,575,.442,37,110,.336,217,465,.467,.474,201,268,.750,143,239,382,140,86,19,97,234,746
412,Frank Williams\willifr02,PG,22,NYK,21,0,167,9,33,.273,6,16,.375,3,17,.176,.364,4,6,.667,3,15,18,34,7,2,17,20,28
413,Jason Williams\willija02,PG,27,MEM,76,76,2407,333,859,.388,143,404,.354,190,455,.418,.471,110,131,.840,25,187,212,631,91,10,168,130,919
414,Jay Williams\willija03,PG,21,CHI,75,54,1961,273,685,.399,65,202,.322,208,483,.431,.446,103,161,.640,27,168,195,350,86,17,171,179,714
415,Jerome Williams\willije01,PF,29,TOR,71,63,2346,267,535,.499,1,6,.167,266,529,.503,.500,156,281,.555,231,419,650,95,116,26,98,197,691
416,Monty Williams\willimo01,SF,31,PHI,21,2,276,34,80,.425,0,2,.000,34,78,.436,.425,24,32,.750,12,33,45,26,12,5,17,33,92
417,Scott Williams\willisc01,C,34,PHO,69,33,872,120,292,.411,0,2,.000,120,290,.414,.411,33,42,.786,72,121,193,22,27,21,32,159,273
418,Shammond Williams\willish01,PG,27,TOT,78,11,1881,228,579,.394,93,261,.356,135,318,.425,.474,78,102,.765,24,147,171,266,77,6,114,140,627
418,Shammond Williams\willish01,PG,27,BOS,51,2,1169,134,338,.396,56,159,.352,78,179,.436,.479,48,57,.842,12,98,110,128,61,3,61,84,372
418,Shammond Williams\willish01,PG,27,DEN,27,9,712,94,241,.390,37,102,.363,57,139,.410,.467,30,45,.667,12,49,61,138,16,3,53,56,255
419,Walt Williams\williwa02,SF,32,DAL,66,1,1161,134,341,.393,64,171,.374,70,170,.412,.487,31,50,.620,53,154,207,59,42,26,35,141,363
420,Corliss Williamson\willico02,SF,29,DET,82,1,2061,374,826,.453,2,11,.182,372,815,.456,.454,237,300,.790,147,211,358,104,44,27,126,238,987
421,Kevin Willis\willike02,C,40,SAS,71,6,840,123,257,.479,0,2,.000,123,255,.482,.479,51,83,.614,83,143,226,24,20,20,60,120,297
422,Rubén Wolkowyski\wolkoru01,PF,29,BOS,7,0,24,2,4,.500,0,1,.000,2,3,.667,.500,1,4,.250,0,1,1,1,0,0,1,3,5
423,Loren Woods\woodslo01,C,24,MIN,38,11,353,29,76,.382,1,3,.333,28,73,.384,.388,21,27,.778,27,68,95,19,10,13,23,37,80
424,Qyntel Woods\woodsqy01,PF,21,POR,53,0,334,59,118,.500,3,9,.333,56,109,.514,.513,7,20,.350,15,38,53,12,15,1,23,36,128
425,Metta World Peace\artesro01,SF,23,IND,69,67,2317,362,846,.428,71,211,.336,291,635,.458,.470,273,371,.736,101,261,362,198,159,50,145,242,1068
426,Lorenzen Wright\wrighlo02,C,27,MEM,70,49,1982,325,716,.454,0,5,.000,325,711,.457,.454,147,223,.659,170,358,528,80,51,54,110,209,797
427,Vincent Yarbrough\yarbrvi01,SG,21,DEN,59,39,1381,168,428,.393,21,78,.269,147,350,.420,.417,49,62,.790,36,126,162,130,57,33,81,145,406
428,Wang Zhizhi\zhizhwa01,C,25,LAC,41,1,412,62,162,.383,16,47,.340,46,115,.400,.432,42,58,.724,26,51,77,10,8,10,31,41,182