Rk,Player,Pos,Age,Tm,G,GS,MP,FG,FGA,FG%,3P,3PA,3P%,2P,2PA,2P%,eFG%,FT,FTA,FT%,ORB,DRB,TRB,AST,STL,BLK,TOV,PF,PTS
1,Shareef Abdur-Rahim\abdursh01,PF,28,POR,54,49,1867,337,670,.503,15,39,.385,322,631,.510,.514,220,254,.866,123,269,392,111,49,26,117,150,909
2,Cory Alexander\alexaco01,SG,31,CHA,16,1,201,16,49,.327,8,19,.421,8,30,.267,.408,9,12,.750,8,21,29,37,9,1,19,29,49
3,Malik Allen\allenma01,PF,26,TOT,36,1,519,84,177,.475,0,0,,84,177,.475,.475,26,28,.929,40,59,99,18,9,22,18,53,194
3,Malik Allen\allenma01,PF,26,MIA,14,0,248,35,76,.461,0,0,,35,76,.461,.461,13,14,.929,24,28,52,11,4,11,11,29,83
3,Malik Allen\allenma01,PF,26,CHA,22,1,271,49,101,.485,0,0,,49,101,.485,.485,13,14,.929,16,31,47,7,5,11,7,24,111
4,Ray Allen*\allenra02,SG,29,SEA,78,78,3064,640,1494,.428,209,556,.376,431,938,.459,.498,378,428,.883,79,268,347,289,84,5,171,167,1867
5,Tony Allen\allento01,SG,23,BOS,77,34,1262,184,387,.475,12,31,.387,172,356,.483,.491,112,152,.737,85,136,221,64,76,24,77,156,492
6,Rafer Alston\alstora01,PG,28,TOR,80,78,2717,403,974,.414,139,389,.357,264,585,.451,.485,191,258,.740,42,237,279,514,118,7,170,212,1136
7,Chris Andersen\anderch01,C,26,NOH,67,2,1430,191,358,.534,0,3,.000,191,355,.538,.534,131,190,.689,137,273,410,71,14,100,64,144,513
8,Derek Anderson\anderde01,SG,30,POR,47,32,1239,152,391,.389,58,151,.384,94,240,.392,.463,70,87,.805,25,103,128,143,36,4,70,89,432
9,Kenny Anderson\anderke01,PG,34,TOT,43,20,743,85,201,.423,6,13,.462,79,188,.420,.438,27,37,.730,24,64,88,103,33,0,49,87,203
9,Kenny Anderson\anderke01,PG,34,ATL,39,20,717,81,190,.426,6,13,.462,75,177,.424,.442,27,37,.730,23,60,83,98,33,0,46,81,195
9,Kenny Anderson\anderke01,PG,34,LAC,4,0,26,4,11,.364,0,0,,4,11,.364,.364,0,0,,1,4,5,5,0,0,3,6,8
10,Shandon Anderson\andersh01,SF-SG,31,TOT,66,5,1171,98,217,.452,5,29,.172,93,188,.495,.463,54,66,.818,41,150,191,70,40,14,50,138,255
10,Shandon Anderson\andersh01,SG,31,NYK,1,0,20,0,2,.000,0,1,.000,0,1,.000,.000,0,0,,1,0,1,0,0,0,1,2,0
10,Shandon Anderson\andersh01,SF,31,MIA,65,5,1151,98,215,.456,5,28,.179,93,187,.497,.467,54,66,.818,40,150,190,70,40,14,49,136,255
11,Carmelo Anthony\anthoca01,SF,20,DEN,75,75,2608,530,1230,.431,42,158,.266,488,1072,.455,.448,456,573,.796,141,285,426,194,68,30,224,229,1558
12,Rafael Araújo\araujra01,C,24,TOR,59,41,736,76,175,.434,1,3,.333,75,172,.436,.437,43,55,.782,59,126,185,16,21,8,52,157,196
13,Gilbert Arenas\arenagi01,PG,23,WAS,80,80,3274,656,1523,.431,205,562,.365,451,961,.469,.498,521,640,.814,83,295,378,411,139,23,242,245,2038
14,Trevor Ariza\arizatr01,SF,19,NYK,80,12,1382,172,389,.442,3,13,.231,169,376,.449,.446,121,174,.695,89,153,242,85,70,18,73,150,468
15,Darrell Armstrong\armstda01,PG,36,TOT,66,16,988,89,277,.321,28,111,.252,61,166,.367,.372,58,68,.853,35,80,115,178,45,8,67,92,264
15,Darrell Armstrong\armstda01,PG,36,NOH,14,9,412,53,159,.333,17,70,.243,36,89,.404,.387,19,21,.905,16,32,48,65,15,2,28,30,142
15,Darrell Armstrong\armstda01,PG,36,DAL,52,7,576,36,118,.305,11,41,.268,25,77,.325,.352,39,47,.830,19,48,67,113,30,6,39,62,122
16,Carlos Arroyo\arroyca01,PG,25,TOT,70,16,1448,167,429,.389,8,30,.267,159,399,.398,.399,119,149,.799,26,78,104,280,44,4,107,143,461
16,Carlos Arroyo\arroyca01,PG,25,UTA,30,16,742,93,232,.401,7,18,.389,86,214,.402,.416,53,63,.841,11,35,46,152,20,3,55,67,246
16,Carlos Arroyo\arroyca01,PG,25,DET,40,0,706,74,197,.376,1,12,.083,73,185,.395,.378,66,86,.767,15,43,58,128,24,1,52,76,215
17,Chucky Atkins\atkinch01,PG,30,LAL,82,82,2903,388,910,.426,176,455,.387,212,455,.466,.523,163,203,.803,31,166,197,358,73,2,151,181,1115
18,Stacey Augmon\augmost01,SF,36,ORL,55,7,663,68,167,.407,0,0,,68,167,.407,.407,57,77,.740,45,54,99,36,23,8,31,83,193
19,Maurice Baker\bakerma01,PG,25,TOT,5,0,19,0,1,.000,0,0,,0,1,.000,.000,0,0,,1,1,2,1,1,0,1,3,0
19,Maurice Baker\bakerma01,PG,25,LAC,1,0,1,0,0,,0,0,,0,0,,,0,0,,0,0,0,0,0,0,0,0,0
19,Maurice Baker\bakerma01,PG,25,POR,4,0,18,0,1,.000,0,0,,0,1,.000,.000,0,0,,1,1,2,1,1,0,1,3,0
20,Vin Baker\bakervi01,PF-C,33,TOT,27,0,204,13,42,.310,0,1,.000,13,41,.317,.310,9,17,.529,17,22,39,10,2,4,17,38,35
20,Vin Baker\bakervi01,PF,33,NYK,24,0,191,13,38,.342,0,1,.000,13,37,.351,.342,7,15,.467,17,20,37,9,2,4,15,31,33
20,Vin Baker\bakervi01,C,33,HOU,3,0,13,0,4,.000,0,0,,0,4,.000,.000,2,2,1.000,0,2,2,1,0,0,2,7,2
21,Marcus Banks\banksma01,PG,23,BOS,81,2,1145,115,286,.402,21,59,.356,94,227,.414,.439,121,163,.742,29,97,126,155,63,13,79,146,372
22,Leandro Barbosa\barbole01,PG,22,PHO,63,6,1087,168,354,.475,51,139,.367,117,215,.544,.547,55,69,.797,32,98,130,126,30,7,87,127,442
23,Matt Barnes\barnema02,SF,24,SAC,43,9,715,62,151,.411,5,22,.227,57,129,.442,.427,35,58,.603,49,84,133,57,30,7,45,80,164
24,Andre Barrett\barrean01,PG,22,TOT,38,1,483,45,124,.363,14,52,.269,31,72,.431,.419,14,19,.737,11,29,40,69,19,1,27,51,118
24,Andre Barrett\barrean01,PG,22,HOU,27,0,314,20,69,.290,9,37,.243,11,32,.344,.355,7,10,.700,5,14,19,42,14,0,16,35,56
24,Andre Barrett\barrean01,PG,22,ORL,11,1,169,25,55,.455,5,15,.333,20,40,.500,.500,7,9,.778,6,15,21,27,5,1,11,16,62
25,Brent Barry\barrybr01,SG,33,SAS,81,8,1742,194,459,.423,100,280,.357,94,179,.525,.532,113,135,.837,29,161,190,178,39,20,64,123,601
26,Jon Barry\barryjo01,SG,35,TOT,69,2,1505,161,368,.438,71,165,.430,90,203,.443,.534,62,71,.873,26,133,159,167,60,9,67,95,455
26,Jon Barry\barryjo01,SG,35,ATL,16,0,275,31,77,.403,11,32,.344,20,45,.444,.474,10,13,.769,4,17,21,28,14,2,14,28,83
26,Jon Barry\barryjo01,SG,35,HOU,53,2,1230,130,291,.447,60,133,.451,70,158,.443,.550,52,58,.897,22,116,138,139,46,7,53,67,372
27,Tony Battie\battito01,C,28,ORL,81,32,1894,163,354,.460,0,6,.000,163,348,.468,.460,68,94,.723,109,343,452,42,30,81,81,244,394
28,Shane Battier\battish01,SG,26,MEM,80,72,2516,271,613,.442,70,177,.395,201,436,.461,.499,180,228,.789,158,255,413,126,91,77,75,201,792
29,Lonny Baxter\baxtelo01,PF,26,NOH,4,0,36,3,11,.273,0,0,,3,11,.273,.273,0,2,.000,4,4,8,0,0,0,4,10,6
30,Raja Bell\bellra01,SG,28,UTA,63,32,1790,303,667,.454,54,134,.403,249,533,.467,.495,112,150,.747,48,153,201,91,44,8,79,205,772
31,Jonathan Bender\bendejo01,SF,24,IND,7,0,93,16,40,.400,1,5,.200,15,35,.429,.413,3,6,.500,5,9,14,4,1,2,10,9,36
32,Travis Best\besttr01,PG,32,NJN,76,6,1461,190,452,.420,26,85,.306,164,367,.447,.449,108,122,.885,19,88,107,143,66,9,67,148,514
33,Mike Bibby\bibbymi01,PG,26,SAC,80,80,3084,560,1264,.443,131,364,.360,429,900,.477,.495,320,413,.775,77,255,332,541,124,30,203,191,1571
34,Andris Biedriņš\biedran01,C,18,GSW,30,1,384,45,78,.577,0,1,.000,45,77,.584,.577,19,40,.475,47,71,118,12,12,24,12,87,109
35,Chauncey Billups\billuch01,PG,28,DET,80,80,2866,404,913,.442,165,387,.426,239,526,.454,.533,343,382,.898,48,223,271,464,81,9,180,194,1316
36,Steve Blake\blakest01,PG,24,WAS,44,1,648,61,186,.328,36,93,.387,25,93,.269,.425,33,41,.805,18,53,71,69,13,0,39,47,191
37,Mark Blount\blounma01,C,29,BOS,82,57,2130,327,618,.529,0,1,.000,327,617,.530,.529,117,164,.713,143,254,397,129,33,64,158,229,771
38,Tony Bobbitt\bobbito01,SG,25,LAL,2,0,12,2,5,.400,1,2,.500,1,3,.333,.500,0,0,,0,3,3,0,0,0,0,1,5
39,Keith Bogans\boganke01,SG,24,CHA,74,42,1791,262,688,.381,57,173,.329,205,515,.398,.422,133,183,.727,76,150,226,135,68,8,122,167,714
40,Matt Bonner\bonnema01,C,24,TOR,82,0,1553,247,463,.533,39,92,.424,208,371,.561,.576,56,71,.789,108,177,285,48,39,19,40,220,589
41,Calvin Booth\boothca01,C,28,TOT,51,1,451,49,108,.454,0,1,.000,49,107,.458,.454,26,32,.813,29,78,107,8,15,28,16,78,124
41,Calvin Booth\boothca01,C,28,DAL,34,1,262,34,79,.430,0,1,.000,34,78,.436,.430,14,16,.875,16,42,58,4,11,16,8,55,82
41,Calvin Booth\boothca01,C,28,MIL,17,0,189,15,29,.517,0,0,,15,29,.517,.517,12,16,.750,13,36,49,4,4,12,8,23,42
42,Carlos Boozer\boozeca01,PF,23,UTA,51,51,1772,361,693,.521,0,1,.000,361,692,.522,.521,187,268,.698,141,316,457,144,41,24,137,179,909
43,Curtis Borchardt\borchcu01,C,24,UTA,67,23,859,74,172,.430,0,0,,74,172,.430,.430,52,71,.732,86,138,224,49,10,32,52,160,200
44,Chris Bosh*\boshch01,PF,20,TOR,81,81,3017,473,1005,.471,3,10,.300,470,995,.472,.472,412,542,.760,194,524,718,153,76,113,187,226,1361
45,Bruce Bowen\bowenbr01,SF,33,SAS,82,82,2627,251,598,.420,102,253,.403,149,345,.432,.505,71,112,.634,50,235,285,126,55,39,57,175,675
46,Ryan Bowen\bowenry01,SF,29,HOU,66,6,604,47,111,.423,3,6,.500,44,105,.419,.437,14,21,.667,21,55,76,18,23,5,7,61,111
47,Earl Boykins\boykiea01,PG,28,DEN,82,5,2162,340,824,.413,56,166,.337,284,658,.432,.447,279,303,.921,37,106,143,372,78,12,121,122,1015
48,Michael Bradley\bradlmi01,PF,25,TOT,18,0,119,15,24,.625,0,1,.000,15,23,.652,.625,3,8,.375,8,20,28,5,1,2,5,12,33
48,Michael Bradley\bradlmi01,PF,25,ORL,8,0,55,3,7,.429,0,0,,3,7,.429,.429,0,0,,3,11,14,2,1,2,1,4,6
48,Michael Bradley\bradlmi01,PF,25,SAC,8,0,48,8,12,.667,0,0,,8,12,.667,.667,2,6,.333,5,6,11,2,0,0,3,8,18
48,Michael Bradley\bradlmi01,PF,25,PHI,2,0,16,4,5,.800,0,1,.000,4,4,1.000,.800,1,2,.500,0,3,3,1,0,0,1,0,9
49,Shawn Bradley\bradlsh01,C,32,DAL,77,14,885,84,186,.452,0,0,,84,186,.452,.452,43,63,.683,70,144,214,15,25,63,33,153,211
50,Torraye Braggs\braggto01,PF,28,HOU,7,0,24,3,7,.429,0,0,,3,7,.429,.429,0,0,,7,5,12,0,0,0,2,4,6
51,Elton Brand\brandel01,PF,25,LAC,81,81,3001,629,1251,.503,0,3,.000,629,1248,.504,.503,364,484,.752,296,474,770,208,62,169,183,240,1622
52,Jamison Brewer\breweja01,PG,24,NYK,18,0,185,11,37,.297,3,15,.200,8,22,.364,.338,6,13,.462,6,16,22,12,8,1,13,11,31
53,Primož Brezec\brezepr01,C,25,CHA,72,72,2276,387,756,.512,0,0,,387,756,.512,.512,164,220,.745,226,305,531,86,33,55,106,183,938
54,Damone Brown\brownda02,SF,25,WAS,14,0,152,23,62,.371,4,11,.364,19,51,.373,.403,4,9,.444,10,18,28,14,1,6,15,17,54
55,Devin Brown\brownde02,SG,26,SAS,67,0,1238,173,409,.423,45,121,.372,128,288,.444,.478,103,130,.792,37,139,176,92,39,12,53,83,494
56,Kedrick Brown\brownke01,SF,23,PHI,8,0,55,2,6,.333,0,3,.000,2,3,.667,.333,8,10,.800,1,10,11,4,3,1,5,4,12
57,Kwame Brown\brownkw01,PF,22,WAS,42,14,908,109,237,.460,0,0,,109,237,.460,.460,74,129,.574,72,134,206,39,25,15,67,112,292
58,P.J. Brown\brownpj01,PF,35,NOH,82,78,2817,338,758,.446,0,0,,338,758,.446,.446,210,243,.864,266,471,737,178,74,50,101,233,886
59,Tierre Brown\brownti01,PG,25,LAL,76,0,1066,124,348,.356,26,72,.361,98,276,.355,.394,59,75,.787,21,72,93,155,32,1,74,59,333
60,Rick Brunson\brunsri01,PG,32,LAC,80,39,1945,166,442,.376,48,130,.369,118,312,.378,.430,57,74,.770,23,164,187,410,82,7,125,106,437
61,Kobe Bryant*\bryanko01,SG,26,LAL,66,66,2689,573,1324,.433,131,387,.339,442,937,.472,.482,542,664,.816,95,297,392,398,86,53,270,174,1819
62,Greg Buckner\buckngr01,SG,28,DEN,70,41,1522,160,303,.528,49,121,.405,111,182,.610,.609,63,81,.778,66,142,208,133,75,6,49,169,432
63,Rodney Buford\buforro01,SF,27,NJN,64,17,1313,187,489,.382,34,108,.315,153,381,.402,.417,37,45,.822,33,156,189,63,40,4,35,101,445
64,Antonio Burks\burksan01,PG,24,MEM,24,0,219,28,60,.467,3,11,.273,25,49,.510,.492,14,19,.737,1,11,12,28,13,1,12,25,73
65,Caron Butler\butleca01,SF,24,LAL,77,77,2746,441,991,.445,38,125,.304,403,866,.465,.464,275,319,.862,146,304,450,146,110,23,125,213,1195
66,Jackie Butler\butleja01,C,19,NYK,3,0,5,4,4,1.000,0,0,,4,4,1.000,1.000,2,2,1.000,0,0,0,0,1,0,1,0,10
67,Rasual Butler\butlera01,SF,25,MIA,65,15,1203,163,409,.399,57,153,.373,106,256,.414,.468,37,48,.771,15,136,151,62,18,29,37,104,420
68,Žarko Čabarkapa\cabarza01,PF,23,TOT,40,0,475,86,177,.486,13,36,.361,73,141,.518,.523,53,65,.815,35,67,102,25,10,5,30,59,238
68,Žarko Čabarkapa\cabarza01,PF,23,PHO,3,0,11,4,7,.571,0,0,,4,7,.571,.571,1,1,1.000,2,1,3,0,0,0,0,0,9
68,Žarko Čabarkapa\cabarza01,PF,23,GSW,37,0,464,82,170,.482,13,36,.361,69,134,.515,.521,52,64,.813,33,66,99,25,10,5,30,59,229
69,Marcus Camby\cambyma01,C,30,DEN,66,66,2015,279,600,.465,0,4,.000,279,596,.468,.465,125,173,.723,131,530,661,152,61,199,103,177,683
70,Elden Campbell\campbel01,C,36,TOT,40,1,390,39,123,.317,0,2,.000,39,121,.322,.317,42,55,.764,28,65,93,19,8,7,29,57,120
70,Elden Campbell\campbel01,C,36,NJN,10,0,50,0,7,.000,0,0,,0,7,.000,.000,2,4,.500,3,8,11,3,0,1,1,10,2
70,Elden Campbell\campbel01,C,36,DET,30,1,340,39,116,.336,0,2,.000,39,114,.342,.336,40,51,.784,25,57,82,16,8,6,28,47,118
71,Brian Cardinal\cardibr01,PF,27,MEM,58,16,1433,160,432,.370,44,125,.352,116,307,.378,.421,158,181,.873,63,162,225,114,88,19,83,172,522
72,Geno Carlisle\carlige01,SG,28,POR,6,0,16,2,3,.667,0,0,,2,3,.667,.667,4,6,.667,1,0,1,1,0,0,1,1,8
73,Matt Carroll\carroma01,SG,24,CHA,25,0,430,70,180,.389,13,39,.333,57,141,.404,.425,71,83,.855,13,47,60,17,17,2,25,37,224
74,Anthony Carter\cartean01,PG,29,MIN,66,12,742,72,177,.407,2,17,.118,70,160,.438,.412,35,51,.686,12,57,69,161,35,18,62,88,181
75,Vince Carter\cartevi01,SF-SG,28,TOT,77,76,2828,696,1541,.452,127,313,.406,569,1228,.463,.493,367,460,.798,106,295,401,327,109,48,168,243,1886
75,Vince Carter\cartevi01,SG,28,TOR,20,20,608,124,302,.411,19,59,.322,105,243,.432,.442,50,72,.694,28,38,66,61,25,15,22,56,317
75,Vince Carter\cartevi01,SF,28,NJN,57,56,2220,572,1239,.462,108,254,.425,464,985,.471,.505,317,388,.817,78,257,335,266,84,33,146,187,1569
76,Sam Cassell\cassesa01,PG,35,MIN,59,38,1522,319,687,.464,27,103,.262,292,584,.500,.484,134,155,.865,25,132,157,301,36,14,109,160,799
77,Kelvin Cato\catoke01,C,30,ORL,62,50,1525,160,297,.539,0,0,,160,297,.539,.539,112,143,.783,102,314,416,40,55,82,64,170,432
78,Lionel Chalmers\chalmli01,PG,24,LAC,36,0,433,42,125,.336,12,49,.245,30,76,.395,.384,15,24,.625,4,27,31,51,13,0,24,30,111
79,Tyson Chandler\chandty01,C,22,CHI,80,10,2189,207,419,.494,0,2,.000,207,417,.496,.494,226,336,.673,261,514,775,65,69,141,118,268,640
80,Calbert Cheaney\cheanca01,SG,33,GSW,55,5,951,113,265,.426,0,3,.000,113,262,.431,.426,24,37,.649,32,92,124,64,17,15,35,95,250
81,Josh Childress\childjo01,SG,21,ATL,80,44,2376,302,642,.470,13,56,.232,289,586,.493,.481,190,231,.823,195,287,482,151,74,35,106,184,807
82,Doug Christie\chrisdo01,SG,34,TOT,52,44,1525,130,332,.392,15,62,.242,115,270,.426,.414,70,78,.897,38,139,177,199,80,18,104,106,345
82,Doug Christie\chrisdo01,SG,34,SAC,31,31,996,83,204,.407,10,39,.256,73,165,.442,.431,50,56,.893,29,94,123,153,43,13,68,61,226
82,Doug Christie\chrisdo01,SG,34,ORL,21,13,529,47,128,.367,5,23,.217,42,105,.400,.387,20,22,.909,9,45,54,46,37,5,36,45,119
83,Speedy Claxton\claxtsp01,PG,26,TOT,62,47,1866,257,611,.421,11,61,.180,246,550,.447,.430,187,254,.736,37,147,184,374,109,8,119,184,712
83,Speedy Claxton\claxtsp01,PG,26,GSW,46,44,1501,216,501,.431,10,52,.192,206,449,.459,.441,162,213,.761,32,121,153,286,87,6,92,154,604
83,Speedy Claxton\claxtsp01,PG,26,NOH,16,3,365,41,110,.373,1,9,.111,40,101,.396,.377,25,41,.610,5,26,31,88,22,2,27,30,108
84,Mateen Cleaves\cleavma01,PG,27,SEA,14,0,65,5,14,.357,0,2,.000,5,12,.417,.357,3,4,.750,2,4,6,7,2,0,2,2,13
85,Derrick Coleman\colemde01,C,37,DET,5,0,50,3,14,.214,0,2,.000,3,12,.250,.214,3,3,1.000,3,12,15,0,0,0,2,6,9
86,Jason Collier\collija02,C,27,ATL,70,44,942,174,376,.463,6,14,.429,168,362,.464,.471,48,71,.676,84,100,184,18,15,13,63,147,402
87,Jarron Collins\collija03,C,26,UTA,50,38,961,65,157,.414,0,1,.000,65,156,.417,.414,83,119,.697,57,107,164,61,11,6,34,146,213
88,Jason Collins\collija04,C,26,NJN,80,80,2542,186,451,.412,2,6,.333,184,445,.413,.415,137,209,.656,153,335,488,105,71,71,91,322,511
89,Nick Collison\collini01,C,24,SEA,82,4,1396,190,354,.537,0,3,.000,190,351,.541,.537,83,118,.703,156,220,376,32,34,50,62,252,463
90,Brian Cook\cookbr01,C,24,LAL,72,0,1087,176,422,.417,78,199,.392,98,223,.439,.509,28,37,.757,63,153,216,35,23,26,29,139,458
91,Omar Cook\cookom01,PG,23,TOR,5,0,74,10,24,.417,0,4,.000,10,20,.500,.417,3,6,.500,2,5,7,22,6,1,6,6,23
92,Jamal Crawford\crawfja01,SG,24,NYK,70,67,2688,437,1097,.398,185,512,.361,252,585,.431,.483,182,216,.843,33,170,203,302,92,19,148,135,1241
93,Austin Croshere\croshau01,PF,29,IND,73,22,1827,188,497,.378,45,174,.259,143,323,.443,.424,226,256,.883,103,272,375,98,48,17,104,154,647
94,Eddy Curry\curryed01,C,22,CHI,63,60,1808,393,730,.538,0,0,,393,730,.538,.538,226,314,.720,116,222,338,37,21,58,163,202,1012
95,Michael Curry\currymi01,SF,36,IND,18,7,249,13,29,.448,0,0,,13,29,.448,.448,4,8,.500,8,19,27,15,5,4,5,39,30
96,Samuel Dalembert\dalemsa01,C,23,PHI,72,60,1785,250,477,.524,0,0,,250,477,.524,.524,89,148,.601,187,355,542,35,46,121,114,241,589
97,Erick Dampier\dampier01,C,29,DAL,59,56,1609,202,367,.550,0,3,.000,202,364,.555,.550,138,228,.605,183,318,501,51,15,80,102,205,542
98,Antonio Daniels\daniean01,PG,29,SEA,75,2,2026,273,623,.438,49,165,.297,224,458,.489,.478,248,304,.816,20,149,169,309,51,3,78,78,843
99,Erik Daniels\danieer01,SF,22,SAC,21,0,72,6,18,.333,1,2,.500,5,16,.313,.361,0,0,,7,11,18,4,2,0,6,7,13
100,Marquis Daniels\daniema01,SG,24,DAL,60,17,1412,220,504,.437,7,35,.200,213,469,.454,.443,98,133,.737,87,129,216,128,83,14,86,124,545
101,Antonio Davis\davisan01,PF,36,CHI,72,62,1843,193,419,.461,0,0,,193,419,.461,.461,115,152,.757,152,276,428,80,27,41,96,147,501
102,Baron Davis\davisba01,PG,25,TOT,46,32,1581,291,752,.387,118,354,.333,173,398,.435,.465,185,243,.761,32,143,175,362,81,14,131,126,885
102,Baron Davis\davisba01,PG,25,NOH,18,13,593,111,303,.366,44,137,.321,67,166,.404,.439,74,96,.771,16,51,67,129,31,4,38,52,340
102,Baron Davis\davisba01,PG,25,GSW,28,19,988,180,449,.401,74,217,.341,106,232,.457,.483,111,147,.755,16,92,108,233,50,10,93,74,545
103,Dale Davis\davisda01,C,35,TOT,61,28,1307,112,234,.479,0,0,,112,234,.479,.479,60,99,.606,152,223,375,47,32,65,43,162,284
103,Dale Davis\davisda01,C,35,GSW,36,3,577,45,109,.413,0,0,,45,109,.413,.413,22,38,.579,61,92,153,23,13,32,20,79,112
103,Dale Davis\davisda01,C,35,IND,25,25,730,67,125,.536,0,0,,67,125,.536,.536,38,61,.623,91,131,222,24,19,33,23,83,172
104,Josh Davis\davisjo02,PF,24,PHI,42,5,328,42,111,.378,19,53,.358,23,58,.397,.464,14,17,.824,29,50,79,12,8,4,15,45,117
105,Ricky Davis\davisri01,SG,25,BOS,82,11,2696,481,1041,.462,61,180,.339,420,861,.488,.491,286,351,.815,66,183,249,246,89,27,205,174,1309
106,Andrew DeClercq\declean01,C,31,ORL,8,0,49,4,9,.444,0,0,,4,9,.444,.444,1,3,.333,7,3,10,0,2,0,1,14,9
107,Carlos Delfino\delfica01,SG,22,DET,30,4,459,42,117,.359,9,35,.257,33,82,.402,.397,23,40,.575,13,42,55,38,22,6,23,44,116
108,Tony Delk\delkto01,SG,31,ATL,56,1,1340,246,591,.416,72,202,.356,174,389,.447,.477,103,136,.757,28,102,130,104,47,3,54,123,667
109,Luol Deng\denglu01,SF,19,CHI,61,45,1663,280,645,.434,31,117,.265,249,528,.472,.458,120,162,.741,92,230,322,135,48,27,118,98,711
110,Boris Diaw\diawbo01,SG,22,ATL,66,25,1201,124,294,.422,9,50,.180,115,244,.471,.437,57,77,.740,54,116,170,149,37,18,87,123,314
111,Dan Dickau\dickada01,PG,26,TOT,71,46,2090,306,756,.405,85,245,.347,221,511,.432,.461,190,228,.833,34,146,180,347,76,4,145,201,887
111,Dan Dickau\dickada01,PG,26,DAL,4,0,16,1,8,.125,1,3,.333,0,5,.000,.188,2,3,.667,0,1,1,1,0,0,1,1,5
111,Dan Dickau\dickada01,PG,26,NOH,67,46,2074,305,748,.408,84,242,.347,221,506,.437,.464,188,225,.836,34,145,179,346,76,4,144,200,882
112,Kaniel Dickens\dickeka01,SF,26,NJN,11,0,61,4,14,.286,3,9,.333,1,5,.200,.393,2,2,1.000,3,6,9,1,2,1,2,5,13
113,DeSagana Diop\diopde01,C,23,CLE,39,0,306,20,69,.290,0,2,.000,20,67,.299,.290,0,5,.000,30,40,70,15,8,27,12,53,40
114,Vlade Divac*\divacvl01,C,36,LAL,15,0,130,13,31,.419,0,0,,13,31,.419,.419,8,12,.667,18,14,32,19,4,1,14,25,34
115,Juan Dixon\dixonju01,SG,26,WAS,63,4,1054,186,447,.416,48,147,.327,138,300,.460,.470,87,97,.897,32,87,119,111,43,4,68,98,507
116,Michael Doleac\doleami01,C,27,MIA,80,8,1175,148,331,.447,0,2,.000,148,329,.450,.447,25,41,.610,74,185,259,47,23,22,36,160,321
117,Keyon Dooling\doolike01,PG,24,MIA,74,0,1184,139,345,.403,19,75,.253,120,270,.444,.430,85,109,.780,11,79,90,132,39,11,65,120,382
118,Predrag Drobnjak\drobnpr01,C,29,ATL,71,1,1435,238,543,.438,25,71,.352,213,472,.451,.461,96,120,.800,73,165,238,49,42,24,78,138,597
119,Chris Duhon\duhonch01,PG,22,CHI,82,73,2177,172,488,.352,94,265,.355,78,223,.350,.449,49,67,.731,23,190,213,398,82,3,119,205,487
120,Tim Duncan*\duncati01,PF,28,SAS,66,66,2203,517,1042,.496,3,9,.333,514,1033,.498,.498,305,455,.670,202,530,732,179,45,174,127,144,1342
121,Mike Dunleavy\dunlemi02,SF,24,GSW,79,79,2570,408,905,.451,107,276,.388,301,629,.479,.510,134,172,.779,97,338,435,203,79,26,132,198,1057
122,Ronald Dupree\duprero01,SF,24,DET,47,0,472,61,127,.480,1,2,.500,60,125,.480,.484,29,47,.617,34,61,95,24,7,10,22,60,152
123,Ndudi Ebi\ebind01,SG,20,MIN,2,0,54,11,21,.524,0,1,.000,11,20,.550,.524,5,9,.556,6,10,16,1,1,1,3,7,27
124,Corsley Edwards\edwarco01,C,25,NOH,10,0,110,10,31,.323,0,0,,10,31,.323,.323,7,12,.583,12,13,25,3,3,4,2,19,27
125,John Edwards\edwarjo01,C,23,IND,25,1,139,11,30,.367,0,0,,11,30,.367,.367,7,14,.500,8,11,19,3,3,4,8,12,29
126,Howard Eisley\eisleho01,PG,32,UTA,74,1,1428,161,405,.398,27,103,.262,134,302,.444,.431,66,83,.795,15,75,90,250,45,9,111,156,415
127,Obinna Ekezie\ekeziob01,C,29,ATL,42,31,732,79,182,.434,0,1,.000,79,181,.436,.434,72,93,.774,69,110,179,11,22,12,45,129,230
128,Francisco Elson\elsonfr01,C,28,DEN,67,11,939,101,216,.468,1,3,.333,100,213,.469,.470,45,79,.570,61,140,201,34,34,41,40,129,248
129,Melvin Ely\elyme01,PF,26,CHA,79,17,1649,227,526,.432,0,0,,227,526,.432,.432,122,212,.575,142,184,326,76,32,69,115,199,576
130,Andre Emmett\emmetan01,SG,22,MEM,8,0,28,2,6,.333,0,0,,2,6,.333,.333,3,5,.600,0,2,2,0,0,0,1,4,7
131,Maurice Evans\evansma01,SG,26,SAC,65,11,1233,165,373,.442,27,82,.329,138,291,.474,.479,59,78,.756,88,113,201,45,37,8,34,104,416
132,Reggie Evans\evansre01,PF,24,SEA,79,79,1881,131,275,.476,0,2,.000,131,273,.480,.476,125,234,.534,254,482,736,58,58,15,104,202,387
133,Michael Finley\finlemi01,SG,31,DAL,64,64,2358,387,907,.427,116,285,.407,271,622,.436,.491,113,136,.831,45,217,262,169,48,18,60,123,1003
134,Derek Fisher\fishede01,PG,30,GSW,74,32,2222,297,755,.393,108,291,.371,189,464,.407,.465,175,203,.862,38,180,218,301,76,4,129,176,877
135,Marcus Fizer\fizerma01,PF,26,MIL,54,0,903,133,292,.455,0,6,.000,133,286,.465,.455,70,103,.680,29,146,175,64,25,13,63,96,336
136,Luis Flores\florelu01,PG,23,TOT,16,0,77,14,29,.483,5,10,.500,9,19,.474,.569,2,2,1.000,1,2,3,11,2,0,11,9,35
136,Luis Flores\florelu01,PG,23,GSW,15,0,73,13,27,.481,4,9,.444,9,18,.500,.556,2,2,1.000,0,2,2,11,2,0,11,9,32
136,Luis Flores\florelu01,PG,23,DEN,1,0,4,1,2,.500,1,1,1.000,0,1,.000,.750,0,0,,1,0,1,0,0,0,0,0,3
137,Danny Fortson\fortsda01,C,28,SEA,62,0,1047,118,226,.522,0,0,,118,226,.522,.522,227,258,.880,157,191,348,8,15,7,91,265,463
138,Jeff Foster\fosteje01,C,28,IND,61,43,1594,168,324,.519,0,5,.000,168,319,.527,.519,90,142,.634,205,345,550,43,46,12,55,186,426
139,Tremaine Fowlkes\fowlktr01,SF,28,IND,8,0,56,9,17,.529,1,3,.333,8,14,.571,.559,0,2,.000,3,5,8,0,2,0,5,7,19
140,Adonal Foyle\foylead01,C,29,GSW,78,50,1700,156,311,.502,0,0,,156,311,.502,.502,40,72,.556,165,264,429,56,26,159,58,201,352
141,Richie Frahm\frahmri01,SG,27,POR,43,0,499,56,140,.400,31,80,.388,25,60,.417,.511,21,25,.840,17,44,61,30,15,4,14,35,164
142,Steve Francis\francst01,PG,27,ORL,78,78,2978,563,1330,.423,38,127,.299,525,1203,.436,.438,499,606,.823,126,324,450,547,112,28,317,273,1663
143,Matt Freije\freijma01,PF,23,NOH,23,11,441,37,127,.291,14,54,.259,23,73,.315,.346,5,8,.625,16,45,61,20,13,2,17,40,93
144,Lawrence Funderburke\fundela01,PF,34,CHI,2,0,21,3,6,.500,0,0,,3,6,.500,.500,3,5,.600,1,2,3,0,0,0,0,2,9
145,Dan Gadzuric\gadzuda01,C,26,MIL,81,81,1783,243,451,.539,0,0,,243,451,.539,.539,107,199,.538,261,413,674,30,47,106,81,224,593
146,Reece Gaines\gainere01,PG,24,TOT,21,0,187,17,50,.340,4,14,.286,13,36,.361,.380,3,4,.750,1,13,14,7,5,1,7,17,41
146,Reece Gaines\gainere01,PG,24,HOU,10,0,108,10,27,.370,3,12,.250,7,15,.467,.426,3,4,.750,0,11,11,3,3,0,4,12,26
146,Reece Gaines\gainere01,PG,24,MIL,11,0,79,7,23,.304,1,2,.500,6,21,.286,.326,0,0,,1,2,3,4,2,1,3,5,15
147,Alex Garcia\garcial01,SG,24,NOH,8,3,146,18,52,.346,5,18,.278,13,34,.382,.394,3,4,.750,7,8,15,18,4,1,8,15,44
148,Kevin Garnett*\garneke01,PF,28,MIN,82,82,3121,683,1360,.502,6,25,.240,677,1335,.507,.504,445,549,.811,247,861,1108,466,121,112,222,207,1817
149,Pat Garrity\garripa01,PF,28,ORL,71,0,955,123,306,.402,49,147,.333,74,159,.465,.482,29,33,.879,21,103,124,30,19,9,30,107,324
150,Pau Gasol\gasolpa01,PF,24,MEM,56,53,1790,357,695,.514,1,6,.167,356,689,.517,.514,282,367,.768,130,280,410,135,37,93,137,146,997
151,Devean George\georgde01,SF,27,LAL,15,3,306,37,104,.356,21,58,.362,16,46,.348,.457,15,20,.750,13,40,53,14,8,2,12,32,110
152,Eddie Gill\gilled01,PG,26,IND,73,3,1021,81,242,.335,36,117,.308,45,125,.360,.409,71,81,.877,16,96,112,83,59,5,60,105,269
153,Kendall Gill\gillke01,SG,36,MIL,14,0,284,32,80,.400,3,9,.333,29,71,.408,.419,18,20,.900,11,26,37,27,14,4,9,37,85
154,Manu Ginóbili*\ginobma01,SG,27,SAS,74,74,2193,367,780,.471,97,258,.376,270,522,.517,.533,355,442,.803,75,254,329,288,119,27,172,190,1186
155,Gordan Giriček\giricgo01,SG,27,UTA,81,44,1660,283,632,.448,38,105,.362,245,527,.465,.478,111,137,.810,25,157,182,137,46,11,90,155,715
156,Dion Glover\glovedi01,SG,26,SAS,7,0,68,8,22,.364,1,8,.125,7,14,.500,.386,8,10,.800,3,8,11,4,3,3,2,9,25
157,Anthony Goldwire\goldwan01,PG,33,TOT,33,2,537,57,136,.419,32,80,.400,25,56,.446,.537,26,31,.839,10,49,59,78,15,0,15,32,172
157,Anthony Goldwire\goldwan01,PG,33,DET,9,0,55,4,15,.267,3,9,.333,1,6,.167,.367,7,8,.875,1,7,8,0,0,0,1,5,18
157,Anthony Goldwire\goldwan01,PG,33,MIL,24,2,482,53,121,.438,29,71,.408,24,50,.480,.558,19,23,.826,9,42,51,78,15,0,14,27,154
158,Drew Gooden\goodedr01,PF,23,CLE,82,80,2523,464,943,.492,5,28,.179,459,915,.502,.495,251,310,.810,207,546,753,130,77,76,133,233,1184
159,Ben Gordon\gordobe01,SG,21,CHI,82,3,2002,434,1056,.411,134,331,.405,300,725,.414,.474,233,270,.863,55,160,215,164,53,10,186,224,1235
160,Brian Grant\grantbr01,C,32,LAL,69,8,1136,103,209,.493,0,0,,103,209,.493,.493,57,79,.722,101,156,257,34,23,23,43,175,263
161,Willie Green\greenwi01,SG,23,PHI,57,21,1066,155,423,.366,30,105,.286,125,318,.393,.402,97,125,.776,22,111,133,100,34,6,75,121,437
162,Adrian Griffin\griffad01,SF,30,CHI,69,1,667,58,161,.360,2,9,.222,56,152,.368,.366,33,44,.750,52,94,146,53,43,4,30,78,151
163,Eddie Griffin\griffed01,PF,22,MIN,70,0,1492,202,522,.387,67,204,.328,135,318,.425,.451,56,78,.718,128,325,453,53,23,118,55,120,527
164,Tom Gugliotta\guglito01,PF,35,TOT,47,9,966,99,241,.411,8,26,.308,91,215,.423,.427,33,43,.767,56,135,191,68,41,17,57,104,239
164,Tom Gugliotta\guglito01,PF,35,BOS,20,0,218,11,37,.297,0,0,,11,37,.297,.297,4,6,.667,15,28,43,12,9,4,9,23,26
164,Tom Gugliotta\guglito01,PF,35,ATL,27,9,748,88,204,.431,8,26,.308,80,178,.449,.451,29,37,.784,41,107,148,56,32,13,48,81,213
165,Marcus Haislip\haislma01,PF,24,IND,9,0,106,13,38,.342,0,1,.000,13,37,.351,.342,6,11,.545,5,10,15,3,2,2,6,15,32
166,Darvin Ham\hamda01,SF,31,DET,47,0,275,17,37,.459,0,0,,17,37,.459,.459,12,31,.387,19,16,35,5,6,7,8,39,46
167,Richard Hamilton\hamilri01,SG,26,DET,76,76,2926,510,1160,.440,36,118,.305,474,1042,.455,.455,368,429,.858,74,221,295,372,77,13,217,232,1424
168,Zendon Hamilton\hamilze01,C,29,MIL,16,0,159,11,32,.344,0,0,,11,32,.344,.344,29,48,.604,18,24,42,6,5,2,12,26,51
169,Ben Handlogten\handlbe01,C,31,UTA,21,5,297,43,83,.518,0,1,.000,43,82,.524,.518,9,17,.529,23,42,65,13,7,5,18,55,95
170,Anfernee Hardaway\hardaan01,SF,33,NYK,37,0,894,110,260,.423,15,50,.300,95,210,.452,.452,34,46,.739,19,70,89,74,28,3,50,79,269
171,Matt Harpring\harprma01,SF,28,UTA,78,55,2584,418,855,.489,9,43,.209,409,812,.504,.494,245,315,.778,196,284,480,142,70,16,133,250,1090
172,Al Harrington\harrial01,SF,24,ATL,66,66,2550,453,986,.459,16,74,.216,437,912,.479,.468,236,351,.672,145,316,461,208,85,16,204,249,1158
173,Junior Harrington\harriju01,SG,24,NOH,29,7,550,64,178,.360,6,19,.316,58,159,.365,.376,29,35,.829,13,50,63,62,25,5,41,72,163
174,Othella Harrington\harriot01,PF,31,CHI,70,28,1271,217,424,.512,0,0,,217,424,.512,.512,127,177,.718,106,186,292,56,24,18,84,188,561
175,Devin Harris\harride01,PG,21,DAL,76,19,1173,157,366,.429,44,131,.336,113,235,.481,.489,78,103,.757,28,74,102,169,77,19,82,139,436
176,Lucious Harris\harrilu01,SG,34,CLE,73,4,1128,118,299,.395,21,65,.323,97,234,.415,.430,56,69,.812,39,82,121,49,27,6,29,68,313
177,David Harrison\harrida01,C,22,IND,43,14,760,106,184,.576,0,0,,106,184,.576,.576,52,91,.571,48,87,135,13,16,55,53,134,264
178,Jason Hart\hartja01,PG,26,CHA,74,27,1887,257,573,.449,35,95,.368,222,478,.464,.479,157,200,.785,18,185,203,367,99,14,102,167,706
179,Donnell Harvey\harvedo01,PF,24,NJN,3,0,16,2,2,1.000,0,0,,2,2,1.000,1.000,4,4,1.000,2,5,7,1,1,1,1,2,8
180,Udonis Haslem\hasleud01,PF,24,MIA,80,80,2675,346,641,.540,0,4,.000,346,637,.543,.540,178,225,.791,239,487,726,108,63,41,113,260,870
181,Trenton Hassell\hassetr01,SG,25,MIN,82,51,2068,225,475,.474,1,11,.091,224,464,.483,.475,90,114,.789,80,139,219,128,30,30,64,200,541
182,Jarvis Hayes\hayesja01,SF,23,WAS,54,22,1560,206,530,.389,42,123,.341,164,407,.403,.428,99,118,.839,41,186,227,90,49,9,62,107,553
183,Brendan Haywood\haywobr01,C,25,WAS,68,68,1865,239,427,.560,0,0,,239,427,.560,.560,159,261,.609,202,262,464,57,52,114,96,218,637
184,Alan Henderson\hendeal01,PF,32,DAL,78,10,1203,116,220,.527,0,2,.000,116,218,.532,.527,41,76,.539,164,184,348,21,29,37,49,149,273
185,Nenê\hilarne01,C,22,DEN,55,18,1317,194,386,.503,0,2,.000,194,384,.505,.503,140,212,.660,104,221,325,84,50,48,94,167,528
186,Grant Hill*\hillgr01,SF,32,ORL,67,67,2338,517,1015,.509,3,13,.231,514,1002,.513,.511,280,341,.821,77,241,318,220,97,28,161,144,1317
187,Kirk Hinrich\hinriki01,PG,24,CHI,77,77,2800,445,1122,.397,145,408,.355,300,714,.420,.461,171,216,.792,32,272,304,494,122,21,176,244,1206
188,Fred Hoiberg\hoibefr01,SG,32,MIN,76,0,1272,139,284,.489,70,145,.483,69,139,.496,.613,89,102,.873,32,149,181,85,50,15,20,105,437
189,Robert Horry\horryro01,PF,34,SAS,75,16,1396,157,375,.419,51,138,.370,106,237,.447,.487,86,109,.789,91,177,268,80,67,60,69,138,451
190,Eddie House\houseed01,PG-SG,26,TOT,68,7,891,165,366,.451,44,97,.454,121,269,.450,.511,23,27,.852,16,67,83,96,44,6,35,65,397
190,Eddie House\houseed01,SG,26,CHA,13,5,300,61,135,.452,12,29,.414,49,106,.462,.496,10,13,.769,2,17,19,24,24,3,13,23,144
190,Eddie House\houseed01,SG,26,MIL,5,0,41,6,17,.353,4,6,.667,2,11,.182,.471,0,0,,0,3,3,5,2,0,0,3,16
190,Eddie House\houseed01,PG,26,SAC,50,2,550,98,214,.458,28,62,.452,70,152,.461,.523,13,14,.929,14,47,61,67,18,3,22,39,237
191,Allan Houston\houstal01,SG,33,NYK,20,11,532,85,205,.415,31,80,.388,54,125,.432,.490,36,43,.837,4,19,23,42,8,2,21,40,237
192,Dwight Howard\howardw01,PF,19,ORL,82,82,2670,352,677,.520,0,2,.000,352,675,.521,.520,277,413,.671,287,536,823,75,77,136,165,232,981
193,Josh Howard\howarjo01,SF,24,DAL,76,76,2446,377,793,.475,34,115,.296,343,678,.506,.497,170,232,.733,169,315,484,109,116,49,122,211,958
194,Juwan Howard\howarju01,PF,31,HOU,61,47,1624,244,541,.451,0,1,.000,244,540,.452,.451,97,115,.843,126,220,346,94,32,5,79,143,585
195,Troy Hudson\hudsotr01,PG,28,MIN,79,32,1729,266,664,.401,89,258,.345,177,406,.436,.468,70,90,.778,19,86,105,283,27,6,113,121,691
196,Larry Hughes\hughela01,SG,26,WAS,61,61,2358,467,1086,.430,59,209,.282,408,877,.465,.457,352,453,.777,74,308,382,285,176,18,153,168,1345
197,Ryan Humphrey\humphry01,SF,25,MEM,35,0,317,42,103,.408,0,2,.000,42,101,.416,.408,18,37,.486,50,37,87,6,10,1,23,35,102
198,Kris Humphries\humphkr01,PF,19,UTA,67,4,873,116,287,.404,2,6,.333,114,281,.406,.408,44,101,.436,73,124,197,43,25,18,52,96,278
199,Brandon Hunter\huntebr01,PF,24,ORL,31,0,224,37,73,.507,0,0,,37,73,.507,.507,21,39,.538,25,44,69,3,4,7,22,42,95
200,Lindsey Hunter\hunteli01,SG,34,DET,76,3,1144,108,302,.358,23,84,.274,85,218,.390,.396,46,58,.793,38,85,123,130,68,13,68,125,285
201,Steven Hunter\huntest01,C,23,PHO,76,3,1046,135,220,.614,0,1,.000,135,219,.616,.614,78,163,.479,98,129,227,13,4,102,44,131,348
202,Andre Iguodala\iguodan01,SG,21,PHI,82,82,2686,269,546,.493,47,142,.331,222,404,.550,.536,156,210,.743,89,375,464,246,138,48,139,204,741
203,Zydrunas Ilgauskas\ilgauzy01,C,29,CLE,78,78,2615,458,979,.468,2,7,.286,456,972,.469,.469,402,503,.799,299,373,672,100,53,165,191,313,1320
204,D.J. Mbenga\mbengdj01,C,24,DAL,15,1,58,6,14,.429,0,0,,6,14,.429,.429,3,4,.750,3,5,8,0,0,5,5,13,15
205,Allen Iverson*\iversal01,PG,29,PHI,75,75,3174,771,1818,.424,104,338,.308,667,1480,.451,.453,656,786,.835,51,248,299,596,180,9,344,140,2302
206,Royal Ivey\iveyro01,PG,23,ATL,62,5,809,85,198,.429,3,9,.333,82,189,.434,.437,47,67,.701,19,65,84,103,39,7,58,140,220
207,Bobby Jackson\jacksbo01,SG,31,SAC,25,0,536,109,255,.427,33,96,.344,76,159,.478,.492,50,58,.862,23,62,85,59,14,2,28,58,301
208,Jermaine Jackson\jacksje01,SG,28,NYK,21,0,230,17,33,.515,0,2,.000,17,31,.548,.515,8,13,.615,3,20,23,24,7,1,10,26,42
209,Jim Jackson\jacksji01,SF,34,TOT,64,27,1987,248,582,.426,122,295,.414,126,287,.439,.531,54,58,.931,33,236,269,183,35,5,115,153,672
209,Jim Jackson\jacksji01,SF,34,HOU,24,24,990,118,283,.417,54,147,.367,64,136,.471,.512,30,33,.909,10,105,115,86,23,1,56,67,320
209,Jim Jackson\jacksji01,SF,34,PHO,40,3,997,130,299,.435,68,148,.459,62,151,.411,.548,24,25,.960,23,131,154,97,12,4,59,86,352
210,Luke Jackson\jackslu02,SF,23,CLE,10,0,43,10,27,.370,4,6,.667,6,21,.286,.444,5,6,.833,2,4,6,3,0,0,2,4,29
211,Marc Jackson\jacksma02,C,30,PHI,81,23,1976,340,731,.465,0,2,.000,340,729,.466,.465,289,349,.828,184,222,406,81,32,18,131,171,969
212,Stephen Jackson\jacksst02,SF,26,IND,51,49,1806,330,819,.403,103,286,.360,227,533,.426,.466,190,229,.830,44,206,250,119,64,14,123,154,953
213,Casey Jacobsen\jacobca01,SG-SF,23,TOT,84,1,1798,165,408,.404,66,177,.373,99,231,.429,.485,151,192,.786,35,132,167,113,33,8,71,104,547
213,Casey Jacobsen\jacobca01,SF,23,PHO,40,0,768,65,157,.414,34,89,.382,31,68,.456,.522,48,62,.774,17,50,67,37,11,1,27,56,212
213,Casey Jacobsen\jacobca01,SG,23,NOH,44,1,1030,100,251,.398,32,88,.364,68,163,.417,.462,103,130,.792,18,82,100,76,22,7,44,48,335
214,Jerome James\jamesje01,C,29,SEA,80,80,1330,174,342,.509,0,2,.000,174,340,.512,.509,47,65,.723,81,160,241,19,23,111,88,279,395
215,LeBron James\jamesle01,SF,20,CLE,80,80,3388,795,1684,.472,108,308,.351,687,1376,.499,.504,477,636,.750,111,477,588,577,177,52,262,146,2175
216,Mike James\jamesmi01,PG,29,TOT,74,5,1859,331,751,.441,100,259,.386,231,492,.470,.507,109,145,.752,35,173,208,263,65,6,106,174,871
216,Mike James\jamesmi01,PG,29,MIL,47,0,1167,205,460,.446,58,152,.382,147,308,.477,.509,67,90,.744,23,99,122,185,40,4,80,114,535
216,Mike James\jamesmi01,PG,29,HOU,27,5,692,126,291,.433,42,107,.393,84,184,.457,.505,42,55,.764,12,74,86,78,25,2,26,60,336
217,Antawn Jamison\jamisan01,PF,28,WAS,68,68,2605,519,1189,.437,71,208,.341,448,981,.457,.466,225,296,.760,160,359,519,154,55,16,118,151,1334
218,Marko Jarić\jaricma01,PG,26,LAC,50,41,1656,189,457,.414,56,151,.371,133,306,.435,.475,59,82,.720,20,141,161,303,84,17,98,107,493
219,Al Jefferson\jeffeal01,PF,20,BOS,71,1,1051,195,369,.528,0,3,.000,195,366,.533,.528,85,135,.630,119,193,312,24,22,55,66,195,475
220,Richard Jefferson\jefferi01,SF,24,NJN,33,33,1355,238,564,.422,30,89,.337,208,475,.438,.449,227,269,.844,49,191,240,133,33,17,132,109,733
221,Jared Jeffries\jeffrja01,SF,23,WAS,77,71,2007,203,434,.468,16,51,.314,187,383,.488,.486,101,173,.584,152,222,374,151,66,35,114,206,523
222,Horace Jenkins\jenkiho01,PG,30,DET,15,0,104,15,45,.333,0,9,.000,15,36,.417,.333,12,13,.923,3,6,9,9,5,1,7,6,42
223,Britton Johnsen\johnsbr01,SF,25,IND,6,1,87,6,22,.273,0,4,.000,6,18,.333,.273,0,0,,5,5,10,4,1,0,3,10,12
224,Anthony Johnson\johnsan02,PG,30,IND,63,36,1747,203,456,.445,41,108,.380,162,348,.466,.490,85,113,.752,32,147,179,302,59,15,96,144,532
225,DerMarr Johnson\johnsde03,SG,24,DEN,71,40,1232,185,371,.499,53,148,.358,132,223,.592,.570,80,101,.792,43,108,151,75,43,18,65,140,503
226,Ervin Johnson\johnser02,C,37,MIN,46,23,410,28,54,.519,1,1,1.000,27,53,.509,.528,16,25,.640,43,70,113,6,7,13,18,86,73
227,Joe Johnson\johnsjo02,SF,23,PHO,82,82,3240,544,1179,.461,177,370,.478,367,809,.454,.536,135,180,.750,120,302,422,291,79,24,148,167,1400
228,Linton Johnson\johnsli01,SF,24,SAS,2,0,15,0,2,.000,0,1,.000,0,1,.000,.000,0,0,,0,3,3,0,1,0,1,1,0
229,Dahntay Jones\jonesda02,SG,24,MEM,52,7,649,83,190,.437,23,60,.383,60,130,.462,.497,44,64,.688,11,58,69,21,13,11,29,81,233
230,Damon Jones\jonesda01,PG,28,MIA,82,66,2576,331,726,.456,225,521,.432,106,205,.517,.611,68,86,.791,14,217,231,350,44,5,98,121,955
231,Eddie Jones\jonesed02,SF,33,MIA,80,80,2839,351,820,.428,142,382,.372,209,438,.477,.515,174,216,.806,38,367,405,212,86,38,99,251,1018
232,Fred Jones\jonesfr01,SG,25,IND,77,14,2268,275,647,.425,87,229,.380,188,418,.450,.492,176,207,.850,34,208,242,196,61,31,114,171,813
233,James Jones\jonesja02,SF,24,IND,75,24,1330,126,318,.396,66,166,.398,60,152,.395,.500,53,62,.855,39,135,174,57,31,28,43,123,371
234,Jumaine Jones\jonesju01,SF,25,LAL,76,23,1830,210,486,.432,102,261,.391,108,225,.480,.537,55,75,.733,107,291,398,65,44,24,49,165,577
235,Mark Jones\jonesma03,SF,29,ORL,10,0,116,9,31,.290,0,4,.000,9,27,.333,.290,5,10,.500,6,7,13,6,5,2,3,16,23
236,Chris Kaman\kamanch01,C,22,LAC,63,50,1632,246,495,.497,0,1,.000,246,494,.498,.497,80,121,.661,135,288,423,73,26,68,115,182,572
237,Jason Kapono\kaponja01,SF,23,CHA,81,14,1491,269,671,.401,80,194,.412,189,477,.396,.461,70,85,.824,32,132,164,61,40,6,46,132,688
238,Mario Kasun\kasunma01,C,24,ORL,45,0,356,47,98,.480,0,1,.000,47,97,.485,.480,24,43,.558,52,76,128,8,8,13,26,86,118
239,Viktor Khryapa\khryavi01,SF,22,POR,32,5,523,54,124,.435,4,11,.364,50,113,.442,.452,23,42,.548,28,80,108,25,20,18,33,80,135
240,Jason Kidd*\kiddja01,PG,31,NJN,66,65,2435,340,855,.398,129,358,.360,211,497,.425,.473,142,192,.740,94,394,488,545,123,9,167,110,951
241,Andrei Kirilenko\kirilan01,PF,23,UTA,41,37,1349,207,420,.493,23,77,.299,184,343,.536,.520,203,259,.784,89,166,255,132,67,136,90,101,640
242,Kerry Kittles\kittlke01,SG,30,LAC,11,0,243,28,73,.384,7,21,.333,21,52,.404,.432,6,10,.600,1,31,32,20,8,3,7,12,69
243,Brandin Knight\knighbr02,PG,23,HOU,1,0,3,0,1,.000,0,0,,0,1,.000,.000,0,0,,0,0,0,1,0,0,0,0,0
244,Brevin Knight\knighbr01,PG,29,CHA,66,61,1944,248,587,.422,3,20,.150,245,567,.432,.425,167,196,.852,21,149,170,591,131,5,147,192,666
245,Kyle Korver\korveky01,SF,23,PHI,82,57,2667,317,759,.418,226,558,.405,91,201,.453,.567,82,96,.854,40,339,379,182,103,33,106,265,942
246,Nenad Krstić\krstine01,PF,21,NJN,75,57,1965,281,570,.493,0,2,.000,281,568,.495,.493,185,255,.725,161,240,401,77,32,63,112,280,747
247,Toni Kukoč*\kukocto01,SF,36,MIL,53,6,1099,105,256,.410,42,116,.362,63,140,.450,.492,44,61,.721,31,129,160,160,39,13,64,70,296
248,Ibo Kutluay\kutluib01,SG,30,SEA,5,0,12,0,1,.000,0,0,,0,1,.000,.000,0,0,,0,1,1,0,0,0,2,1,0
249,Christian Laettner\laettch01,PF,35,MIA,49,0,739,107,184,.582,1,7,.143,106,177,.599,.584,45,59,.763,36,95,131,41,32,15,29,78,260
250,Raef LaFrentz\lafrera01,PF,28,BOS,80,80,2196,341,688,.496,82,225,.364,259,463,.559,.555,120,148,.811,154,399,553,98,42,99,70,262,884
251,Maciej Lampe\lampema01,C,19,TOT,37,0,380,49,132,.371,2,4,.500,47,128,.367,.379,15,22,.682,24,65,89,11,5,7,17,51,115
251,Maciej Lampe\lampema01,C,19,PHO,16,0,119,17,49,.347,2,3,.667,15,46,.326,.367,8,12,.667,9,23,32,1,1,2,10,20,44
251,Maciej Lampe\lampema01,C,19,NOH,21,0,261,32,83,.386,0,1,.000,32,82,.390,.386,7,10,.700,15,42,57,10,4,5,7,31,71
252,Voshon Lenard\lenarvo01,SG,31,DEN,3,1,54,10,26,.385,4,12,.333,6,14,.429,.462,5,8,.625,0,6,6,6,1,0,2,2,29
253,Rashard Lewis\lewisra02,SF,25,SEA,71,71,2697,532,1151,.462,173,432,.400,359,719,.499,.537,220,283,.777,110,278,388,94,75,62,123,158,1457
254,Randy Livingston\livinra01,PG,29,UTA,17,4,227,22,52,.423,5,8,.625,17,44,.386,.471,15,17,.882,3,9,12,45,12,2,14,28,64
255,Shaun Livingston\livinsh01,PG,19,LAC,30,15,814,89,215,.414,0,2,.000,89,213,.418,.414,44,59,.746,22,67,89,151,32,11,75,82,222
256,Raül López\lopezra01,PG,24,UTA,31,15,518,57,135,.422,20,45,.444,37,90,.411,.496,27,33,.818,7,32,39,123,22,3,47,78,161
257,Tyronn Lue\luety01,PG,27,TOT,70,49,2007,295,654,.451,55,155,.355,240,499,.481,.493,142,165,.861,14,135,149,322,33,0,105,168,787
257,Tyronn Lue\luety01,PG,27,HOU,21,3,479,48,122,.393,15,45,.333,33,77,.429,.455,14,18,.778,0,40,40,58,8,0,24,48,125
257,Tyronn Lue\luety01,PG,27,ATL,49,46,1528,247,532,.464,40,110,.364,207,422,.491,.502,128,147,.871,14,95,109,264,25,0,81,120,662
258,George Lynch\lynchge01,SF,34,NOH,44,27,933,68,189,.360,11,37,.297,57,152,.375,.389,17,23,.739,55,119,174,88,32,12,57,83,164
259,Mark Madsen\madsema01,C,29,MIN,41,14,601,34,66,.515,0,0,,34,66,.515,.515,20,40,.500,63,65,128,18,7,14,24,103,88
260,Corey Maggette\maggeco01,SG,25,LAC,66,60,2436,425,986,.431,51,168,.304,374,818,.457,.457,563,657,.857,70,324,394,225,70,8,195,191,1464
261,Jamaal Magloire\magloja01,C,26,NOH,23,22,703,98,227,.432,0,0,,98,227,.432,.432,74,123,.602,79,126,205,29,8,23,59,74,270
262,Stephon Marbury\marbust01,PG,27,NYK,82,82,3281,604,1308,.462,115,325,.354,489,983,.497,.506,458,549,.834,50,198,248,668,122,6,233,186,1781
263,Shawn Marion\mariosh01,PF,26,PHO,81,81,3146,613,1289,.476,114,341,.334,499,948,.526,.520,229,275,.833,235,680,915,154,163,119,125,199,1569
264,Sean Marks\marksse01,PF,29,SAS,23,0,244,27,80,.338,0,3,.000,27,77,.351,.338,22,28,.786,18,38,56,8,3,11,14,29,76
265,Donyell Marshall\marshdo01,PF,31,TOR,65,2,1645,262,592,.443,151,363,.416,111,229,.485,.570,72,91,.791,95,333,428,81,57,46,42,136,747
266,Darrick Martin\martida01,PG,33,LAC,11,0,190,16,50,.320,5,18,.278,11,32,.344,.370,5,8,.625,3,7,10,28,6,0,6,19,42
267,Kenyon Martin\martike01,PF,27,DEN,70,67,2272,444,907,.490,0,12,.000,444,895,.496,.490,199,308,.646,146,365,511,170,100,78,149,228,1087
268,Kevin Martin\martike02,PG,21,SAC,45,0,455,45,117,.385,5,25,.200,40,92,.435,.406,36,55,.655,29,29,58,22,16,3,24,35,131
269,Desmond Mason\masonde01,SF,27,MIL,80,71,2893,478,1079,.443,1,8,.125,477,1071,.445,.443,420,524,.802,85,227,312,217,58,27,164,198,1377
270,Tony Massenburg\masseto01,PF,37,SAS,61,6,699,74,182,.407,0,0,,74,182,.407,.407,48,63,.762,54,109,163,14,18,20,40,122,196
271,Walter McCarty\mccarwa01,PF,30,TOT,72,0,906,95,235,.404,55,155,.355,40,80,.500,.521,15,29,.517,29,109,138,37,25,15,36,144,260
271,Walter McCarty\mccarwa01,PF,30,BOS,44,0,553,62,150,.413,30,90,.333,32,60,.533,.513,8,15,.533,21,56,77,26,15,9,17,85,162
271,Walter McCarty\mccarwa01,PF,30,PHO,28,0,353,33,85,.388,25,65,.385,8,20,.400,.535,7,14,.500,8,53,61,11,10,6,19,59,98
272,Jelani McCoy\mccoyje01,C,27,ATL,10,0,88,7,13,.538,0,0,,7,13,.538,.538,1,5,.200,7,14,21,0,3,8,6,24,15
273,Antonio McDyess\mcdyean01,PF,30,DET,77,8,1797,307,598,.513,0,1,.000,307,597,.514,.513,126,192,.656,177,305,482,71,46,52,93,204,740
274,Tracy McGrady*\mcgratr01,SF,25,HOU,78,78,3182,715,1660,.431,142,435,.326,573,1225,.468,.473,431,557,.774,71,413,484,448,135,52,201,167,2003
275,Jeff McInnis\mcinnje01,PG,30,CLE,76,69,2651,377,915,.412,91,264,.345,286,651,.439,.462,130,160,.813,32,125,157,391,56,1,117,177,975
276,Aaron McKie\mckieaa01,SG,32,PHI,68,3,1118,61,142,.430,20,62,.323,41,80,.513,.500,10,16,.625,20,152,172,103,48,17,31,116,152
277,Keith McLeod\mcleoke01,PG,25,UTA,53,47,1382,143,408,.350,18,72,.250,125,336,.372,.373,112,146,.767,20,93,113,236,63,12,99,138,416
278,Stanislav Medvedenko\medvest01,PF,25,LAL,43,4,423,71,156,.455,0,1,.000,71,155,.458,.455,23,28,.821,31,48,79,13,9,2,13,64,165
279,Ron Mercer\mercero01,SF,28,NJN,18,3,390,65,158,.411,0,3,.000,65,155,.419,.411,7,10,.700,9,31,40,20,16,2,14,20,137
280,Chris Mihm\mihmch01,C,25,LAL,75,75,1870,280,552,.507,0,2,.000,280,550,.509,.507,175,258,.678,197,305,502,50,14,108,110,237,735
281,Darius Miles\milesda01,SF,23,POR,63,22,1699,336,697,.482,8,23,.348,328,674,.487,.488,129,215,.600,71,228,299,129,75,78,157,189,809
282,Darko Miličić\milicda01,C,19,DET,37,2,254,25,76,.329,0,0,,25,76,.329,.329,17,24,.708,3,40,43,7,2,17,16,31,67
283,Andre Miller\millean02,PG,28,DEN,82,82,2852,427,895,.477,6,39,.154,421,856,.492,.480,253,302,.838,100,238,338,569,121,8,220,204,1113
284,Anthony Miller\millean01,PF,33,ATL,2,0,9,2,3,.667,0,0,,2,3,.667,.667,0,0,,0,1,1,1,1,0,1,2,4
285,Brad Miller\millebr01,C,28,SAC,56,56,2089,319,609,.524,5,19,.263,314,590,.532,.528,233,287,.812,139,382,521,220,69,68,82,181,876
286,Mike Miller\millemi01,SF,24,MEM,76,51,2278,387,766,.505,140,323,.433,247,443,.558,.597,108,150,.720,36,264,300,220,54,23,127,197,1022
287,Reggie Miller*\millere01,SG,39,IND,66,66,2105,314,719,.437,96,298,.322,218,421,.518,.503,250,268,.933,18,138,156,146,50,5,77,109,974
288,Yao Ming*\mingya01,C,24,HOU,80,80,2447,538,975,.552,0,0,,538,975,.552,.552,389,497,.783,208,461,669,61,34,160,196,298,1465
289,Cuttino Mobley\moblecu01,SG,29,TOT,66,64,2388,408,932,.438,150,342,.439,258,590,.437,.518,168,205,.820,45,184,229,188,74,30,133,152,1134
289,Cuttino Mobley\moblecu01,SG,29,ORL,23,21,726,128,296,.432,58,125,.464,70,171,.409,.530,55,69,.797,11,52,63,42,23,9,41,49,369
289,Cuttino Mobley\moblecu01,SG,29,SAC,43,43,1662,280,636,.440,92,217,.424,188,419,.449,.513,113,136,.831,34,132,166,146,51,21,92,103,765
290,Nazr Mohammed\mohamna01,C,27,TOT,77,59,1933,289,602,.480,0,1,.000,289,601,.481,.480,153,227,.674,247,339,586,34,58,86,108,236,731
290,Nazr Mohammed\mohamna01,C,27,NYK,54,54,1519,234,460,.509,0,1,.000,234,459,.510,.509,121,171,.708,169,270,439,26,53,53,81,172,589
290,Nazr Mohammed\mohamna01,C,27,SAS,23,5,414,55,142,.387,0,0,,55,142,.387,.387,32,56,.571,78,69,147,8,5,33,27,64,142
291,Jérôme Moïso\moisoje01,C-PF,26,TOT,20,1,120,9,18,.500,0,1,.000,9,17,.529,.500,10,13,.769,10,27,37,1,3,6,7,13,28
291,Jérôme Moïso\moisoje01,C,26,TOR,8,1,69,3,9,.333,0,1,.000,3,8,.375,.333,8,9,.889,6,17,23,0,2,3,6,7,14
291,Jérôme Moïso\moisoje01,C,26,NJN,8,0,24,3,4,.750,0,0,,3,4,.750,.750,2,4,.500,3,4,7,0,0,1,1,2,8
291,Jérôme Moïso\moisoje01,PF,26,CLE,4,0,27,3,5,.600,0,0,,3,5,.600,.600,0,0,,1,6,7,1,1,2,0,4,6
292,Mikki Moore\mooremi01,PF,29,LAC,74,4,1178,144,287,.502,1,5,.200,143,282,.507,.503,107,136,.787,97,149,246,47,19,32,63,173,396
293,Alonzo Mourning*\mournal01,C-PF,34,TOT,37,17,702,100,212,.472,0,0,,100,212,.472,.472,82,141,.582,53,145,198,18,8,74,57,82,282
293,Alonzo Mourning*\mournal01,PF,34,NJN,18,14,457,68,150,.453,0,0,,68,150,.453,.453,51,86,.593,31,96,127,14,5,41,45,50,187
293,Alonzo Mourning*\mournal01,C,34,MIA,19,3,245,32,62,.516,0,0,,32,62,.516,.516,31,55,.564,22,49,71,4,3,33,12,32,95
294,Troy Murphy\murphtr01,PF,24,GSW,70,69,2375,392,947,.414,59,148,.399,333,799,.417,.445,233,319,.730,251,505,756,97,53,33,108,190,1076
295,Lamond Murray\murrala01,SF,31,TOR,62,1,918,132,310,.426,46,105,.438,86,205,.420,.500,61,80,.763,44,120,164,47,32,16,54,85,371
296,Ronald Murray\murraro01,SG,25,SEA,49,6,883,131,363,.361,24,95,.253,107,268,.399,.394,59,80,.738,15,83,98,65,30,11,57,59,345
297,Dikembe Mutombo*\mutomdi01,C,38,HOU,80,2,1212,108,217,.498,0,0,,108,217,.498,.498,106,143,.741,150,276,426,10,16,101,51,135,322
298,Mamadou N'Diaye\ndiayma02,C,29,LAC,11,0,72,8,20,.400,0,1,.000,8,19,.421,.400,4,7,.571,9,9,18,1,1,5,0,20,20
299,Boštjan Nachbar\nachbbo01,PF-SF,24,TOT,71,6,1341,161,411,.392,75,196,.383,86,215,.400,.483,97,117,.829,24,158,182,74,29,16,73,183,494
299,Boštjan Nachbar\nachbbo01,SF,24,HOU,16,2,204,15,43,.349,10,21,.476,5,22,.227,.465,9,12,.750,4,26,30,9,1,0,5,30,49
299,Boštjan Nachbar\nachbbo01,PF,24,NOH,55,4,1137,146,368,.397,65,175,.371,81,193,.420,.485,88,105,.838,20,132,152,65,28,16,68,153,445
300,Lee Nailon\nailole01,SF,29,NOH,68,51,2017,415,869,.478,0,2,.000,415,867,.479,.478,133,165,.806,128,170,298,109,36,16,110,190,963
301,Eduardo Nájera\najered01,PF,28,TOT,68,4,1185,145,322,.450,6,21,.286,139,301,.462,.460,58,91,.637,102,141,243,65,41,24,61,148,354
301,Eduardo Nájera\najered01,PF,28,GSW,42,4,610,70,172,.407,6,15,.400,64,157,.408,.424,29,45,.644,53,65,118,37,18,10,32,71,175
301,Eduardo Nájera\najered01,PF,28,DEN,26,0,575,75,150,.500,0,6,.000,75,144,.521,.500,29,46,.630,49,76,125,28,23,14,29,77,179
302,Steve Nash*\nashst01,PG,30,PHO,75,75,2573,430,857,.502,94,218,.431,336,639,.526,.557,211,238,.887,57,192,249,861,74,6,245,136,1165
303,Jameer Nelson\nelsoja01,PG,22,ORL,79,21,1612,286,628,.455,44,141,.312,242,487,.497,.490,73,107,.682,52,141,193,237,78,3,117,199,689
304,Rasho Nesterović\nestera01,C,28,SAS,70,70,1785,198,430,.460,0,0,,198,430,.460,.460,14,30,.467,184,275,459,71,31,117,73,207,410
305,Ira Newble\newblir01,SG,30,CLE,74,69,1832,182,424,.429,19,53,.358,163,371,.439,.452,55,69,.797,78,142,220,91,50,18,61,144,438
306,Andrés Nocioni\nocioan01,SF,25,CHI,81,38,1892,241,601,.401,25,97,.258,216,504,.429,.422,170,222,.766,69,317,386,122,37,34,135,208,677
307,Moochie Norris\norrimo01,PG,31,TOT,38,0,360,35,109,.321,0,12,.000,35,97,.361,.321,20,24,.833,10,36,46,39,18,2,27,44,90
307,Moochie Norris\norrimo01,PG,31,NYK,32,0,321,32,93,.344,0,12,.000,32,81,.395,.344,18,22,.818,9,33,42,34,17,2,25,42,82
307,Moochie Norris\norrimo01,PG,31,HOU,6,0,39,3,16,.188,0,0,,3,16,.188,.188,2,2,1.000,1,3,4,5,1,0,2,2,8
308,Dirk Nowitzki\nowitdi01,PF,26,DAL,78,78,3020,663,1445,.459,91,228,.399,572,1217,.470,.490,615,708,.869,96,661,757,240,97,119,176,219,2032
309,Jermaine O'Neal\onealje01,PF,26,IND,44,41,1530,386,854,.452,1,6,.167,385,848,.454,.453,295,391,.754,85,303,388,82,25,88,131,173,1068
310,Shaquille O'Neal*\onealsh01,C,32,MIA,73,73,2492,658,1095,.601,0,0,,658,1095,.601,.601,353,765,.461,253,507,760,200,36,171,203,262,1669
311,Lamar Odom\odomla01,PF,25,LAL,64,64,2320,366,774,.473,36,117,.308,330,657,.502,.496,207,298,.695,134,519,653,238,42,65,161,211,975
312,Emeka Okafor\okafoem01,PF,22,CHA,73,73,2600,448,1003,.447,0,1,.000,448,1002,.447,.447,209,343,.609,275,520,795,64,62,125,125,214,1105
313,Mehmet Okur\okurme01,C,25,UTA,82,25,2304,354,756,.468,17,63,.270,337,693,.486,.479,329,387,.850,194,422,616,166,32,68,141,227,1054
314,Kevin Ollie\ollieke01,PG,32,PHI,26,0,158,11,31,.355,0,0,,11,31,.355,.355,6,9,.667,3,16,19,19,5,0,6,16,28
315,Michael Olowokandi\olowomi01,C,29,MIN,62,34,1215,161,353,.456,0,0,,161,353,.456,.456,46,69,.667,106,218,324,29,15,56,68,193,368
316,Greg Ostertag\ostergr01,C,31,SAC,56,3,556,37,84,.440,0,2,.000,37,82,.451,.440,13,38,.342,55,112,167,37,7,40,24,88,87
317,Bo Outlaw\outlabo01,PF,33,PHO,39,0,214,12,34,.353,0,0,,12,34,.353,.353,5,9,.556,16,37,53,13,6,12,8,29,29
318,Travis Outlaw\outlatr01,SF,20,POR,59,2,793,133,267,.498,4,10,.400,129,257,.502,.506,49,75,.653,40,81,121,35,30,40,39,77,319
319,Zaza Pachulia\pachuza01,C,20,MIL,74,4,1397,160,354,.452,0,1,.000,160,353,.453,.452,138,185,.746,131,247,378,60,44,34,70,166,458
320,Scott Padgett\padgesc01,PF,28,HOU,66,0,942,98,233,.421,50,126,.397,48,107,.449,.528,29,40,.725,47,138,185,55,33,10,30,119,275
321,Milt Palacio\palacmi01,PG,26,TOR,80,4,1533,175,392,.446,2,12,.167,173,380,.455,.449,115,155,.742,26,108,134,279,48,13,104,126,467
322,Jannero Pargo\pargoja01,PG,25,CHI,32,0,453,82,213,.385,23,66,.348,59,147,.401,.439,17,23,.739,12,35,47,76,16,1,45,53,204
323,Smush Parker\parkesm01,PG,23,TOT,16,1,144,18,43,.419,3,13,.231,15,30,.500,.453,9,13,.692,4,8,12,15,5,0,19,16,48
323,Smush Parker\parkesm01,PG,23,DET,11,1,110,11,28,.393,2,9,.222,9,19,.474,.429,9,13,.692,2,7,9,11,3,0,10,13,33
323,Smush Parker\parkesm01,PG,23,PHO,5,0,34,7,15,.467,1,4,.250,6,11,.545,.500,0,0,,2,1,3,4,2,0,9,3,15
324,Tony Parker\parketo01,PG,22,SAS,80,80,2735,539,1118,.482,43,156,.276,496,962,.516,.501,210,323,.650,47,251,298,491,98,4,215,167,1331
325,Ruben Patterson\patteru01,SF,29,POR,70,36,1957,319,601,.531,2,25,.080,317,576,.550,.532,169,282,.599,126,147,273,138,106,21,143,164,809
326,Sasha Pavlović\pavloal01,SG,21,CLE,65,9,862,120,276,.435,30,78,.385,90,198,.455,.489,44,64,.688,15,56,71,49,29,4,47,121,314
327,Gary Payton*\paytoga01,PG,36,BOS,77,77,2541,339,725,.468,42,129,.326,297,596,.498,.497,153,201,.761,48,188,236,469,88,12,148,121,873
328,Anthony Peeler\peelean01,SG,35,WAS,40,0,529,56,150,.373,25,65,.385,31,85,.365,.457,16,18,.889,14,51,65,57,18,2,28,39,153
329,Kirk Penney\penneki01,SG,24,LAC,4,0,12,1,3,.333,0,1,.000,1,2,.500,.333,0,0,,0,1,1,1,0,0,2,0,2
330,Kendrick Perkins\perkike01,C,20,BOS,60,3,548,56,119,.471,0,0,,56,119,.471,.471,37,58,.638,53,123,176,21,9,37,43,98,149
331,Wesley Person\persowe01,SF,33,TOT,41,3,667,107,226,.473,41,89,.461,66,137,.482,.564,9,13,.692,3,80,83,39,19,4,17,30,264
331,Wesley Person\persowe01,SF,33,MIA,16,3,206,25,57,.439,8,21,.381,17,36,.472,.509,4,4,1.000,1,21,22,11,6,0,7,6,62
331,Wesley Person\persowe01,SF,33,DEN,25,0,461,82,169,.485,33,68,.485,49,101,.485,.583,5,9,.556,2,59,61,28,13,4,10,24,202
332,Morris Peterson\petermo01,SG,27,TOR,82,61,2510,356,848,.420,129,335,.385,227,513,.442,.496,188,226,.832,71,269,340,169,91,18,93,219,1029
333,Eric Piatkowski\piatker01,SG,34,CHI,68,11,841,111,258,.430,57,134,.425,54,124,.435,.541,45,56,.804,15,64,79,51,29,1,37,67,324
334,Paul Pierce*\piercpa01,SF,27,BOS,82,82,2960,556,1223,.455,108,292,.370,448,931,.481,.499,549,668,.822,78,461,539,348,133,39,230,255,1769
335,Mickaël Piétrus\pietrmi01,SF,22,GSW,67,3,1340,214,501,.427,67,195,.344,147,306,.480,.494,141,202,.698,65,124,189,82,46,18,92,139,636
336,Zoran Planinić\planizo01,PG,22,NJN,43,8,515,78,174,.448,15,40,.375,63,134,.470,.491,46,66,.697,19,50,69,44,25,0,41,76,217
337,Pavel Podkolzin\podkopa01,C,20,DAL,5,0,10,0,0,,0,0,,0,0,,,1,2,.500,0,2,2,0,0,0,2,4,1
338,Scot Pollard\pollasc01,C,29,IND,49,17,865,79,167,.473,0,0,,79,167,.473,.473,33,49,.673,85,120,205,18,30,24,31,123,191
339,Mark Pope\popema01,PF,32,DEN,9,0,27,2,6,.333,0,0,,2,6,.333,.333,0,0,,5,3,8,1,1,2,1,5,4
340,James Posey\poseyja01,SF,28,MEM,50,18,1382,127,356,.357,55,178,.309,72,178,.404,.434,96,111,.865,45,174,219,88,48,23,69,134,405
341,Vitaly Potapenko\potapvi01,C,29,SEA,33,1,335,45,87,.517,0,1,.000,45,86,.523,.517,27,31,.871,30,48,78,9,7,3,12,53,117
342,Tayshaun Prince\princta01,SF,24,DET,82,82,3039,469,963,.487,47,138,.341,422,825,.512,.511,221,274,.807,133,302,435,247,56,71,135,161,1206
343,Laron Profit\profila01,SF,27,WAS,42,4,428,56,128,.438,8,28,.286,48,100,.480,.469,16,25,.640,24,52,76,37,16,5,27,44,136
344,Joel Przybilla\przybjo01,C,25,POR,76,50,1858,199,333,.598,0,0,,199,333,.598,.598,90,174,.517,178,410,588,74,24,163,98,239,488
345,Vladimir Radmanović\radmavl01,PF,24,SEA,63,0,1856,266,650,.409,128,329,.389,138,321,.430,.508,81,103,.786,52,237,289,86,57,31,80,172,741
346,Aleksandar Radojević\radojal01,C,28,UTA,12,6,128,6,19,.316,0,0,,6,19,.316,.316,7,10,.700,9,19,28,6,0,2,15,32,19
347,Peter John Ramos\ramospe01,C,19,WAS,6,0,20,5,10,.500,0,0,,5,10,.500,.500,1,2,.500,1,3,4,0,0,1,3,4,11
348,Zach Randolph\randoza01,PF,23,POR,46,37,1603,332,741,.448,0,6,.000,332,735,.452,.448,207,254,.815,142,300,442,86,34,17,112,112,871
349,Theo Ratliff\ratlith01,C,31,POR,63,45,1731,115,257,.447,0,0,,115,257,.447,.447,74,107,.692,111,220,331,34,23,158,56,183,304
350,Željko Rebrača\rebraze01,C,32,LAC,58,2,928,133,234,.568,0,0,,133,234,.568,.568,73,85,.859,49,135,184,26,13,40,49,130,339
351,Michael Redd\reddmi01,SG,25,MIL,75,75,2848,625,1418,.441,104,293,.355,521,1125,.463,.477,369,432,.854,72,240,312,172,63,8,133,152,1723
352,Justin Reed\reedju01,SF,23,BOS,23,0,121,15,29,.517,0,3,.000,15,26,.577,.517,11,15,.733,8,8,16,10,3,1,5,12,41
353,Jared Reiner\reineja01,C,22,CHI,19,2,132,10,30,.333,0,0,,10,30,.333,.333,1,4,.250,13,25,38,1,3,7,9,35,21
354,Jason Richardson\richaja01,SG,24,GSW,72,72,2724,610,1368,.446,125,370,.338,485,998,.486,.492,214,309,.693,125,299,424,281,105,32,169,156,1559
355,Quentin Richardson\richaqu01,SG,24,PHO,79,78,2839,407,1045,.389,226,631,.358,181,414,.437,.498,136,184,.739,91,388,479,158,96,27,102,197,1176
356,Luke Ridnour\ridnolu01,PG,23,SEA,82,82,2571,299,739,.405,67,178,.376,232,561,.414,.450,159,180,.883,55,149,204,483,94,23,149,185,824
357,Bernard Robinson\robinbe01,SG,24,CHA,31,1,328,36,81,.444,3,8,.375,33,73,.452,.463,18,26,.692,14,34,48,30,11,4,20,42,93
358,Clifford Robinson\robincl02,C-PF,38,TOT,71,29,1689,202,523,.386,67,193,.347,135,330,.409,.450,62,97,.639,54,155,209,104,62,53,66,181,533
358,Clifford Robinson\robincl02,C,38,GSW,42,29,1090,141,354,.398,42,127,.331,99,227,.436,.458,35,58,.603,31,83,114,74,44,39,41,107,359
358,Clifford Robinson\robincl02,PF,38,NJN,29,0,599,61,169,.361,25,66,.379,36,103,.350,.435,27,39,.692,23,72,95,30,18,14,25,74,174
359,Glenn Robinson\robingl01,SF,32,SAS,9,0,157,34,77,.442,2,6,.333,32,71,.451,.455,20,23,.870,4,20,24,8,4,3,7,19,90
360,Rodney Rogers\rogerro01,SF-PF,33,TOT,58,33,1367,172,450,.382,48,168,.286,124,282,.440,.436,52,70,.743,61,185,246,86,41,20,86,172,444
360,Rodney Rogers\rogerro01,SF,33,NOH,30,26,882,109,289,.377,25,92,.272,84,197,.426,.420,32,42,.762,28,114,142,60,19,12,66,103,275
360,Rodney Rogers\rogerro01,PF,33,PHI,28,7,485,63,161,.391,23,76,.303,40,85,.471,.463,20,28,.714,33,71,104,26,22,8,20,69,169
361,Jalen Rose\roseja01,SF,32,TOR,81,65,2710,527,1159,.455,108,274,.394,419,885,.473,.501,333,390,.854,44,232,276,209,63,10,180,190,1495
362,Malik Rose\rosema01,PF,30,TOT,76,5,1475,198,441,.449,1,10,.100,197,431,.457,.450,137,186,.737,129,212,341,59,46,16,102,208,534
362,Malik Rose\rosema01,PF,30,SAS,50,1,862,124,267,.464,0,4,.000,124,263,.471,.464,69,99,.697,95,132,227,41,31,9,56,124,317
362,Malik Rose\rosema01,PF,30,NYK,26,4,613,74,174,.425,1,6,.167,73,168,.435,.428,68,87,.782,34,80,114,18,15,7,46,84,217
363,Quinton Ross\rossqu01,SG,23,LAC,78,19,1659,161,373,.432,1,4,.250,160,369,.434,.433,74,110,.673,59,151,210,109,51,22,54,165,397
364,Michael Ruffin\ruffimi01,C,28,WAS,79,7,1262,41,99,.414,0,1,.000,41,98,.418,.414,29,67,.433,157,175,332,64,43,41,44,193,111
365,Kareem Rush\rushka01,SG,24,TOT,48,22,968,157,406,.387,51,137,.372,106,269,.394,.450,37,48,.771,20,69,89,68,20,7,47,74,402
365,Kareem Rush\rushka01,SG,24,LAL,14,0,91,4,20,.200,2,10,.200,2,10,.200,.250,2,2,1.000,3,7,10,3,2,1,3,7,12
365,Kareem Rush\rushka01,SG,24,CHA,34,22,877,153,386,.396,49,127,.386,104,259,.402,.460,35,46,.761,17,62,79,65,18,6,44,67,390
366,Bryon Russell\russebr01,SF,34,DEN,70,2,1026,95,252,.377,56,149,.376,39,103,.379,.488,61,77,.792,50,122,172,72,44,11,35,130,307
367,John Salmons\salmojo01,SG,25,PHI,58,8,993,85,210,.405,31,91,.341,54,119,.454,.479,35,48,.729,12,109,121,114,40,13,51,92,236
368,Jamal Sampson\sampsja01,PF,21,CHA,23,0,329,28,62,.452,0,0,,28,62,.452,.452,23,39,.590,36,86,122,8,4,17,17,53,79
369,Daniel Santiago\santida01,C,28,MIL,11,0,105,7,21,.333,0,0,,7,21,.333,.333,8,11,.727,6,13,19,1,3,4,4,28,22
370,Brian Scalabrine\scalabr01,PF,26,NJN,54,14,1167,132,332,.398,22,68,.324,110,264,.417,.431,53,69,.768,83,161,244,88,34,18,66,111,339
371,Ansu Sesay\sesayan01,SF,28,GSW,16,0,128,17,42,.405,2,8,.250,15,34,.441,.429,13,24,.542,18,20,38,12,2,3,8,16,49
372,Ha Seung-Jin\seungha01,C,19,POR,19,0,104,10,23,.435,0,0,,10,23,.435,.435,6,11,.545,6,12,18,2,1,5,12,21,26
373,Paul Shirley\shirlpa01,PF,27,PHO,9,0,30,5,11,.455,0,0,,5,11,.455,.455,2,4,.500,1,1,2,3,0,0,1,3,12
374,Bobby Simmons\simmobo01,SF,24,LAC,75,74,2799,474,1017,.466,50,115,.435,424,902,.470,.491,231,273,.846,128,318,446,205,106,16,135,227,1229
375,Brian Skinner\skinnbr01,C-PF,28,TOT,49,23,941,104,205,.507,0,1,.000,104,204,.510,.507,25,70,.357,107,173,280,43,31,49,40,102,233
375,Brian Skinner\skinnbr01,PF,28,PHI,24,0,246,22,57,.386,0,1,.000,22,56,.393,.386,5,17,.294,23,39,62,5,5,6,13,29,49
375,Brian Skinner\skinnbr01,C,28,SAC,25,23,695,82,148,.554,0,0,,82,148,.554,.554,20,53,.377,84,134,218,38,26,43,27,73,184
376,Tamar Slay\slayta01,SG,24,CHA,8,0,78,13,39,.333,2,12,.167,11,27,.407,.359,0,2,.000,6,8,14,3,5,0,8,20,28
377,Donta Smith\smithdo04,SG,21,ATL,38,0,433,44,113,.389,6,22,.273,38,91,.418,.416,33,48,.688,19,33,52,39,23,5,25,50,127
378,J.R. Smith\smithjr01,SG,19,NOH,76,56,1859,295,748,.394,81,281,.288,214,467,.458,.449,111,161,.689,39,113,152,142,55,11,109,135,782
379,Jabari Smith\smithja01,PF,27,NJN,45,2,648,62,148,.419,1,2,.500,61,146,.418,.422,41,55,.745,29,82,111,38,25,14,39,103,166
380,Joe Smith\smithjo02,PF,29,MIL,74,73,2265,319,621,.514,0,1,.000,319,620,.515,.514,175,228,.768,179,362,541,67,43,38,79,222,813
381,Josh Smith\smithjo03,SF,19,ATL,74,59,2050,274,602,.455,4,23,.174,270,579,.466,.458,163,237,.688,147,310,457,127,59,144,135,157,715
382,Steve Smith\smithst01,SG,35,TOT,50,1,750,102,248,.411,41,105,.390,61,143,.427,.494,69,80,.863,15,50,65,71,14,7,27,82,314
382,Steve Smith\smithst01,SG,35,CHA,37,1,636,93,218,.427,38,90,.422,55,128,.430,.514,67,77,.870,13,36,49,57,12,7,24,74,291
382,Steve Smith\smithst01,SG,35,MIA,13,0,114,9,30,.300,3,15,.200,6,15,.400,.350,2,3,.667,2,14,16,14,2,0,3,8,23
383,Theron Smith\smithth01,SF,24,CHA,33,5,510,44,136,.324,3,12,.250,41,124,.331,.335,14,16,.875,39,77,116,28,6,4,27,58,105
384,Eric Snow\snower01,SG,31,CLE,81,15,1844,125,327,.382,13,45,.289,112,282,.397,.402,59,80,.738,37,118,155,317,67,16,89,189,322
385,Kirk Snyder\snydeki01,SG,21,UTA,68,7,906,122,328,.372,30,85,.353,92,243,.379,.418,64,96,.667,50,71,121,36,26,19,58,116,338
386,Darius Songaila\songada01,PF,26,SAC,81,21,1668,257,488,.527,0,3,.000,257,485,.530,.527,94,111,.847,125,219,344,114,51,18,70,206,608
387,Pape Sow\sowpa01,C,23,TOR,27,4,255,23,58,.397,0,0,,23,58,.397,.397,16,27,.593,18,39,57,2,12,4,10,46,62
388,Latrell Sprewell\sprewla01,SF,34,MIN,80,79,2450,398,961,.414,69,211,.327,329,750,.439,.450,156,188,.830,65,189,254,179,53,21,127,124,1021
389,Jerry Stackhouse\stackje01,SG,30,DAL,56,7,1617,274,662,.414,32,120,.267,242,542,.446,.438,253,298,.849,38,145,183,127,53,10,106,104,833
390,DeShawn Stevenson\stevede01,SG,23,ORL,55,27,1089,174,426,.408,25,67,.373,149,359,.415,.438,56,101,.554,38,64,102,69,16,9,57,73,429
391,Michael Stewart\stewami01,PF,29,ATL,12,1,145,11,21,.524,0,0,,11,21,.524,.524,3,7,.429,21,19,40,5,6,5,6,32,25
392,Peja Stojaković\stojape01,SF,27,SAC,66,66,2534,451,1016,.444,174,433,.402,277,583,.475,.530,253,275,.920,62,223,285,138,79,12,102,157,1329
393,Awvee Storey\storeaw01,SG,27,NJN,9,0,32,3,10,.300,1,2,.500,2,8,.250,.350,1,2,.500,4,1,5,1,0,0,0,3,8
394,Damon Stoudamire\stoudda01,PG,31,POR,81,70,2762,457,1165,.392,181,490,.369,276,675,.409,.470,182,199,.915,56,254,310,458,86,2,164,158,1277
395,Amar'e Stoudemire\stoudam01,C,22,PHO,80,80,2889,747,1336,.559,3,16,.188,744,1320,.564,.560,583,795,.733,219,494,713,131,77,130,189,278,2080
396,Erick Strickland\stricer01,SG,31,MIL,62,5,1014,114,304,.375,21,83,.253,93,221,.421,.410,52,64,.813,11,92,103,115,30,1,64,103,301
397,Rod Strickland\stricro02,PG,38,HOU,16,2,196,9,43,.209,1,2,.500,8,41,.195,.221,9,10,.900,3,24,27,39,3,2,16,15,28
398,Bruno Šundov\sundobr01,C,24,NYK,21,0,73,11,37,.297,1,3,.333,10,34,.294,.311,2,2,1.000,6,7,13,2,2,2,6,16,25
399,Bob Sura\surabo01,PG,31,HOU,61,59,1922,215,504,.427,55,155,.355,160,349,.458,.481,141,188,.750,79,258,337,317,65,7,147,168,626
400,Mike Sweetney\sweetmi01,C,22,NYK,77,28,1509,237,446,.531,0,1,.000,237,445,.533,.531,176,235,.749,169,249,418,44,27,28,108,224,650
401,Robert Swift\swiftro01,C,19,SEA,16,0,72,5,11,.455,0,0,,5,11,.455,.455,5,9,.556,1,4,5,2,1,7,4,16,15
402,Stromile Swift\swiftst01,PF,25,MEM,60,14,1279,219,488,.449,0,4,.000,219,484,.452,.449,166,219,.758,92,181,273,43,41,92,90,182,604
403,Wally Szczerbiak\szczewa02,SF,27,MIN,81,37,2558,465,919,.506,63,169,.373,402,750,.536,.540,260,304,.855,82,221,303,191,40,16,132,178,1253
404,Yuta Tabuse\tabusyu01,PG,24,PHO,4,0,17,1,6,.167,1,1,1.000,0,5,.000,.250,4,4,1.000,2,2,4,3,0,0,1,1,7
405,Maurice Taylor\tayloma01,PF-C,28,TOT,65,16,1336,203,446,.455,3,9,.333,200,437,.458,.459,63,103,.612,67,190,257,67,27,20,94,180,472
405,Maurice Taylor\tayloma01,PF,28,HOU,38,16,905,127,292,.435,3,8,.375,124,284,.437,.440,39,60,.650,41,123,164,53,16,12,63,123,296
405,Maurice Taylor\tayloma01,C,28,NYK,27,0,431,76,154,.494,0,1,.000,76,153,.497,.494,24,43,.558,26,67,93,14,11,8,31,57,176
406,Sebastian Telfair\telfase01,PG,19,POR,68,26,1330,169,430,.393,17,69,.246,152,361,.421,.413,105,133,.789,10,94,104,224,35,4,125,120,460
407,Jason Terry\terryja01,PG,27,DAL,80,57,2401,372,743,.501,103,245,.420,269,498,.540,.570,146,173,.844,38,150,188,429,109,15,147,177,993
408,Billy Thomas\thomabi01,SF,29,NJN,25,0,356,34,94,.362,17,56,.304,17,38,.447,.452,7,9,.778,7,29,36,17,14,1,9,29,92
409,Etan Thomas\thomaet01,C,26,WAS,47,10,976,128,255,.502,0,0,,128,255,.502,.502,76,144,.528,85,159,244,20,17,51,50,133,332
410,James Thomas\thomaja02,PF,24,TOT,11,2,117,12,20,.600,0,0,,12,20,.600,.600,2,6,.333,17,20,37,4,4,4,7,13,26
410,James Thomas\thomaja02,PF,24,POR,9,2,112,11,18,.611,0,0,,11,18,.611,.611,2,6,.333,15,20,35,4,4,4,7,12,24
410,James Thomas\thomaja02,PF,24,ATL,2,0,5,1,2,.500,0,0,,1,2,.500,.500,0,0,,2,0,2,0,0,0,0,1,2
411,John Thomas\thomajo02,C,29,MIN,44,8,521,42,86,.488,0,0,,42,86,.488,.488,27,46,.587,39,58,97,17,15,13,18,82,111
412,Kenny Thomas\thomake01,PF,27,TOT,73,58,2167,367,781,.470,1,5,.200,366,776,.472,.471,173,227,.762,184,351,535,152,67,17,131,227,908
412,Kenny Thomas\thomake01,PF,27,PHI,47,43,1344,217,476,.456,1,4,.250,216,472,.458,.457,95,119,.798,106,202,308,77,40,6,83,151,530
412,Kenny Thomas\thomake01,PF,27,SAC,26,15,823,150,305,.492,0,1,.000,150,304,.493,.492,78,108,.722,78,149,227,75,27,11,48,76,378
413,Kurt Thomas\thomaku01,PF,32,NYK,80,80,2855,424,901,.471,2,4,.500,422,897,.470,.472,66,84,.786,170,661,831,160,70,79,99,310,916
414,Tim Thomas\thomati01,SF,27,NYK,71,68,1940,315,718,.439,85,208,.409,230,510,.451,.498,136,173,.786,45,192,237,110,41,17,113,222,851
415,Jamaal Tinsley\tinslja01,PG,26,IND,40,40,1301,218,522,.418,58,156,.372,160,366,.437,.473,122,164,.744,26,134,160,257,81,12,134,112,616
416,Robert Traylor\traylro01,C,27,CLE,74,6,1327,177,399,.444,0,8,.000,177,391,.453,.444,55,102,.539,136,196,332,61,54,50,73,215,409
417,Jake Tsakalidis\tsakaja01,C,25,MEM,31,1,278,32,64,.500,0,0,,32,64,.500,.500,14,18,.778,21,35,56,10,3,16,12,42,78
418,Nikoloz Tskitishvili\tskitni01,PF,21,TOT,35,0,220,22,74,.297,2,17,.118,20,57,.351,.311,4,7,.571,12,29,41,10,8,11,19,33,50
418,Nikoloz Tskitishvili\tskitni01,PF,21,DEN,23,0,158,15,51,.294,0,7,.000,15,44,.341,.294,4,7,.571,11,18,29,4,8,8,14,24,34
418,Nikoloz Tskitishvili\tskitni01,PF,21,GSW,12,0,62,7,23,.304,2,10,.200,5,13,.385,.348,0,0,,1,11,12,6,0,3,5,9,16
419,Hedo Türkoğlu\turkohe01,SF,25,ORL,67,11,1757,328,782,.419,93,245,.380,235,537,.438,.479,188,225,.836,62,171,233,153,41,18,119,140,937
420,Beno Udrih\udrihbe01,PG,22,SAS,80,2,1149,173,390,.444,58,142,.408,115,248,.464,.518,67,89,.753,16,67,83,150,41,10,77,96,471
421,Nick Van Exel\vanexni01,SG,33,POR,53,34,1619,214,561,.381,100,257,.389,114,304,.375,.471,58,74,.784,20,141,161,227,44,0,92,70,586
422,Keith Van Horn\vanhoke01,SF-PF,29,TOT,62,16,1502,257,564,.456,54,142,.380,203,422,.481,.504,128,157,.815,89,205,294,75,36,21,81,170,696
422,Keith Van Horn\vanhoke01,SF,29,MIL,33,13,818,128,285,.449,30,78,.385,98,207,.473,.502,56,65,.862,55,110,165,41,21,11,47,82,342
422,Keith Van Horn\vanhoke01,PF,29,DAL,29,3,684,129,279,.462,24,64,.375,105,215,.488,.505,72,92,.783,34,95,129,34,15,10,34,88,354
423,Anderson Varejão\varejan01,PF,22,CLE,54,0,863,99,193,.513,0,2,.000,99,191,.518,.513,68,127,.535,109,148,257,27,41,38,26,122,266
424,Jacque Vaughn\vaughja01,SG,29,NJN,71,34,1410,146,325,.449,5,15,.333,141,310,.455,.457,76,91,.835,17,90,107,135,41,1,62,138,373
425,Jake Voskuhl\voskuja01,C,27,PHO,38,1,360,27,59,.458,0,0,,27,59,.458,.458,26,38,.684,30,62,92,17,4,11,20,60,80
426,Jackson Vroman\vromaja01,C-PF,23,TOT,46,18,705,82,199,.412,0,3,.000,82,196,.418,.412,48,75,.640,64,111,175,40,25,19,64,105,212
426,Jackson Vroman\vromaja01,PF,23,PHO,10,1,57,6,16,.375,0,0,,6,16,.375,.375,4,7,.571,5,8,13,7,3,2,7,11,16
426,Jackson Vroman\vromaja01,C,23,NOH,36,17,648,76,183,.415,0,3,.000,76,180,.422,.415,44,68,.647,59,103,162,33,22,17,57,94,196
427,Sasha Vujačić\vujacsa01,SG,20,LAL,35,3,403,33,117,.282,17,63,.270,16,54,.296,.355,18,19,.947,13,49,62,51,12,2,15,41,101
428,Dwyane Wade\wadedw01,SG,23,MIA,77,77,2974,630,1318,.478,13,45,.289,617,1273,.485,.483,581,762,.762,110,287,397,520,121,82,321,230,1854
429,Dajuan Wagner\wagneda02,SG,21,CLE,11,0,102,18,55,.327,5,26,.192,13,29,.448,.373,3,4,.750,0,2,2,13,5,0,9,15,44
430,Antoine Walker\walkean02,PF,28,TOT,77,77,2955,581,1377,.422,110,341,.323,471,1036,.455,.462,201,373,.539,182,513,695,265,89,58,253,217,1473
430,Antoine Walker\walkean02,PF,28,ATL,53,53,2128,420,1013,.415,85,268,.317,335,745,.450,.457,157,294,.534,126,371,497,194,64,32,183,147,1082
430,Antoine Walker\walkean02,PF,28,BOS,24,24,827,161,364,.442,25,73,.342,136,291,.467,.477,44,79,.557,56,142,198,71,25,26,70,70,391
431,Samaki Walker\walkesa01,PF,28,WAS,14,0,134,11,31,.355,0,0,,11,31,.355,.355,2,3,.667,8,10,18,4,3,7,8,25,24
432,Ben Wallace*\wallabe01,C,30,DET,74,74,2671,295,651,.453,1,9,.111,294,642,.458,.454,130,304,.428,292,610,902,123,106,176,82,159,721
433,Gerald Wallace\wallage01,SF,22,CHA,70,68,2147,286,637,.449,17,62,.274,269,575,.468,.462,191,289,.661,118,268,386,137,117,91,159,182,780
434,Rasheed Wallace\wallara01,PF,30,DET,79,79,2687,467,1062,.440,75,236,.318,392,826,.475,.475,136,195,.697,174,470,644,142,65,115,127,236,1145
435,Luke Walton\waltolu01,SF,24,LAL,61,5,768,74,180,.411,16,61,.262,58,119,.487,.456,34,48,.708,55,87,142,93,26,11,58,70,198
436,Charlie Ward\wardch01,PG,34,HOU,14,13,360,24,77,.312,16,51,.314,8,26,.308,.416,11,13,.846,6,33,39,43,15,0,18,22,75
437,Earl Watson\watsoea01,PG,25,MEM,80,14,1808,236,554,.426,52,163,.319,184,391,.471,.473,91,138,.659,35,129,164,359,83,19,167,184,615
438,Clarence Weatherspoon\weathcl01,PF,34,HOU,40,18,525,47,114,.412,0,0,,47,114,.412,.412,29,35,.829,35,87,122,17,9,6,15,74,123
439,Chris Webber*\webbech01,PF,31,TOT,67,67,2370,555,1283,.433,15,44,.341,540,1239,.436,.438,181,228,.794,130,482,612,318,94,53,182,214,1306
439,Chris Webber*\webbech01,PF,31,SAC,46,46,1668,412,917,.449,11,29,.379,401,888,.452,.455,143,179,.799,94,353,447,252,68,34,133,144,978
439,Chris Webber*\webbech01,PF,31,PHI,21,21,702,143,366,.391,4,15,.267,139,351,.396,.396,38,49,.776,36,129,165,66,26,19,49,70,328
440,Bonzi Wells\wellsbo01,SG,28,MEM,69,19,1489,272,617,.441,36,104,.346,236,513,.460,.470,141,188,.750,49,180,229,80,85,27,90,165,721
441,Jiří Welsch\welscji01,SG-SF,25,TOT,71,32,1317,149,371,.402,34,110,.309,115,261,.441,.447,129,169,.763,26,141,167,103,44,5,73,121,461
441,Jiří Welsch\welscji01,SG,25,BOS,55,32,1125,137,320,.428,32,99,.323,105,221,.475,.478,109,141,.773,20,119,139,84,39,5,58,105,415
441,Jiří Welsch\welscji01,SF,25,CLE,16,0,192,12,51,.235,2,11,.182,10,40,.250,.255,20,28,.714,6,22,28,19,5,0,15,16,46
442,David Wesley\wesleda01,SG,34,TOT,80,79,2774,334,840,.398,118,315,.375,216,525,.411,.468,162,189,.857,38,190,228,265,96,9,113,215,948
442,David Wesley\wesleda01,SG,34,NOH,26,26,934,133,342,.389,28,80,.350,105,262,.401,.430,67,76,.882,12,73,85,109,35,1,54,65,361
442,David Wesley\wesleda01,SG,34,HOU,54,53,1840,201,498,.404,90,235,.383,111,263,.422,.494,95,113,.841,26,117,143,156,61,8,59,150,587
443,David West\westda01,SF,24,NOH,30,8,552,75,172,.436,2,5,.400,73,167,.437,.442,34,50,.680,40,89,129,23,12,16,37,62,186
444,Delonte West\westde01,SG,21,BOS,39,7,507,66,155,.426,24,67,.358,42,88,.477,.503,19,27,.704,14,51,65,53,21,8,24,69,175
445,Jahidi White\whiteja01,C,28,CHA,17,0,135,14,31,.452,0,0,,14,31,.452,.452,14,40,.350,11,23,34,1,2,12,11,31,42
446,Rodney White\whitero02,SF,24,TOT,58,2,677,121,289,.419,24,60,.400,97,229,.424,.460,27,44,.614,24,65,89,44,32,11,37,64,293
446,Rodney White\whitero02,SF,24,DEN,42,2,531,98,227,.432,19,44,.432,79,183,.432,.474,21,34,.618,20,54,74,36,30,10,27,51,236
446,Rodney White\whitero02,SF,24,GSW,16,0,146,23,62,.371,5,16,.313,18,46,.391,.411,6,10,.600,4,11,15,8,2,1,10,13,57
447,Chris Wilcox\wilcoch01,C,22,LAC,54,25,1005,169,329,.514,0,0,,169,329,.514,.514,88,144,.611,63,165,228,38,26,24,77,129,426
448,Damien Wilkins\wilkida02,SF,25,SEA,29,7,520,73,168,.435,16,59,.271,57,109,.523,.482,21,34,.618,29,37,66,26,22,10,16,55,183
449,Mike Wilks\wilksmi01,PG,25,SAS,48,0,278,32,77,.416,5,16,.313,27,61,.443,.448,12,16,.750,4,21,25,33,14,1,14,26,81
450,Aaron Williams\williaa01,C,33,TOT,42,4,315,29,63,.460,0,0,,29,63,.460,.460,15,17,.882,17,43,60,8,5,8,17,70,73
450,Aaron Williams\williaa01,C,33,NJN,19,0,150,14,27,.519,0,0,,14,27,.519,.519,9,10,.900,7,24,31,6,4,5,11,25,37
450,Aaron Williams\williaa01,C,33,TOR,23,4,165,15,36,.417,0,0,,15,36,.417,.417,6,7,.857,10,19,29,2,1,3,6,45,36
451,Eric Williams\willier01,SG,32,TOT,55,39,1322,142,330,.430,28,73,.384,114,257,.444,.473,112,161,.696,44,128,172,92,38,4,60,147,424
451,Eric Williams\willier01,SG,32,NJN,21,21,739,87,185,.470,17,40,.425,70,145,.483,.516,74,108,.685,28,67,95,42,16,2,34,80,265
451,Eric Williams\willier01,SG,32,TOR,34,18,583,55,145,.379,11,33,.333,44,112,.393,.417,38,53,.717,16,61,77,50,22,2,26,67,159
452,Frank Williams\willifr02,SG,24,CHI,9,0,71,3,20,.150,0,4,.000,3,16,.188,.150,0,0,,2,4,6,11,2,3,3,9,6
453,Jason Williams\willija02,PG,29,MEM,71,68,1952,266,644,.413,107,330,.324,159,314,.506,.496,80,101,.792,19,103,122,399,75,5,130,91,719
454,Jerome Williams\willije01,SF,31,NYK,79,4,1211,122,243,.502,0,5,.000,122,238,.513,.502,115,172,.669,115,168,283,41,55,10,65,155,359
455,Mo Williams\willima01,PG,22,MIL,80,80,2254,323,737,.438,32,99,.323,291,638,.456,.460,136,160,.850,50,194,244,484,74,11,196,221,814
456,Scott Williams\willisc01,C,36,CLE,19,0,152,12,41,.293,0,1,.000,12,40,.300,.293,9,11,.818,15,15,30,8,4,6,5,30,33
457,Corliss Williamson\willico02,PF,31,TOT,72,9,1527,273,584,.467,0,2,.000,273,582,.469,.467,195,244,.799,104,155,259,78,38,15,86,218,741
457,Corliss Williamson\willico02,PF,31,PHI,48,5,1056,194,417,.465,0,2,.000,194,415,.467,.465,130,165,.788,73,105,178,43,26,12,60,144,518
457,Corliss Williamson\willico02,PF,31,SAC,24,4,471,79,167,.473,0,0,,79,167,.473,.473,65,79,.823,31,50,81,35,12,3,26,74,223
458,Kevin Willis\willike02,C,42,ATL,29,5,344,35,90,.389,0,2,.000,35,88,.398,.389,17,23,.739,29,47,76,9,8,7,15,53,87
459,Loren Woods\woodslo01,C,26,TOR,45,30,712,71,164,.433,0,1,.000,71,163,.436,.433,34,59,.576,81,139,220,17,8,39,37,78,176
460,Qyntel Woods\woodsqy01,SF,23,MIA,3,0,40,5,12,.417,0,0,,5,12,.417,.417,0,0,,2,4,6,0,4,0,2,6,10
461,Metta World Peace\artesro01,SF,25,IND,7,7,291,59,119,.496,7,17,.412,52,102,.510,.525,47,51,.922,8,37,45,22,12,6,17,27,172
462,Dorell Wright\wrighdo01,SF,19,MIA,3,0,27,3,11,.273,0,4,.000,3,7,.429,.273,1,1,1.000,0,1,1,3,4,0,3,2,7
463,Lorenzen Wright\wrighlo02,C,29,MEM,80,77,2287,320,683,.469,0,3,.000,320,680,.471,.469,131,198,.662,177,436,613,87,58,69,100,251,771
464,Wang Zhizhi\zhizhwa01,C,27,MIA,20,0,92,17,36,.472,2,3,.667,15,33,.455,.500,7,12,.583,6,12,18,5,3,2,5,9,43