Rk,Player,Pos,Age,Tm,G,GS,MP,FG,FGA,FG%,3P,3PA,3P%,2P,2PA,2P%,eFG%,FT,FTA,FT%,ORB,DRB,TRB,AST,STL,BLK,TOV,PF,PTS
1,Shareef Abdur-Rahim\abdursh01,PF,29,SAC,72,30,1961,332,632,.525,5,22,.227,327,610,.536,.529,218,278,.784,106,251,357,149,48,42,108,227,887
2,Alex Acker\ackeral01,SG,23,DET,5,0,35,4,16,.250,1,5,.200,3,11,.273,.281,0,0,,1,4,5,4,1,0,4,4,9
3,Malik Allen\allenma01,PF,27,CHI,54,20,701,121,247,.490,1,1,1.000,120,246,.488,.492,23,38,.605,44,96,140,20,14,16,34,92,266
4,Ray Allen*\allenra02,SG,30,SEA,78,78,3022,681,1500,.454,269,653,.412,412,847,.486,.544,324,359,.903,71,261,332,286,105,16,188,151,1955
5,Tony Allen\allento01,PG,24,BOS,51,9,978,129,274,.471,11,34,.324,118,240,.492,.491,100,134,.746,32,79,111,67,51,18,67,126,369
6,Rafer Alston\alstora01,PG,29,HOU,63,63,2431,280,738,.379,102,312,.327,178,426,.418,.449,99,143,.692,36,219,255,425,101,15,157,194,761
7,Chris Andersen\anderch01,C,27,NOK,32,2,570,56,98,.571,0,0,,56,98,.571,.571,49,103,.476,61,94,155,6,8,41,26,84,161
8,Alan Anderson\anderal01,SF,23,CHA,36,7,564,75,181,.414,24,58,.414,51,123,.415,.481,33,41,.805,23,47,70,32,11,4,32,48,207
9,Derek Anderson\anderde01,SG,31,TOT,43,11,1047,108,303,.356,40,134,.299,68,169,.402,.422,93,111,.838,21,122,143,101,23,6,54,98,349
9,Derek Anderson\anderde01,SG,31,HOU,20,8,582,68,173,.393,19,67,.284,49,106,.462,.448,61,73,.836,12,71,83,53,15,4,37,49,216
9,Derek Anderson\anderde01,SG,31,MIA,23,3,465,40,130,.308,21,67,.313,19,63,.302,.388,32,38,.842,9,51,60,48,8,2,17,49,133
10,Shandon Anderson\andersh01,SF,32,MIA,48,1,638,54,126,.429,5,19,.263,49,107,.458,.448,13,18,.722,18,63,81,30,17,6,24,75,126
11,Martynas Andriuškevičius\andrima01,C,19,CLE,6,0,9,0,1,.000,0,0,,0,1,.000,.000,0,0,,1,3,4,0,2,0,0,1,0
12,Carmelo Anthony\anthoca01,SF,21,DEN,80,80,2941,756,1572,.481,37,152,.243,719,1420,.506,.493,573,709,.808,122,272,394,216,88,42,218,229,2122
13,Rafael Araújo\araujra01,C,25,TOR,52,34,601,53,145,.366,0,1,.000,53,144,.368,.366,15,28,.536,43,101,144,15,24,6,42,104,121
14,Gilbert Arenas\arenagi01,PG,24,WAS,80,80,3384,746,1668,.447,199,540,.369,547,1128,.485,.507,655,799,.820,59,221,280,484,161,25,297,286,2346
15,Trevor Ariza\arizatr01,SF,20,TOT,57,10,999,93,226,.412,1,5,.200,92,221,.416,.414,77,127,.606,78,140,218,61,57,11,62,100,264
15,Trevor Ariza\arizatr01,SF,20,NYK,36,10,709,61,146,.418,1,3,.333,60,143,.420,.421,42,77,.545,49,88,137,46,43,9,46,78,165
15,Trevor Ariza\arizatr01,SF,20,ORL,21,0,290,32,80,.400,0,2,.000,32,78,.410,.400,35,50,.700,29,52,81,15,14,2,16,22,99
16,Darrell Armstrong\armstda01,PG,37,DAL,62,2,622,43,128,.336,11,48,.229,32,80,.400,.379,33,42,.786,18,63,81,86,27,3,58,71,130
17,Carlos Arroyo\arroyca01,PG-SG,26,TOT,77,0,1194,168,378,.444,7,20,.350,161,358,.450,.454,106,137,.774,33,97,130,232,38,4,83,119,449
17,Carlos Arroyo\arroyca01,PG,26,DET,50,0,600,57,157,.363,2,6,.333,55,151,.364,.369,42,58,.724,24,46,70,155,19,3,45,77,158
17,Carlos Arroyo\arroyca01,SG,26,ORL,27,0,594,111,221,.502,5,14,.357,106,207,.512,.514,64,79,.810,9,51,60,77,19,1,38,42,291
18,Chucky Atkins\atkinch01,PG-SG,31,TOT,71,41,1713,226,573,.394,97,274,.354,129,299,.431,.479,129,163,.791,23,97,120,198,43,2,87,152,678
18,Chucky Atkins\atkinch01,SG,31,WAS,28,2,552,66,174,.379,33,92,.359,33,82,.402,.474,22,31,.710,12,33,45,69,14,0,30,58,187
18,Chucky Atkins\atkinch01,PG,31,MEM,43,39,1161,160,399,.401,64,182,.352,96,217,.442,.481,107,132,.811,11,64,75,129,29,2,57,94,491
19,Stacey Augmon\augmost01,SF,37,ORL,36,3,385,25,73,.342,0,0,,25,73,.342,.342,21,30,.700,18,35,53,23,12,6,11,40,71
20,Vin Baker\bakervi01,C,34,LAC,8,1,85,7,15,.467,0,0,,7,15,.467,.467,13,18,.722,2,17,19,4,4,4,9,13,27
21,Marcus Banks\banksma01,PG,24,TOT,58,29,1497,219,468,.468,22,63,.349,197,405,.486,.491,118,147,.803,23,112,135,220,54,11,119,162,578
21,Marcus Banks\banksma01,PG,24,BOS,18,1,269,33,80,.413,6,19,.316,27,61,.443,.450,27,30,.900,4,15,19,32,7,0,23,38,99
21,Marcus Banks\banksma01,PG,24,MIN,40,28,1228,186,388,.479,16,44,.364,170,344,.494,.500,91,117,.778,19,97,116,188,47,11,96,124,479
22,Leandro Barbosa\barbole01,SG,23,PHO,57,11,1592,273,567,.481,87,196,.444,186,371,.501,.558,111,147,.755,31,119,150,158,48,6,89,145,744
23,Matt Barnes\barnema02,PF-SF,25,TOT,56,5,631,70,140,.500,3,15,.200,67,125,.536,.511,32,47,.681,48,73,121,28,20,7,30,100,175
23,Matt Barnes\barnema02,SF,25,NYK,6,5,93,11,30,.367,1,4,.250,10,26,.385,.383,3,4,.750,7,17,24,6,4,0,6,8,26
23,Matt Barnes\barnema02,PF,25,PHI,50,0,538,59,110,.536,2,11,.182,57,99,.576,.545,29,43,.674,41,56,97,22,16,7,24,92,149
24,Andre Barrett\barrean01,PG,23,TOT,19,0,282,38,104,.365,2,14,.143,36,90,.400,.375,9,12,.750,9,16,25,52,10,0,15,13,87
24,Andre Barrett\barrean01,PG,23,PHO,2,0,21,3,7,.429,0,1,.000,3,6,.500,.429,3,3,1.000,1,2,3,2,0,0,1,1,9
24,Andre Barrett\barrean01,PG,23,TOR,17,0,261,35,97,.361,2,13,.154,33,84,.393,.371,6,9,.667,8,14,22,50,10,0,14,12,78
25,Earl Barron\barroea01,C,24,MIA,8,0,45,5,16,.313,0,0,,5,16,.313,.313,3,4,.750,2,8,10,0,0,0,5,10,13
26,Brent Barry\barrybr01,SG,34,SAS,74,5,1259,156,345,.452,80,202,.396,76,143,.531,.568,39,59,.661,29,130,159,123,39,27,52,99,431
27,Jon Barry\barryjo01,SG,36,HOU,20,0,342,25,65,.385,12,32,.375,13,33,.394,.477,24,29,.828,1,30,31,26,13,1,22,25,86
28,Eddie Basden\basdeed01,SF,22,CHI,19,0,141,15,37,.405,1,7,.143,14,30,.467,.419,8,10,.800,7,21,28,8,9,2,9,17,39
29,Brandon Bass\bassbr01,PF,20,NOK,29,1,268,28,70,.400,0,0,,28,70,.400,.400,12,19,.632,18,50,68,3,3,7,11,18,68
30,Esteban Batista\batises01,PF,22,ATL,57,3,495,34,80,.425,0,1,.000,34,79,.430,.425,33,53,.623,61,83,144,7,15,11,38,111,101
31,Tony Battie\battito01,C,29,ORL,82,82,2215,280,552,.507,0,6,.000,280,546,.513,.507,89,134,.664,145,312,457,49,46,69,88,250,649
32,Shane Battier\battish01,SF,27,MEM,81,81,2839,303,621,.488,65,165,.394,238,456,.522,.540,147,208,.707,164,265,429,136,92,114,90,223,818
33,Lonny Baxter\baxtelo01,C-PF,27,TOT,41,0,400,45,104,.433,0,0,,45,104,.433,.433,28,35,.800,45,72,117,4,11,8,20,56,118
33,Lonny Baxter\baxtelo01,C,27,HOU,23,0,281,33,72,.458,0,0,,33,72,.458,.458,16,19,.842,38,46,84,2,9,7,13,48,82
33,Lonny Baxter\baxtelo01,PF,27,CHA,18,0,119,12,32,.375,0,0,,12,32,.375,.375,12,16,.750,7,26,33,2,2,1,7,8,36
34,Charlie Bell\bellch01,SG,26,MIL,59,6,1283,180,410,.439,71,168,.423,109,242,.450,.526,63,89,.708,21,99,120,130,59,5,41,126,494
35,Raja Bell\bellra01,SG,29,PHO,79,79,2959,425,930,.457,197,446,.442,228,484,.471,.563,115,146,.788,44,209,253,207,76,22,89,248,1162
36,Jonathan Bender\bendejo01,SF,25,IND,2,0,21,4,5,.800,0,0,,4,5,.800,.800,2,2,1.000,0,4,4,2,0,1,0,2,10
37,Mike Bibby\bibbymi01,PG,27,SAC,82,82,3167,597,1382,.432,192,497,.386,405,885,.458,.501,342,403,.849,29,211,240,444,82,10,199,169,1728
38,Andris Biedriņš\biedran01,C,19,GSW,68,2,1000,118,185,.638,0,0,,118,185,.638,.638,22,72,.306,124,159,283,24,23,47,34,190,258
39,Chauncey Billups\billuch01,PG,29,DET,81,81,2925,423,1012,.418,184,425,.433,239,587,.407,.509,465,520,.894,41,211,252,699,71,8,170,160,1495
40,Steve Blake\blakest01,PG,25,POR,68,57,1781,206,470,.438,76,184,.413,130,286,.455,.519,72,91,.791,26,120,146,306,42,5,83,107,560
41,Andray Blatche\blatcan01,PF,19,WAS,29,0,175,26,67,.388,3,13,.231,23,54,.426,.410,10,12,.833,12,26,38,10,5,7,12,36,65
42,Mark Blount\blounma01,C,30,TOT,81,55,2240,373,734,.508,0,0,,373,734,.508,.508,168,222,.757,96,269,365,99,40,76,194,254,914
42,Mark Blount\blounma01,C,30,BOS,39,25,1083,194,380,.511,0,0,,194,380,.511,.511,97,127,.764,36,126,162,66,15,36,120,107,485
42,Mark Blount\blounma01,C,30,MIN,42,30,1157,179,354,.506,0,0,,179,354,.506,.506,71,95,.747,60,143,203,33,25,40,74,147,429
43,Keith Bogans\boganke01,SG-SF,25,TOT,72,31,1912,215,544,.395,65,200,.325,150,344,.436,.455,127,186,.683,55,200,255,128,71,9,90,167,622
43,Keith Bogans\boganke01,SG,25,CHA,39,9,848,114,288,.396,33,98,.337,81,190,.426,.453,80,105,.762,29,77,106,45,39,3,41,78,341
43,Keith Bogans\boganke01,SF,25,HOU,33,22,1064,101,256,.395,32,102,.314,69,154,.448,.457,47,81,.580,26,123,149,83,32,6,49,89,281
44,Andrew Bogut\bogutan01,PF,21,MIL,82,77,2348,323,606,.533,0,3,.000,323,603,.536,.533,122,194,.629,189,384,573,192,49,68,125,259,768
45,Matt Bonner\bonnema01,PF,25,TOR,78,6,1710,209,467,.448,102,243,.420,107,224,.478,.557,63,76,.829,86,198,284,56,49,31,32,216,583
46,Calvin Booth\boothca01,C,29,WAS,33,2,250,20,47,.426,1,2,.500,19,45,.422,.436,5,9,.556,19,33,52,12,9,9,8,44,46
47,Carlos Boozer\boozeca01,PF,24,UTA,33,19,1025,219,399,.549,0,0,,219,399,.549,.549,99,137,.723,73,212,285,88,30,8,69,105,537
48,Chris Bosh*\boshch01,C,21,TOR,70,70,2751,549,1087,.505,0,13,.000,549,1074,.511,.505,474,581,.816,204,443,647,181,50,79,157,209,1572
49,Bruce Bowen\bowenbr01,SF,34,SAS,82,82,2755,232,536,.433,104,245,.424,128,291,.440,.530,51,84,.607,35,285,320,126,79,30,67,191,619
50,Ryan Bowen\bowenry01,SF,30,HOU,68,19,652,37,124,.298,3,22,.136,34,102,.333,.310,11,14,.786,31,57,88,24,21,6,13,85,88
51,Earl Boykins\boykiea01,PG,29,DEN,60,0,1542,271,661,.410,62,179,.346,209,482,.434,.457,152,174,.874,21,60,81,230,48,4,83,73,756
52,Michael Bradley\bradlmi01,PF,26,PHI,46,1,367,32,79,.405,1,5,.200,31,74,.419,.411,2,3,.667,40,67,107,17,5,7,19,39,67
53,Elton Brand\brandel01,PF,26,LAC,79,79,3099,756,1435,.527,1,3,.333,755,1432,.527,.527,440,568,.775,236,554,790,208,81,201,173,227,1953
54,Primož Brezec\brezepr01,C,26,CHA,79,79,2165,409,791,.517,0,2,.000,409,789,.518,.517,164,224,.732,181,259,440,45,19,32,85,227,982
55,Devin Brown\brownde02,SG,27,UTA,81,14,1711,207,527,.393,39,118,.331,168,409,.411,.430,158,212,.745,73,134,207,104,44,14,99,153,611
56,Kwame Brown\brownkw01,C,23,LAL,72,49,1978,204,388,.526,0,1,.000,204,387,.527,.526,128,235,.545,182,291,473,72,27,46,100,196,536
57,P.J. Brown\brownpj01,C,36,NOK,75,73,2380,269,583,.461,0,0,,269,583,.461,.461,139,168,.827,182,365,547,90,46,50,90,216,677
58,Rick Brunson\brunsri01,PG,33,TOT,27,0,246,21,54,.389,5,13,.385,16,41,.390,.435,7,12,.583,1,21,22,35,8,1,22,22,54
58,Rick Brunson\brunsri01,PG,33,SEA,4,0,31,5,8,.625,0,1,.000,5,7,.714,.625,0,0,,0,2,2,2,0,0,3,1,10
58,Rick Brunson\brunsri01,PG,33,HOU,23,0,215,16,46,.348,5,12,.417,11,34,.324,.402,7,12,.583,1,19,20,33,8,1,19,21,44
59,Kobe Bryant*\bryanko01,SG,27,LAL,80,80,3277,978,2173,.450,180,518,.347,798,1655,.482,.491,696,819,.850,71,354,425,360,147,30,250,233,2832
60,Greg Buckner\buckngr01,SG,29,DEN,73,27,1758,181,417,.434,86,243,.354,95,174,.546,.537,43,55,.782,31,178,209,127,87,20,52,180,491
61,Pat Burke\burkepa01,C,32,PHO,42,0,346,63,127,.496,2,7,.286,61,120,.508,.504,13,21,.619,21,52,73,16,6,13,33,62,141
62,Antonio Burks\burksan01,PG,25,MEM,57,1,570,51,144,.354,1,6,.167,50,138,.362,.358,10,23,.435,4,33,37,76,20,0,36,45,113
63,Kevin Burleson\burleke01,PG,26,CHA,39,1,340,22,88,.250,10,54,.185,12,34,.353,.307,16,17,.941,4,22,26,48,26,2,25,63,70
64,Caron Butler\butleca01,SF,25,WAS,75,54,2708,494,1086,.455,41,120,.342,453,966,.469,.474,289,332,.870,114,352,466,186,127,18,175,238,1318
65,Jackie Butler\butleja01,C,20,NYK,55,0,740,117,215,.544,0,0,,117,215,.544,.544,58,77,.753,67,116,183,25,17,31,62,127,292
66,Rasual Butler\butlera01,SF,26,NOK,79,20,1875,257,633,.406,92,242,.380,165,391,.422,.479,79,114,.693,51,181,232,40,33,45,65,142,685
67,Andrew Bynum\bynuman01,C,18,LAL,46,0,338,33,82,.402,0,0,,33,82,.402,.402,8,27,.296,34,46,80,9,4,22,17,56,74
68,Will Bynum\bynumwi01,PG,23,GSW,15,0,162,21,52,.404,2,9,.222,19,43,.442,.423,10,16,.625,3,9,12,19,7,0,14,10,54
69,Žarko Čabarkapa\cabarza01,PF,24,GSW,61,0,505,67,174,.385,5,20,.250,62,154,.403,.399,60,84,.714,37,74,111,20,13,7,35,87,199
70,José Calderón\caldejo01,SG,24,TOR,64,11,1487,132,312,.423,7,43,.163,125,269,.465,.434,78,92,.848,30,111,141,288,42,4,101,93,349
71,Marcus Camby\cambyma01,C,31,DEN,56,54,1857,302,649,.465,1,11,.091,301,638,.472,.466,111,156,.712,132,536,668,115,79,184,92,158,716
72,Brian Cardinal\cardibr01,PF,28,MEM,36,0,402,46,111,.414,13,29,.448,33,82,.402,.473,19,27,.704,11,44,55,33,23,0,27,65,124
73,Matt Carroll\carroma01,SG,25,CHA,78,6,1275,192,476,.403,72,185,.389,120,291,.412,.479,138,168,.821,34,123,157,35,47,11,48,120,594
74,Anthony Carter\cartean01,PG,30,MIN,45,8,589,53,137,.387,4,15,.267,49,122,.402,.401,40,55,.727,9,53,62,101,24,9,40,71,150
75,Vince Carter\cartevi01,SG,29,NJN,79,79,2906,653,1518,.430,125,367,.341,528,1151,.459,.471,480,601,.799,135,327,462,338,94,53,213,235,1911
76,Sam Cassell\cassesa01,PG,36,LAC,78,75,2653,493,1112,.443,70,190,.368,423,922,.459,.475,289,335,.863,40,247,287,491,74,11,175,225,1345
77,Kelvin Cato\catoke01,C,31,TOT,27,0,333,36,84,.429,0,0,,36,84,.429,.429,26,35,.743,20,50,70,4,6,12,18,52,98
77,Kelvin Cato\catoke01,C,31,ORL,23,0,299,31,72,.431,0,0,,31,72,.431,.431,26,35,.743,19,44,63,2,6,10,16,48,88
77,Kelvin Cato\catoke01,C,31,DET,4,0,34,5,12,.417,0,0,,5,12,.417,.417,0,0,,1,6,7,2,0,2,2,4,10
78,Tyson Chandler\chandty01,C,23,CHI,79,50,2121,160,283,.565,0,1,.000,160,282,.567,.565,97,193,.503,265,449,714,81,41,104,123,298,417
79,Calbert Cheaney\cheanca01,SF,34,GSW,42,0,448,42,108,.389,0,8,.000,42,100,.420,.389,8,8,1.000,20,41,61,19,13,2,17,38,92
80,Josh Childress\childjo01,SF,22,ATL,74,10,2249,278,504,.552,32,65,.492,246,439,.560,.583,154,201,.766,134,253,387,131,86,39,101,184,742
81,Doug Christie\chrisdo01,SG,35,DAL,7,7,185,9,26,.346,0,1,.000,9,25,.360,.346,8,12,.667,2,11,13,14,9,1,6,10,26
82,Speedy Claxton\claxtsp01,PG,27,NOK,71,3,2019,304,736,.413,17,63,.270,287,673,.426,.425,246,320,.769,39,154,193,339,108,6,154,177,871
83,Mateen Cleaves\cleavma01,PG,28,SEA,27,0,230,25,71,.352,4,16,.250,21,55,.382,.380,19,24,.792,2,12,14,42,3,2,14,30,73
84,Jarron Collins\collija03,C,27,UTA,79,41,1730,129,280,.461,0,0,,129,280,.461,.461,157,219,.717,134,199,333,97,36,27,61,252,415
85,Jason Collins\collija04,C,27,NJN,71,70,1895,104,262,.397,3,12,.250,101,250,.404,.403,44,86,.512,93,249,342,70,46,40,61,251,255
86,Nick Collison\collini01,PF,25,SEA,66,27,1448,207,394,.525,0,3,.000,207,391,.529,.525,79,113,.699,143,225,368,74,21,35,77,213,493
87,Brian Cook\cookbr01,PF,25,LAL,81,46,1535,261,511,.511,36,84,.429,225,427,.527,.546,84,101,.832,88,186,274,74,37,32,61,205,642
88,Jamal Crawford\crawfja01,SG,25,NYK,79,27,2555,366,879,.416,101,293,.345,265,586,.452,.474,295,357,.826,36,212,248,301,87,15,175,150,1128
89,Austin Croshere\croshau01,PF,30,IND,50,26,1148,132,285,.463,54,140,.386,78,145,.538,.558,90,102,.882,62,203,265,62,22,7,48,105,408
90,Eddy Curry\curryed01,C,23,NYK,72,69,1865,336,597,.563,0,0,,336,597,.563,.563,307,486,.632,145,287,432,19,28,56,179,239,979
91,Samuel Dalembert\dalemsa01,C,24,PHI,66,52,1761,196,369,.531,0,1,.000,196,368,.533,.531,93,132,.705,159,382,541,25,34,160,107,244,485
92,Erick Dampier\dampier01,C,30,DAL,82,36,1934,171,347,.493,0,0,,171,347,.493,.493,127,215,.591,273,367,640,51,27,106,115,263,469
93,Antonio Daniels\daniean01,SG,30,WAS,80,17,2283,230,550,.418,23,101,.228,207,449,.461,.439,284,336,.845,19,153,172,284,52,8,89,96,767
94,Marquis Daniels\daniema01,SG,25,DAL,62,29,1766,246,512,.480,4,19,.211,242,493,.491,.484,138,183,.754,81,143,224,172,67,13,100,143,634
95,Antonio Davis\davisan01,PF-C,37,TOT,44,39,940,82,190,.432,0,1,.000,82,189,.434,.432,52,81,.642,90,118,208,21,23,10,51,125,216
95,Antonio Davis\davisan01,PF,37,NYK,36,31,749,68,159,.428,0,1,.000,68,158,.430,.428,45,61,.738,75,97,172,14,20,9,43,99,181
95,Antonio Davis\davisan01,C,37,TOR,8,8,191,14,31,.452,0,0,,14,31,.452,.452,7,20,.350,15,21,36,7,3,1,8,26,35
96,Baron Davis\davisba01,PG,26,GSW,54,48,1971,335,861,.389,102,324,.315,233,537,.434,.448,195,289,.675,45,191,236,480,89,14,159,165,967
97,Dale Davis\davisda01,C,36,DET,28,2,178,9,24,.375,0,1,.000,9,23,.391,.375,8,15,.533,21,32,53,6,0,9,4,23,26
98,Josh Davis\davisjo02,PF,25,TOT,6,0,17,2,7,.286,0,2,.000,2,5,.400,.286,2,3,.667,3,1,4,1,2,0,1,3,6
98,Josh Davis\davisjo02,PF,25,MIL,4,0,12,1,4,.250,0,1,.000,1,3,.333,.250,0,0,,2,1,3,1,1,0,1,2,2
98,Josh Davis\davisjo02,PF,25,HOU,1,0,0,0,0,,0,0,,0,0,,,0,0,,0,0,0,0,0,0,0,1,0
98,Josh Davis\davisjo02,PF,25,PHO,1,0,5,1,3,.333,0,1,.000,1,2,.500,.333,2,3,.667,1,0,1,0,1,0,0,0,4
99,Ricky Davis\davisri01,SG-SF,26,TOT,78,78,3207,584,1304,.448,73,242,.302,511,1062,.481,.476,275,345,.797,65,286,351,394,91,17,213,190,1516
99,Ricky Davis\davisri01,SG,26,BOS,42,42,1747,329,709,.464,40,125,.320,289,584,.495,.492,129,164,.787,40,147,187,221,49,9,115,91,827
99,Ricky Davis\davisri01,SF,26,MIN,36,36,1460,255,595,.429,33,117,.282,222,478,.464,.456,146,181,.807,25,139,164,173,42,8,98,99,689
100,Carlos Delfino\delfica01,SG,23,DET,68,1,726,91,226,.403,20,60,.333,71,166,.428,.447,45,67,.672,28,85,113,44,21,15,36,86,247
101,Tony Delk\delkto01,PG-SG,32,TOT,24,0,385,71,161,.441,20,47,.426,51,114,.447,.503,20,27,.741,14,39,53,33,13,1,19,28,182
101,Tony Delk\delkto01,SG,32,ATL,1,0,7,0,1,.000,0,0,,0,1,.000,.000,2,2,1.000,1,1,2,0,0,0,0,0,2
101,Tony Delk\delkto01,PG,32,DET,23,0,378,71,160,.444,20,47,.426,51,113,.451,.506,18,25,.720,13,38,51,33,13,1,19,28,180
102,Luol Deng\denglu01,SF,20,CHI,78,56,2604,442,954,.463,21,78,.269,421,876,.481,.474,207,276,.750,127,389,516,147,72,50,105,128,1112
103,Boris Diaw\diawbo01,PF,23,PHO,81,70,2874,449,853,.526,8,30,.267,441,823,.536,.531,174,238,.731,159,399,558,503,58,85,189,260,1080
104,Dan Dickau\dickada01,PG,27,BOS,19,0,234,17,46,.370,10,20,.500,7,26,.269,.478,18,18,1.000,5,11,16,40,11,1,18,40,62
105,Travis Diener\dienetr01,PG,23,ORL,23,0,246,29,69,.420,25,57,.439,4,12,.333,.601,5,6,.833,4,17,21,16,7,0,10,22,88
106,Ike Diogu\dioguik01,PF,22,GSW,69,14,1031,175,334,.524,0,0,,175,334,.524,.524,136,168,.810,95,134,229,29,15,30,78,164,486
107,DeSagana Diop\diopde01,C,24,DAL,81,45,1510,75,154,.487,1,2,.500,74,152,.487,.490,39,72,.542,145,229,374,23,44,146,36,253,190
108,Juan Dixon\dixonju01,SG,27,POR,76,42,1920,357,821,.435,65,170,.382,292,651,.449,.474,156,194,.804,30,147,177,149,58,6,113,157,935
109,Michael Doleac\doleami01,C,28,MIA,31,3,371,37,88,.420,0,0,,37,88,.420,.420,24,30,.800,23,62,85,8,10,7,14,45,98
110,Keyon Dooling\doolike01,PG,25,ORL,50,7,1137,178,405,.440,13,43,.302,165,362,.456,.456,101,121,.835,11,67,78,109,49,4,82,116,470
111,Chris Duhon\duhonch01,PG,23,CHI,74,38,2155,215,538,.400,100,278,.360,115,260,.442,.493,117,143,.818,28,192,220,373,70,3,117,152,647
112,Tim Duncan*\duncati01,PF,29,SAS,80,80,2784,574,1185,.484,2,5,.400,572,1180,.485,.485,335,533,.629,231,650,881,253,70,162,198,219,1485
113,Mike Dunleavy\dunlemi02,SF,25,GSW,81,68,2578,331,816,.406,74,260,.285,257,556,.462,.451,196,252,.778,78,321,399,237,60,32,120,199,932
114,Ronald Dupree\duprero01,SF,25,MIN,36,0,265,33,63,.524,0,1,.000,33,62,.532,.524,14,41,.341,21,28,49,14,12,0,14,44,80
115,John Edwards\edwarjo01,C,24,ATL,40,4,296,31,64,.484,0,0,,31,64,.484,.484,8,11,.727,18,30,48,5,3,15,12,76,70
116,Howard Eisley\eisleho01,PG,33,TOT,32,0,394,34,103,.330,13,42,.310,21,61,.344,.393,20,24,.833,3,30,33,69,11,2,21,34,101
116,Howard Eisley\eisleho01,PG,33,LAC,13,0,112,4,17,.235,1,4,.250,3,13,.231,.265,0,0,,1,13,14,25,3,0,3,11,9
116,Howard Eisley\eisleho01,PG,33,DEN,19,0,282,30,86,.349,12,38,.316,18,48,.375,.419,20,24,.833,2,17,19,44,8,2,18,23,92
117,Monta Ellis\ellismo01,SG,20,GSW,49,3,886,132,318,.415,28,82,.341,104,236,.441,.459,42,59,.712,22,83,105,78,32,11,58,69,334
118,Francisco Elson\elsonfr01,C,29,DEN,72,54,1579,151,284,.532,1,5,.200,150,279,.538,.533,49,74,.662,99,240,339,47,54,45,65,211,352
119,Melvin Ely\elyme01,PF,27,CHA,57,22,1348,216,425,.508,0,2,.000,216,423,.511,.508,128,192,.667,94,183,277,76,29,44,100,160,560
120,Maurice Evans\evansma01,SG,27,DET,80,1,1139,154,341,.452,43,116,.371,111,225,.493,.515,52,65,.800,76,87,163,60,41,15,39,122,403
121,Reggie Evans\evansre01,PF,25,TOT,67,25,1393,131,268,.489,0,1,.000,131,267,.491,.489,115,217,.530,171,331,502,38,40,10,85,166,377
121,Reggie Evans\evansre01,PF,25,SEA,41,23,788,88,173,.509,0,1,.000,88,172,.512,.509,66,120,.550,114,162,276,23,24,5,41,95,242
121,Reggie Evans\evansre01,PF,25,DEN,26,2,605,43,95,.453,0,0,,43,95,.453,.453,49,97,.505,57,169,226,15,16,5,44,71,135
122,Daniel Ewing\ewingda01,SG,22,LAC,66,5,971,97,255,.380,22,78,.282,75,177,.424,.424,36,46,.783,23,62,85,84,37,6,57,86,252
123,Noel Felix\felixno01,SF,24,SEA,12,0,82,6,25,.240,1,3,.333,5,22,.227,.260,5,8,.625,3,10,13,2,2,3,8,13,18
124,Raymond Felton\feltora01,PG,21,CHA,80,54,2406,345,883,.391,97,271,.358,248,612,.405,.446,161,222,.725,77,188,265,446,102,8,182,181,948
125,Michael Finley\finlemi01,SG,32,SAS,77,18,2038,286,695,.412,110,279,.394,176,416,.423,.491,98,115,.852,31,216,247,116,37,7,62,97,780
126,Derek Fisher\fishede01,PG,31,GSW,82,36,2589,364,887,.410,117,295,.397,247,592,.417,.476,244,293,.833,36,175,211,352,125,8,156,237,1089
127,Gerald Fitch\fitchge01,PG,23,MIA,18,1,239,30,89,.337,7,26,.269,23,63,.365,.376,17,23,.739,7,23,30,33,7,5,15,28,84
128,Marcus Fizer\fizerma01,PF,27,NOK,3,0,39,9,17,.529,1,1,1.000,8,16,.500,.559,1,2,.500,1,6,7,1,0,0,2,5,20
129,Sharrod Ford\fordsh02,PF,24,PHO,3,0,13,2,3,.667,0,0,,2,3,.667,.667,0,0,,1,2,3,0,0,1,2,7,4
130,T.J. Ford\fordtj01,PG,22,MIL,72,70,2557,328,789,.416,35,104,.337,293,685,.428,.438,187,248,.754,63,248,311,473,104,7,219,196,878
131,Danny Fortson\fortsda01,C,29,SEA,23,1,276,27,51,.529,0,0,,27,51,.529,.529,33,43,.767,31,47,78,2,4,2,26,76,87
132,Jeff Foster\fosteje01,C,29,IND,63,37,1581,138,250,.552,0,4,.000,138,246,.561,.552,96,159,.604,224,350,574,50,41,27,64,191,372
133,Adonal Foyle\foylead01,C,30,GSW,77,72,1824,152,300,.507,0,0,,152,300,.507,.507,41,67,.612,143,281,424,33,44,125,80,215,345
134,Richie Frahm\frahmri01,SG,28,TOT,33,0,342,39,100,.390,23,70,.329,16,30,.533,.505,7,10,.700,3,30,33,21,4,2,8,30,108
134,Richie Frahm\frahmri01,SG,28,MIN,25,0,225,24,65,.369,15,48,.313,9,17,.529,.485,3,5,.600,3,20,23,15,3,2,4,22,66
134,Richie Frahm\frahmri01,SG,28,HOU,8,0,117,15,35,.429,8,22,.364,7,13,.538,.543,4,5,.800,0,10,10,6,1,0,4,8,42
135,Steve Francis\francst01,PG-SG,28,TOT,70,60,2393,333,765,.435,25,83,.301,308,682,.452,.452,314,399,.787,74,216,290,345,74,17,214,204,1005
135,Steve Francis\francst01,PG,28,ORL,46,45,1734,249,575,.433,18,70,.257,231,505,.457,.449,231,290,.797,60,159,219,262,51,11,156,142,747
135,Steve Francis\francst01,SG,28,NYK,24,15,659,84,190,.442,7,13,.538,77,177,.435,.461,83,109,.761,14,57,71,83,23,6,58,62,258
136,Channing Frye\fryech01,C,22,NYK,65,14,1572,305,640,.477,3,9,.333,302,631,.479,.479,189,229,.825,138,236,374,53,30,47,97,200,802
137,Dan Gadzuric\gadzuda01,C,27,MIL,74,0,885,171,309,.553,0,1,.000,171,308,.555,.553,41,89,.461,91,141,232,24,25,43,35,171,383
138,Deng Gai\gaide01,C,23,PHI,2,0,5,0,0,,0,0,,0,0,,,0,0,,0,0,0,0,0,0,0,0,0
139,Reece Gaines\gainere01,PG,25,MIL,12,0,54,6,12,.500,0,2,.000,6,10,.600,.500,1,4,.250,0,0,0,3,1,0,1,1,13
140,Francisco García\garcifr01,SF,24,SAC,67,11,1301,130,325,.400,39,137,.285,91,188,.484,.460,78,101,.772,39,146,185,94,41,47,75,135,377
141,Kevin Garnett*\garneke01,PF,29,MIN,76,76,2957,626,1191,.526,8,30,.267,618,1161,.532,.529,396,489,.810,214,752,966,308,104,107,180,206,1656
142,Pat Garrity\garripa01,PF,29,ORL,57,0,938,101,242,.417,50,129,.388,51,113,.451,.521,30,37,.811,31,77,108,38,12,9,38,108,282
143,Pau Gasol\gasolpa01,PF,25,MEM,80,80,3135,600,1194,.503,3,12,.250,597,1182,.505,.504,425,617,.689,191,522,713,371,46,153,235,184,1628
144,Devean George\georgde01,SF,28,LAL,71,5,1542,170,425,.400,50,160,.313,120,265,.453,.459,58,86,.674,82,192,274,68,66,34,54,159,448
145,Eddie Gill\gilled01,PG,27,IND,41,0,122,10,45,.222,7,23,.304,3,22,.136,.300,18,23,.783,0,15,15,12,11,1,9,13,45
146,Manu Ginóbili*\ginobma01,SG,28,SAS,65,56,1813,309,669,.462,83,217,.382,226,452,.500,.524,280,360,.778,42,188,230,235,101,26,121,156,981
147,Gordan Giriček\giricgo01,SG,28,UTA,37,36,956,166,383,.433,18,59,.305,148,324,.457,.457,43,57,.754,15,55,70,63,16,4,63,87,393
148,Anthony Goldwire\goldwan01,PG,34,LAC,3,0,22,1,7,.143,0,2,.000,1,5,.200,.143,0,0,,0,1,1,2,0,0,1,0,2
149,Ryan Gomes\gomesry01,PF,23,BOS,61,33,1376,173,355,.487,3,9,.333,170,346,.491,.492,112,149,.752,102,196,298,58,35,5,55,83,461
150,Drew Gooden\goodedr01,PF,24,CLE,79,79,2174,334,652,.512,1,3,.333,333,649,.513,.513,176,258,.682,237,428,665,56,52,49,106,190,845
151,Ben Gordon\gordobe01,SG,22,CHI,80,47,2482,486,1152,.422,166,382,.435,320,770,.416,.494,211,268,.787,43,176,219,240,75,5,180,238,1349
152,Joey Graham\grahajo01,SF,23,TOR,80,24,1581,198,414,.478,29,87,.333,169,327,.517,.513,108,133,.812,57,187,244,60,37,13,92,228,533
153,Stephen Graham\grahast01,SG,23,TOT,22,0,175,21,54,.389,2,10,.200,19,44,.432,.407,14,15,.933,5,22,27,7,5,2,13,31,58
153,Stephen Graham\grahast01,SG,23,HOU,6,0,38,6,16,.375,1,5,.200,5,11,.455,.406,4,4,1.000,1,6,7,3,2,0,5,5,17
153,Stephen Graham\grahast01,SG,23,CHI,3,0,20,1,5,.200,1,4,.250,0,1,.000,.300,2,2,1.000,0,3,3,1,0,0,1,3,5
153,Stephen Graham\grahast01,SG,23,CLE,13,0,117,14,33,.424,0,1,.000,14,32,.438,.424,8,9,.889,4,13,17,3,3,2,7,23,36
154,Danny Granger\grangda01,SF,22,IND,78,17,1765,221,478,.462,30,93,.323,191,385,.496,.494,115,148,.777,131,253,384,90,58,62,80,211,587
155,Brian Grant\grantbr01,C,33,PHO,21,2,248,27,65,.415,0,0,,27,65,.415,.415,7,8,.875,11,46,57,7,5,3,7,45,61
156,Devin Green\greende01,SG,23,LAL,27,0,135,6,28,.214,0,2,.000,6,26,.231,.214,13,21,.619,10,14,24,7,3,0,5,13,25
157,Gerald Green\greenge01,SG,20,BOS,32,3,374,66,138,.478,6,20,.300,60,118,.508,.500,29,37,.784,10,31,41,18,13,4,22,41,167
158,Willie Green\greenwi01,SG,24,PHI,10,2,153,28,66,.424,10,19,.526,18,47,.383,.500,4,5,.800,1,14,15,5,2,0,12,13,70
159,Orien Greene\greenor01,PG,23,BOS,80,5,1235,100,253,.395,9,40,.225,91,213,.427,.413,45,68,.662,37,108,145,129,77,10,109,181,254
160,Adrian Griffin\griffad01,SG,31,DAL,52,45,1245,98,204,.480,0,2,.000,98,202,.485,.480,41,53,.774,75,152,227,89,51,9,39,113,237
161,Eddie Griffin\griffed01,C,23,MIN,70,27,1359,130,370,.351,16,82,.195,114,288,.396,.373,44,74,.595,107,282,389,40,13,148,43,125,320
162,Anthony Grundy\grundan01,SG,26,ATL,12,0,108,19,38,.500,5,15,.333,14,23,.609,.566,9,14,.643,1,16,17,9,7,0,9,14,52
163,Richard Hamilton\hamilri01,SG,27,DET,80,80,2825,649,1322,.491,55,120,.458,594,1202,.494,.512,256,303,.845,84,172,256,275,52,16,173,207,1609
164,Zendon Hamilton\hamilze01,C,30,TOT,12,0,49,7,14,.500,0,0,,7,14,.500,.500,12,18,.667,3,8,11,0,4,0,6,5,26
164,Zendon Hamilton\hamilze01,C,30,CLE,11,0,46,7,13,.538,0,0,,7,13,.538,.538,11,16,.688,3,8,11,0,3,0,6,4,25
164,Zendon Hamilton\hamilze01,C,30,PHI,1,0,3,0,1,.000,0,0,,0,1,.000,.000,1,2,.500,0,0,0,0,1,0,0,1,1
165,Anfernee Hardaway\hardaan01,SF,34,NYK,4,0,72,4,14,.286,0,1,.000,4,13,.308,.286,2,2,1.000,0,10,10,8,2,0,6,7,10
166,Matt Harpring\harprma01,SF,29,UTA,71,32,1944,322,678,.475,14,39,.359,308,639,.482,.485,227,313,.725,158,210,368,98,59,14,109,202,885
167,Al Harrington\harrial01,PF,25,ATL,76,76,2782,551,1220,.452,66,191,.346,485,1029,.471,.479,243,350,.694,132,391,523,238,85,14,195,301,1411
168,Othella Harrington\harriot01,C,32,CHI,72,23,824,135,273,.495,0,0,,135,273,.495,.495,77,123,.626,54,100,154,39,7,13,61,131,347
169,Devin Harris\harride01,PG,22,DAL,56,4,1275,190,405,.469,5,21,.238,185,384,.482,.475,169,236,.716,26,99,125,177,53,16,84,121,554
170,David Harrison\harrida01,C,23,IND,67,17,1034,148,294,.503,0,0,,148,294,.503,.503,89,174,.511,84,170,254,14,23,59,79,193,385
171,Jason Hart\hartja01,PG,27,SAC,66,0,818,86,221,.389,9,31,.290,77,190,.405,.410,37,56,.661,12,59,71,70,31,5,43,85,218
172,Udonis Haslem\hasleud01,PF,25,MIA,81,80,2491,300,591,.508,0,2,.000,300,589,.509,.508,157,199,.789,167,467,634,95,50,17,80,216,757
173,Trenton Hassell\hassetr01,SG,26,MIN,77,67,2514,286,616,.464,7,23,.304,279,593,.470,.470,131,176,.744,82,134,216,203,43,29,124,201,710
174,Chuck Hayes\hayesch01,PF,22,HOU,40,0,535,59,105,.562,0,1,.000,59,104,.567,.562,29,45,.644,67,112,179,14,26,14,12,76,147
175,Jarvis Hayes\hayesja01,SG,24,WAS,21,13,516,77,183,.421,17,47,.362,60,136,.441,.467,25,30,.833,19,57,76,27,16,1,22,38,196
176,Brendan Haywood\haywobr01,C,26,WAS,79,70,1879,222,432,.514,0,0,,222,432,.514,.514,131,224,.585,200,267,467,46,30,104,97,232,575
177,Luther Head\headlu01,SG,23,HOU,80,27,2310,254,630,.403,113,313,.361,141,317,.445,.493,86,123,.699,33,233,266,215,89,9,119,169,707
178,Alan Henderson\hendeal01,C,33,CLE,51,3,531,47,91,.516,0,0,,47,91,.516,.516,33,49,.673,60,77,137,10,9,12,22,58,127
179,Nenê\hilarne01,PF,23,DEN,1,0,3,0,1,.000,0,0,,0,1,.000,.000,0,0,,0,0,0,0,0,0,2,1,0
180,Grant Hill*\hillgr01,SF,33,ORL,21,17,613,119,243,.490,2,8,.250,117,235,.498,.494,78,102,.765,15,65,80,48,24,6,35,50,318
181,Kirk Hinrich\hinriki01,PG,25,CHI,81,81,2955,451,1078,.418,126,341,.370,325,737,.441,.477,256,314,.815,29,259,288,514,94,21,188,251,1284
182,Julius Hodge\hodgeju01,SG,22,DEN,14,0,33,5,13,.385,0,0,,5,13,.385,.385,3,8,.375,5,2,7,6,2,0,8,7,13
183,Randy Holcomb\holcora01,SF,26,CHI,4,0,11,1,1,1.000,0,0,,1,1,1.000,1.000,0,0,,1,0,1,0,0,0,0,2,2
184,Robert Horry\horryro01,PF,35,SAS,63,3,1182,112,292,.384,53,144,.368,59,148,.399,.474,44,68,.647,71,171,242,79,43,51,41,115,321
185,Eddie House\houseed01,PG,27,PHO,81,0,1421,320,759,.422,123,316,.389,197,443,.445,.503,33,41,.805,15,117,132,148,42,12,76,96,796
186,Dwight Howard\howardw01,PF,20,ORL,82,81,3021,468,881,.531,0,2,.000,468,879,.532,.531,356,598,.595,288,734,1022,125,65,115,217,277,1292
187,Josh Howard\howarjo01,SF,25,DAL,59,58,1915,350,743,.471,27,63,.429,323,680,.475,.489,196,267,.734,123,248,371,111,68,26,79,167,923
188,Juwan Howard\howarju01,PF,32,HOU,80,80,2537,394,859,.459,0,4,.000,394,855,.461,.459,154,191,.806,168,367,535,112,49,8,133,235,942
189,Troy Hudson\hudsotr01,PG,29,MIN,36,0,800,127,333,.381,40,101,.396,87,232,.375,.441,48,52,.923,8,36,44,106,12,4,40,55,342
190,Larry Hughes\hughela01,SG,27,CLE,36,31,1281,192,469,.409,28,76,.368,164,393,.417,.439,146,193,.756,26,135,161,131,53,21,99,117,558
191,Kris Humphries\humphkr01,PF,20,UTA,62,2,619,77,203,.379,0,5,.000,77,198,.389,.379,34,65,.523,56,101,157,30,23,16,31,82,188
192,Lindsey Hunter\hunteli01,PG,35,DET,30,1,353,37,100,.370,11,43,.256,26,57,.456,.425,2,4,.500,10,30,40,62,19,1,20,44,87
193,Steven Hunter\huntest01,C,24,PHI,69,35,1312,175,291,.601,0,0,,175,291,.601,.601,71,138,.514,110,161,271,17,12,76,64,120,421
194,Andre Iguodala\iguodan01,SF,22,PHI,82,82,3086,344,688,.500,56,158,.354,288,530,.543,.541,263,349,.754,117,364,481,255,135,21,153,198,1007
195,Zydrunas Ilgauskas\ilgauzy01,C,30,CLE,78,78,2283,450,889,.506,0,5,.000,450,884,.509,.506,317,380,.834,245,346,591,91,38,136,155,280,1217
196,D.J. Mbenga\mbengdj01,C,25,DAL,43,1,237,32,60,.533,0,1,.000,32,59,.542,.533,10,20,.500,19,37,56,2,6,25,16,47,74
197,Allen Iverson*\iversal01,PG,30,PHI,72,72,3103,815,1822,.447,72,223,.323,743,1599,.465,.467,675,829,.814,44,188,232,532,140,10,248,121,2377
198,Royal Ivey\iveyro01,PG,24,ATL,73,66,978,116,264,.439,4,10,.400,112,254,.441,.447,24,33,.727,31,65,96,74,24,7,23,147,260
199,Jarrett Jack\jackja01,SG,22,POR,79,4,1599,189,428,.442,20,76,.263,169,352,.480,.465,128,160,.800,18,142,160,219,41,2,102,138,526
200,Bobby Jackson\jacksbo01,PG,32,MEM,71,15,1775,286,748,.382,129,332,.389,157,416,.377,.469,107,146,.733,44,179,223,195,61,1,101,155,808
201,Jermaine Jackson\jacksje01,PG,29,MIL,30,2,202,11,26,.423,1,4,.250,10,22,.455,.442,12,14,.857,8,19,27,25,4,1,13,19,35
202,Jim Jackson\jacksji01,SF,35,TOT,40,1,512,47,160,.294,18,74,.243,29,86,.337,.350,9,13,.692,11,65,76,35,12,6,35,51,121
202,Jim Jackson\jacksji01,SF,35,PHO,27,1,420,38,129,.295,14,63,.222,24,66,.364,.349,9,13,.692,11,53,64,31,10,6,30,46,99
202,Jim Jackson\jacksji01,SF,35,LAL,13,0,92,9,31,.290,4,11,.364,5,20,.250,.355,0,0,,0,12,12,4,2,0,5,5,22
203,Luke Jackson\jackslu02,SF,24,CLE,36,0,315,29,85,.341,12,36,.333,17,49,.347,.412,26,33,.788,16,24,40,25,11,2,31,30,96
204,Marc Jackson\jacksma02,C,31,TOT,64,10,1027,174,369,.472,1,2,.500,173,367,.471,.473,66,82,.805,86,131,217,44,13,8,65,126,415
204,Marc Jackson\jacksma02,C,31,NJN,37,0,433,66,148,.446,0,0,,66,148,.446,.446,38,48,.792,30,59,89,22,5,6,28,70,170
204,Marc Jackson\jacksma02,C,31,NOK,27,10,594,108,221,.489,1,2,.500,107,219,.489,.491,28,34,.824,56,72,128,22,8,2,37,56,245
205,Stephen Jackson\jacksst02,SG,27,IND,81,81,2910,472,1148,.411,117,339,.345,355,809,.439,.462,268,341,.786,48,264,312,225,104,43,203,195,1329
206,Jerome James\jamesje01,C,30,NYK,45,9,406,56,121,.463,0,0,,56,121,.463,.463,25,40,.625,39,52,91,12,3,23,51,104,137
207,LeBron James\jamesle01,SF,21,CLE,79,79,3361,875,1823,.480,127,379,.335,748,1444,.518,.515,601,814,.738,75,481,556,521,123,66,260,181,2478
208,Mike James\jamesmi01,PG,30,TOR,79,79,2925,576,1228,.469,169,382,.442,407,846,.481,.538,283,338,.837,45,217,262,460,72,3,206,214,1604
209,Antawn Jamison\jamisan01,SF,29,WAS,82,80,3288,660,1494,.442,147,373,.394,513,1121,.458,.491,217,297,.731,167,598,765,158,90,12,137,189,1684
210,Marko Jarić\jaricma01,PG,27,MIN,75,49,2102,226,566,.399,40,133,.301,186,433,.430,.435,95,138,.688,60,173,233,293,108,21,127,189,587
211,Šarūnas Jasikevičius\jasiksa01,PG,29,IND,75,15,1557,170,429,.396,86,236,.364,84,193,.435,.497,121,133,.910,19,134,153,227,40,4,116,108,547
212,Al Jefferson\jeffeal01,PF,21,BOS,59,7,1062,189,379,.499,0,4,.000,189,375,.504,.499,86,134,.642,97,202,299,30,30,46,62,166,464
213,Richard Jefferson\jefferi01,SF,25,NJN,78,78,3059,495,1005,.493,60,188,.319,435,817,.532,.522,471,580,.812,95,439,534,297,59,17,174,193,1521
214,Jared Jeffries\jeffrja01,PF,24,WAS,77,77,1951,187,415,.451,16,50,.320,171,365,.468,.470,99,168,.589,164,215,379,148,58,50,99,223,489
215,Amir Johnson\johnsam01,SF,18,DET,3,0,39,7,10,.700,2,3,.667,5,7,.714,.800,4,4,1.000,3,1,4,3,0,2,4,7,20
216,Anthony Johnson\johnsan02,PG,31,IND,75,53,1981,267,603,.443,51,155,.329,216,448,.482,.485,106,141,.752,31,137,168,324,63,22,115,132,691
217,DerMarr Johnson\johnsde03,SG,25,DEN,58,21,924,132,306,.431,56,160,.350,76,146,.521,.523,34,42,.810,19,77,96,55,25,26,46,86,354
218,Ervin Johnson\johnser02,C,38,MIL,18,0,81,7,17,.412,0,0,,7,17,.412,.412,1,2,.500,5,19,24,2,1,2,5,23,15
219,Joe Johnson\johnsjo02,SG,24,ATL,82,82,3340,632,1395,.453,128,360,.356,504,1035,.487,.499,261,330,.791,98,237,335,536,103,31,267,187,1653
220,Linton Johnson\johnsli01,SF,25,TOT,36,7,524,61,149,.409,13,36,.361,48,113,.425,.453,18,27,.667,40,82,122,14,12,12,28,61,153
220,Linton Johnson\johnsli01,SF,25,NJN,9,0,35,5,10,.500,0,0,,5,10,.500,.500,1,4,.250,0,7,7,2,2,0,4,7,11
220,Linton Johnson\johnsli01,SF,25,NOK,27,7,489,56,139,.403,13,36,.361,43,103,.417,.450,17,23,.739,40,75,115,12,10,12,24,54,142
221,Dahntay Jones\jonesda02,SF,25,MEM,71,4,967,109,263,.414,3,21,.143,106,242,.438,.420,60,93,.645,20,84,104,39,38,15,50,108,281
222,Damon Jones\jonesda01,PG,29,CLE,82,7,2089,190,491,.387,140,371,.377,50,120,.417,.530,32,50,.640,14,119,133,169,37,1,55,112,552
223,Dwayne Jones\jonesdw02,PF,22,BOS,14,0,87,4,10,.400,0,0,,4,10,.400,.400,6,13,.462,10,21,31,2,1,3,3,14,14
224,Eddie Jones\jonesed02,SG,34,MEM,75,75,2437,292,722,.404,133,374,.356,159,348,.457,.497,168,215,.781,35,244,279,177,131,27,93,201,885
225,Fred Jones\jonesfr01,SG,26,IND,68,2,1837,233,559,.417,63,187,.337,170,372,.457,.473,122,160,.763,18,152,170,154,55,20,107,142,651
226,James Jones\jonesja02,SF,25,PHO,75,24,1772,243,581,.418,110,285,.386,133,296,.449,.513,103,121,.851,44,209,253,57,38,49,35,142,699
227,Jumaine Jones\jonesju01,PF,26,CHA,76,42,2089,298,736,.405,115,335,.343,183,401,.456,.483,88,121,.727,105,271,376,63,68,22,74,200,799
228,Chris Kaman\kamanch01,C,23,LAC,78,78,2560,369,706,.523,0,2,.000,369,704,.524,.523,194,252,.770,187,563,750,79,45,108,176,269,932
229,Jason Kapono\kaponja01,SF,24,MIA,51,2,665,79,177,.446,21,53,.396,58,124,.468,.506,28,33,.848,12,59,71,37,7,3,20,89,207
230,Mario Kasun\kasunma01,C,25,ORL,28,0,213,31,69,.449,0,0,,31,69,.449,.449,18,23,.783,24,36,60,3,2,3,15,69,80
231,Viktor Khryapa\khryavi01,SF,23,POR,69,53,1492,158,342,.462,10,30,.333,148,312,.474,.477,77,111,.694,114,193,307,88,50,29,84,209,403
232,Jason Kidd*\kiddja01,PG,32,NJN,80,80,2975,366,905,.404,139,395,.352,227,510,.445,.481,194,244,.795,86,494,580,672,150,29,192,157,1065
233,Andrei Kirilenko\kirilan01,SF,24,UTA,69,63,2604,336,730,.460,36,117,.308,300,613,.489,.485,346,495,.699,161,391,552,299,102,220,203,162,1054
234,Linas Kleiza\kleizli01,PF,21,DEN,61,2,519,77,173,.445,2,13,.154,75,160,.469,.451,57,81,.704,38,78,116,15,10,13,16,87,213
235,Brevin Knight\knighbr01,PG,30,CHA,69,67,2351,308,772,.399,3,13,.231,305,759,.402,.401,252,314,.803,35,188,223,610,157,4,164,202,871
236,Yaroslav Korolev\korolya01,SF,18,LAC,24,0,127,9,30,.300,2,7,.286,7,23,.304,.333,7,10,.700,5,8,13,9,3,0,6,11,27
237,Kyle Korver\korveky01,SF,24,PHI,82,43,2563,327,761,.430,184,438,.420,143,323,.443,.551,101,119,.849,27,243,270,163,65,26,98,224,939
238,Nenad Krstić\krstine01,PF,22,NJN,80,80,2469,447,881,.507,1,4,.250,446,877,.509,.508,185,265,.698,182,331,513,88,32,63,133,297,1080
239,Toni Kukoč*\kukocto01,PF,37,MIL,65,0,1018,116,298,.389,45,147,.306,71,151,.470,.465,40,56,.714,26,124,150,139,33,17,66,87,317
240,Raef LaFrentz\lafrera01,PF,29,BOS,82,63,2033,238,552,.431,112,286,.392,126,266,.474,.533,51,75,.680,80,326,406,115,29,72,65,273,639
241,Maciej Lampe\lampema01,C,20,TOT,6,0,28,2,11,.182,0,0,,2,11,.182,.182,0,2,.000,4,5,9,2,0,0,3,2,4
241,Maciej Lampe\lampema01,C,20,NOK,2,0,16,0,4,.000,0,0,,0,4,.000,.000,0,0,,1,3,4,2,0,0,1,2,0
241,Maciej Lampe\lampema01,C,20,HOU,4,0,12,2,7,.286,0,0,,2,7,.286,.286,0,2,.000,3,2,5,0,0,0,2,0,4
242,David Lee\leeda02,SF,22,NYK,67,14,1129,137,230,.596,0,0,,137,230,.596,.596,71,123,.577,109,194,303,43,30,20,51,124,345
243,Voshon Lenard\lenarvo01,SG,32,TOT,26,6,458,75,191,.393,25,78,.321,50,113,.442,.458,16,31,.516,5,42,47,41,21,4,31,39,191
243,Voshon Lenard\lenarvo01,SG,32,DEN,12,6,238,42,103,.408,10,35,.286,32,68,.471,.456,5,13,.385,2,26,28,18,8,2,11,21,99
243,Voshon Lenard\lenarvo01,SG,32,POR,14,0,220,33,88,.375,15,43,.349,18,45,.400,.460,11,18,.611,3,16,19,23,13,2,20,18,92
244,Rashard Lewis\lewisra02,SF,26,SEA,78,77,2876,538,1151,.467,142,370,.384,396,781,.507,.529,350,428,.818,111,279,390,182,102,50,141,191,1568
245,Randy Livingston\livinra01,PG,30,CHI,5,0,22,0,2,.000,0,0,,0,2,.000,.000,0,0,,1,3,4,1,1,0,1,6,0
246,Shaun Livingston\livinsh01,PG,20,LAC,61,14,1525,149,349,.427,1,8,.125,148,341,.434,.428,53,77,.688,41,142,183,273,46,32,111,160,352
247,John Lucas III\lucasjo02,PG,23,HOU,13,0,107,14,36,.389,2,9,.222,12,27,.444,.417,0,0,,2,3,5,12,5,0,7,6,30
248,Tyronn Lue\luety01,PG,28,ATL,51,10,1234,192,418,.459,58,127,.457,134,291,.460,.529,118,138,.855,13,69,82,157,26,3,75,113,560
249,Arvydas Macijauskas\macijar01,SG,26,NOK,19,0,135,14,41,.341,3,12,.250,11,29,.379,.378,13,15,.867,3,7,10,5,7,0,8,10,44
250,Mark Madsen\madsema01,C,30,MIN,62,7,676,27,66,.409,0,7,.000,27,59,.458,.409,20,47,.426,50,91,141,11,23,17,26,114,74
251,Corey Maggette\maggeco01,SF,26,LAC,32,13,943,167,375,.445,24,71,.338,143,304,.470,.477,212,256,.828,28,141,169,66,19,4,78,95,570
252,Jamaal Magloire\magloja01,C,27,MIL,82,82,2465,287,615,.467,0,0,,287,615,.467,.467,178,333,.535,220,558,778,56,29,80,166,276,752
253,Stephon Marbury\marbust01,PG,28,NYK,60,60,2193,349,774,.451,33,104,.317,316,670,.472,.472,246,326,.755,25,150,175,382,63,4,157,143,977
254,Shawn Marion\mariosh01,PF,27,PHO,81,81,3263,716,1365,.525,96,290,.331,620,1075,.577,.560,241,298,.809,249,710,959,143,160,137,125,223,1769
255,Sean Marks\marksse01,PF,30,SAS,25,0,181,37,71,.521,0,3,.000,37,68,.544,.521,7,12,.583,12,31,43,7,5,7,7,21,81
256,Donyell Marshall\marshdo01,PF,32,CLE,81,0,2077,265,671,.395,128,395,.324,137,276,.496,.490,92,123,.748,105,387,492,60,59,41,90,160,750
257,Rawle Marshall\marshra01,SF,23,DAL,23,9,241,24,60,.400,1,3,.333,23,57,.404,.408,22,29,.759,8,23,31,10,8,7,15,17,71
258,Darrick Martin\martida01,PG,34,TOR,40,0,339,34,97,.351,16,40,.400,18,57,.316,.433,18,24,.750,2,18,20,57,17,0,15,42,102
259,Kenyon Martin\martike01,PF,28,DEN,56,49,1546,297,600,.495,5,22,.227,292,578,.505,.499,121,170,.712,93,260,353,79,43,52,72,171,720
260,Kevin Martin\martike02,SG,22,SAC,72,41,1913,262,546,.480,66,179,.369,196,367,.534,.540,188,222,.847,58,203,261,97,55,9,81,138,778
261,Desmond Mason\masonde01,SF,28,NOK,70,55,2102,275,690,.399,1,6,.167,274,684,.401,.399,206,302,.682,64,234,298,66,42,17,113,136,757
262,Jason Maxiell\maxieja01,PF,22,DET,26,0,159,23,54,.426,0,0,,23,54,.426,.426,14,42,.333,12,16,28,3,4,5,11,14,60
263,Sean May\mayse01,PF,21,CHA,23,1,398,70,171,.409,0,5,.000,70,166,.422,.409,49,64,.766,42,67,109,22,17,12,33,58,189
264,Rashad McCants\mccanra01,SG,21,MIN,79,12,1362,241,535,.450,67,180,.372,174,355,.490,.513,78,106,.736,29,114,143,63,44,22,86,176,627
265,Walter McCarty\mccarwa01,SF,31,LAC,36,1,353,33,99,.333,10,45,.222,23,54,.426,.384,12,21,.571,15,53,68,23,8,5,19,52,88
266,Antonio McDyess\mcdyean01,PF,31,DET,82,0,1733,285,560,.509,0,2,.000,285,558,.511,.509,68,122,.557,156,280,436,90,46,48,76,220,638
267,Tracy McGrady*\mcgratr01,SF,26,HOU,47,47,1745,410,1011,.406,73,234,.312,337,777,.434,.442,254,340,.747,46,261,307,225,59,41,120,88,1147
268,Jeff McInnis\mcinnje01,SG,31,NJN,28,1,486,63,143,.441,3,16,.188,60,127,.472,.451,20,29,.690,11,39,50,52,11,2,29,37,149
269,Aaron McKie\mckieaa01,PG,33,LAL,14,0,121,3,12,.250,0,2,.000,3,10,.300,.250,1,2,.500,3,17,20,11,5,0,2,7,7
270,Keith McLeod\mcleoke01,PG,26,UTA,66,32,1232,120,340,.353,24,82,.293,96,258,.372,.388,106,133,.797,11,67,78,151,42,9,76,131,370
271,Stanislav Medvedenko\medvest01,PF,26,LAL,2,0,6,1,2,.500,0,0,,1,2,.500,.500,0,0,,0,0,0,1,0,0,0,1,2
272,Chris Mihm\mihmch01,C,26,LAL,59,56,1541,230,459,.501,0,0,,230,459,.501,.501,144,201,.716,137,236,373,61,16,73,83,214,604
273,Aaron Miles\milesaa01,PG,22,GSW,19,0,118,6,18,.333,0,0,,6,18,.333,.333,4,4,1.000,0,14,14,24,4,1,11,13,16
274,C.J. Miles\milescj01,PG,18,UTA,23,0,203,28,76,.368,5,20,.250,23,56,.411,.401,18,24,.750,18,20,38,16,7,2,9,20,79
275,Darius Miles\milesda01,SF,24,POR,40,23,1286,235,510,.461,2,10,.200,233,500,.466,.463,87,163,.534,24,158,182,73,42,39,99,100,559
276,Darko Miličić\milicda01,C,20,TOT,55,1,767,119,234,.509,0,2,.000,119,232,.513,.509,28,50,.560,44,107,151,41,14,77,51,92,266
276,Darko Miličić\milicda01,C,20,DET,25,0,140,17,33,.515,0,2,.000,17,31,.548,.515,3,8,.375,10,18,28,9,3,15,15,25,37
276,Darko Miličić\milicda01,C,20,ORL,30,1,627,102,201,.507,0,0,,102,201,.507,.507,25,42,.595,34,89,123,32,11,62,36,67,229
277,Andre Miller\millean02,PG,29,DEN,82,82,2937,404,872,.463,5,27,.185,399,845,.472,.466,313,424,.738,92,259,351,674,106,18,256,213,1126
278,Brad Miller\millebr01,C,29,SAC,79,79,2923,434,877,.495,34,88,.386,400,789,.507,.514,280,338,.828,122,493,615,374,61,62,180,234,1182
279,Mike Miller\millemi01,SG,25,MEM,74,9,2268,354,760,.466,138,339,.407,216,421,.513,.557,168,210,.800,42,355,397,200,52,27,140,173,1014
280,Yao Ming*\mingya01,C,25,HOU,57,57,1949,467,900,.519,0,1,.000,467,899,.519,.519,337,395,.853,148,433,581,85,30,94,147,195,1271
281,Cuttino Mobley\moblecu01,SG,30,LAC,79,74,2979,429,1008,.426,83,245,.339,346,763,.453,.467,229,273,.839,50,291,341,238,93,36,145,208,1170
282,Nazr Mohammed\mohamna01,C,28,SAS,80,30,1389,190,377,.504,0,0,,190,377,.504,.504,113,144,.785,163,255,418,40,21,49,91,220,493
283,Sergei Monia\moniase01,SF,22,TOT,26,15,343,29,87,.333,9,34,.265,20,53,.377,.385,10,14,.714,11,41,52,19,7,5,12,41,77
283,Sergei Monia\moniase01,SF,22,POR,23,15,336,29,85,.341,9,33,.273,20,52,.385,.394,8,12,.667,11,40,51,19,6,5,12,41,75
283,Sergei Monia\moniase01,SF,22,SAC,3,0,7,0,2,.000,0,1,.000,0,1,.000,.000,2,2,1.000,0,1,1,0,1,0,0,0,2
284,Mikki Moore\mooremi01,C,30,SEA,47,1,583,54,124,.435,0,2,.000,54,122,.443,.435,46,62,.742,44,86,130,27,7,15,40,92,154
285,Terence Morris\morrite01,SF,27,ORL,22,0,192,16,49,.327,0,2,.000,16,47,.340,.327,3,3,1.000,6,32,38,4,6,5,7,19,35
286,Alonzo Mourning*\mournal01,C,35,MIA,65,20,1302,188,315,.597,0,1,.000,188,314,.599,.597,133,224,.594,125,234,359,11,13,173,79,177,509
287,Troy Murphy\murphtr01,PF,25,GSW,74,74,2516,363,838,.433,58,181,.320,305,657,.464,.468,251,319,.787,195,548,743,101,47,26,108,191,1035
288,Lamond Murray\murrala01,SF,32,NJN,57,1,576,72,181,.398,27,78,.346,45,103,.437,.472,25,40,.625,29,103,132,13,17,7,22,66,196
289,Ronald Murray\murraro01,SG,26,TOT,76,27,2112,321,768,.418,37,141,.262,284,627,.453,.442,172,242,.711,33,120,153,197,68,11,135,133,851
289,Ronald Murray\murraro01,SG,26,SEA,48,2,1085,179,451,.397,17,76,.224,162,375,.432,.416,99,138,.717,18,68,86,120,30,4,79,69,474
289,Ronald Murray\murraro01,SG,26,CLE,28,25,1027,142,317,.448,20,65,.308,122,252,.484,.479,73,104,.702,15,52,67,77,38,7,56,64,377
290,Dikembe Mutombo*\mutomdi01,C,39,HOU,64,23,955,50,95,.526,0,0,,50,95,.526,.526,69,91,.758,100,206,306,4,17,57,35,128,169
291,Boniface N'Dong\ndongbo01,C,28,LAC,23,1,152,22,53,.415,0,1,.000,22,52,.423,.415,6,9,.667,15,22,37,7,2,5,6,23,50
292,Boštjan Nachbar\nachbbo01,PF-SF,25,TOT,36,13,502,54,156,.346,19,71,.268,35,85,.412,.407,30,44,.682,8,52,60,27,16,5,24,65,157
292,Boštjan Nachbar\nachbbo01,PF,25,NOK,25,13,405,42,124,.339,17,57,.298,25,67,.373,.407,25,36,.694,4,45,49,22,13,5,20,52,126
292,Boštjan Nachbar\nachbbo01,SF,25,NJN,11,0,97,12,32,.375,2,14,.143,10,18,.556,.406,5,8,.625,4,7,11,5,3,0,4,13,31
293,Lee Nailon\nailole01,PF,30,PHI,22,0,237,40,80,.500,0,0,,40,80,.500,.500,13,15,.867,23,19,42,7,8,4,10,32,93
294,Eduardo Nájera\najered01,PF,29,DEN,64,3,1449,127,301,.422,4,12,.333,123,289,.426,.429,89,114,.781,128,197,325,52,53,34,54,165,347
295,Steve Nash*\nashst01,PG,31,PHO,79,79,2796,541,1056,.512,150,342,.439,391,714,.548,.583,257,279,.921,47,286,333,826,61,12,276,120,1489
296,Jameer Nelson\nelsoja01,PG,23,ORL,62,33,1784,347,719,.483,70,165,.424,277,554,.500,.531,141,181,.779,39,141,180,302,70,9,148,174,905
297,Rasho Nesterović\nestera01,C,29,SAS,80,51,1515,172,334,.515,0,2,.000,172,332,.518,.515,18,30,.600,114,195,309,33,21,88,53,209,362
298,Ira Newble\newblir01,SG,31,CLE,36,3,353,17,57,.298,3,13,.231,14,44,.318,.325,11,16,.688,21,35,56,9,5,10,12,47,48
299,Andrés Nocioni\nocioan01,PF,26,CHI,82,43,2239,383,831,.461,93,238,.391,290,593,.489,.517,204,242,.843,89,411,500,117,40,52,120,252,1063
300,Moochie Norris\norrimo01,PG,32,TOT,45,0,424,46,112,.411,4,14,.286,42,98,.429,.429,29,42,.690,12,42,54,50,20,1,33,49,125
300,Moochie Norris\norrimo01,PG,32,HOU,29,0,241,26,65,.400,0,5,.000,26,60,.433,.400,13,17,.765,9,25,34,29,14,1,16,31,65
300,Moochie Norris\norrimo01,PG,32,NOK,16,0,183,20,47,.426,4,9,.444,16,38,.421,.468,16,25,.640,3,17,20,21,6,0,17,18,60
301,Dirk Nowitzki\nowitdi01,PF,27,DAL,81,81,3089,751,1564,.480,110,271,.406,641,1293,.496,.515,539,598,.901,115,613,728,226,58,83,156,164,2151
302,Jermaine O'Neal\onealje01,PF,27,IND,51,47,1802,380,805,.472,3,10,.300,377,795,.474,.474,261,368,.709,102,374,476,133,27,117,151,177,1024
303,Shaquille O'Neal*\onealsh01,C,33,MIA,59,58,1806,480,800,.600,0,0,,480,800,.600,.600,221,471,.469,172,369,541,113,23,104,168,230,1181
304,Fabricio Oberto\obertfa01,C,30,SAS,59,0,490,44,93,.473,0,2,.000,44,91,.484,.473,15,27,.556,57,66,123,27,9,11,28,91,103
305,Lamar Odom\odomla01,PF,26,LAL,80,80,3221,445,925,.481,80,215,.372,365,710,.514,.524,216,313,.690,181,557,738,443,75,64,213,256,1186
306,Emeka Okafor\okafoem01,PF,23,CHA,26,25,874,131,316,.415,0,0,,131,316,.415,.415,82,125,.656,94,167,261,31,22,50,53,88,344
307,Mehmet Okur\okurme01,PF,26,UTA,82,82,2945,519,1128,.460,80,234,.342,439,894,.491,.496,354,454,.780,211,535,746,194,40,73,163,285,1472
308,Kevin Ollie\ollieke01,SG,33,PHI,70,23,1069,75,174,.431,1,3,.333,74,171,.433,.434,41,49,.837,13,85,98,101,33,3,29,103,192
309,Michael Olowokandi\olowomi01,C,30,TOT,48,24,919,107,240,.446,0,0,,107,240,.446,.446,24,47,.511,50,170,220,23,22,33,55,122,238
309,Michael Olowokandi\olowomi01,C,30,MIN,32,24,752,87,195,.446,0,0,,87,195,.446,.446,19,39,.487,45,134,179,17,19,27,41,100,193
309,Michael Olowokandi\olowomi01,C,30,BOS,16,0,167,20,45,.444,0,0,,20,45,.444,.444,5,8,.625,5,36,41,6,3,6,14,22,45
310,Greg Ostertag\ostergr01,C,32,UTA,60,22,807,61,124,.492,0,0,,61,124,.492,.492,24,48,.500,82,143,225,58,6,66,46,129,146
311,Bo Outlaw\outlabo01,PF,34,ORL,32,0,355,35,58,.603,0,0,,35,58,.603,.603,5,8,.625,31,46,77,14,10,12,17,50,75
312,Travis Outlaw\outlatr01,PF,21,POR,69,11,1153,162,368,.440,14,53,.264,148,315,.470,.459,62,89,.697,48,141,189,34,31,46,37,112,400
313,Andre Owens\owensan01,PG,25,UTA,23,2,210,27,74,.365,3,16,.188,24,58,.414,.385,12,18,.667,11,10,21,8,5,0,13,25,69
314,Zaza Pachulia\pachuza01,C,21,ATL,78,78,2452,307,681,.451,0,2,.000,307,679,.452,.451,297,404,.735,264,349,613,129,89,39,180,286,911
315,Scott Padgett\padgesc01,PF,29,NJN,62,1,718,71,201,.353,42,121,.347,29,80,.363,.458,27,34,.794,56,109,165,41,28,12,21,90,211
316,Milt Palacio\palacmi01,PG,27,UTA,71,18,1376,171,403,.424,1,16,.063,170,387,.439,.426,98,150,.653,17,117,134,190,47,14,110,125,441
317,Jannero Pargo\pargoja01,PG,26,CHI,57,0,646,109,292,.373,39,103,.379,70,189,.370,.440,17,21,.810,8,53,61,94,24,2,61,57,274
318,Smush Parker\parkesm01,PG,24,LAL,82,82,2773,348,779,.447,120,328,.366,228,451,.506,.524,125,180,.694,37,234,271,302,140,16,147,213,941
319,Tony Parker\parketo01,PG,23,SAS,80,80,2715,623,1136,.548,11,36,.306,612,1100,.556,.553,253,358,.707,38,223,261,460,83,4,249,161,1510
320,Ruben Patterson\patteru01,SF-SG,30,TOT,71,22,1792,327,635,.515,1,13,.077,326,622,.524,.516,203,338,.601,118,126,244,127,76,21,150,150,858
320,Ruben Patterson\patteru01,SF,30,POR,45,2,1056,188,379,.496,0,7,.000,188,372,.505,.496,138,226,.611,73,81,154,60,42,12,82,79,514
320,Ruben Patterson\patteru01,SG,30,DEN,26,20,736,139,256,.543,1,6,.167,138,250,.552,.545,65,112,.580,45,45,90,67,34,9,68,71,344
321,Chris Paul\paulch01,PG,20,NOK,78,78,2808,407,947,.430,50,177,.282,357,770,.464,.456,394,465,.847,61,339,400,611,175,6,183,218,1258
322,Sasha Pavlović\pavloal01,SG,22,CLE,53,19,813,87,212,.410,35,96,.365,52,116,.448,.493,32,49,.653,16,64,80,25,19,6,42,103,241
323,Gary Payton*\paytoga01,PG,37,MIA,81,25,2305,230,547,.420,66,230,.287,164,317,.517,.481,100,126,.794,34,199,233,257,71,10,102,169,626
324,Kendrick Perkins\perkike01,C,21,BOS,68,40,1332,137,266,.515,0,2,.000,137,264,.519,.515,80,130,.615,140,264,404,69,21,105,107,199,354
325,Morris Peterson\petermo01,SG,28,TOR,82,77,3140,478,1096,.436,177,448,.395,301,648,.465,.517,241,294,.820,65,316,381,190,104,15,126,223,1374
326,Johan Petro\petrojo01,C,20,SEA,68,41,1282,153,300,.510,0,0,,153,300,.510,.510,47,75,.627,109,187,296,15,25,51,60,213,353
327,Eric Piatkowski\piatker01,SG,35,CHI,29,1,228,24,61,.393,9,33,.273,15,28,.536,.467,2,5,.400,4,19,23,13,6,1,11,20,59
328,Paul Pierce*\piercpa01,SF,28,BOS,79,79,3084,689,1462,.471,111,314,.354,578,1148,.503,.509,627,812,.772,77,453,530,375,107,34,273,223,2116
329,Mickaël Piétrus\pietrmi01,SF,23,GSW,52,18,1179,169,418,.404,56,176,.318,113,242,.467,.471,87,143,.608,58,105,163,44,33,10,78,132,481
330,Zoran Planinić\planizo01,PG,23,NJN,56,1,596,66,183,.361,13,56,.232,53,127,.417,.396,46,66,.697,14,60,74,53,20,4,43,91,191
331,Pavel Podkolzin\podkopa01,C,21,DAL,1,0,18,0,2,.000,0,0,,0,2,.000,.000,3,6,.500,0,7,7,0,0,1,2,0,3
332,Scot Pollard\pollasc01,C,30,IND,45,32,771,70,154,.455,0,0,,70,154,.455,.455,29,38,.763,73,145,218,24,37,20,26,115,169
333,James Posey\poseyja01,SF,29,MIA,67,63,1914,159,395,.403,117,290,.403,42,105,.400,.551,48,61,.787,33,286,319,89,54,20,58,196,483
334,Vitaly Potapenko\potapvi01,C,30,TOT,33,12,353,37,71,.521,0,0,,37,71,.521,.521,10,17,.588,27,37,64,9,2,2,16,50,84
334,Vitaly Potapenko\potapvi01,C,30,SEA,24,12,321,32,64,.500,0,0,,32,64,.500,.500,10,17,.588,26,36,62,7,2,2,14,44,74
334,Vitaly Potapenko\potapvi01,C,30,SAC,9,0,32,5,7,.714,0,0,,5,7,.714,.714,0,0,,1,1,2,2,0,0,2,6,10
335,Josh Powell\poweljo01,PF,23,DAL,37,2,429,37,81,.457,0,0,,37,81,.457,.457,36,45,.800,28,53,81,9,7,4,22,52,110
336,Ronnie Price\pricero01,PG,22,SAC,29,0,150,21,58,.362,6,27,.222,15,31,.484,.414,12,12,1.000,5,10,15,11,6,0,10,10,60
337,Tayshaun Prince\princta01,SF,25,DET,82,82,2898,455,999,.455,64,183,.350,391,816,.479,.487,182,238,.765,104,242,346,186,62,39,91,96,1156
338,Laron Profit\profila01,SG,28,LAL,25,1,279,40,84,.476,3,18,.167,37,66,.561,.494,21,24,.875,8,35,43,15,11,5,24,25,104
339,Joel Przybilla\przybjo01,C,26,POR,56,52,1395,131,239,.548,0,0,,131,239,.548,.548,82,154,.532,146,245,391,43,20,130,76,149,344
340,Vladimir Radmanović\radmavl01,PF,25,TOT,77,27,1974,262,643,.407,138,354,.390,124,289,.429,.515,93,114,.816,64,294,358,136,61,29,93,210,755
340,Vladimir Radmanović\radmavl01,PF,25,SEA,47,16,1089,154,384,.401,72,196,.367,82,188,.436,.495,55,62,.887,39,148,187,72,32,15,53,130,435
340,Vladimir Radmanović\radmavl01,PF,25,LAC,30,11,885,108,259,.417,66,158,.418,42,101,.416,.544,38,52,.731,25,146,171,64,29,14,40,80,320
341,Shavlik Randolph\randosh01,PF,22,PHI,57,1,487,44,97,.454,0,0,,44,97,.454,.454,43,71,.606,55,78,133,19,19,12,21,83,131
342,Zach Randolph\randoza01,PF,24,POR,74,71,2545,536,1229,.436,16,55,.291,520,1174,.443,.443,245,343,.714,193,399,592,144,57,14,165,185,1333
343,Theo Ratliff\ratlith01,C,32,POR,55,19,1301,108,189,.571,0,0,,108,189,.571,.571,54,83,.651,89,190,279,28,18,88,47,143,270
344,Željko Rebrača\rebraze01,C,33,LAC,29,2,412,52,96,.542,0,0,,52,96,.542,.542,31,41,.756,13,51,64,9,5,19,24,59,135
345,Michael Redd\reddmi01,SG,26,MIL,80,80,3130,682,1516,.450,163,413,.395,519,1103,.471,.504,501,571,.877,78,264,342,229,95,5,170,157,2028
346,Justin Reed\reedju01,SF,24,TOT,72,6,997,119,295,.403,0,1,.000,119,294,.405,.403,87,120,.725,53,71,124,41,23,15,52,163,325
346,Justin Reed\reedju01,SF,24,BOS,32,0,291,25,74,.338,0,0,,25,74,.338,.338,25,40,.625,13,16,29,7,5,4,15,45,75
346,Justin Reed\reedju01,SF,24,MIN,40,6,706,94,221,.425,0,1,.000,94,220,.427,.425,62,80,.775,40,55,95,34,18,11,37,118,250
347,Jason Richardson\richaja01,SG,25,GSW,75,75,2877,641,1438,.446,183,477,.384,458,961,.477,.509,276,410,.673,105,333,438,232,97,37,167,206,1741
348,Quentin Richardson\richaqu01,SF,25,NYK,55,43,1442,163,459,.355,64,188,.340,99,271,.365,.425,61,91,.670,65,165,230,88,39,6,56,134,451
349,Luke Ridnour\ridnolu01,PG,24,SEA,79,77,2625,334,799,.418,43,149,.289,291,650,.448,.445,199,227,.877,47,188,235,550,123,22,162,178,910
350,Anthony Roberson\roberan02,PG,22,MEM,16,0,88,14,31,.452,5,10,.500,9,21,.429,.532,2,2,1.000,0,6,6,5,1,0,3,6,35
351,Lawrence Roberts\roberla01,C,23,MEM,33,0,181,20,44,.455,0,2,.000,20,42,.476,.455,11,23,.478,26,23,49,5,8,2,5,30,51
352,Bernard Robinson\robinbe01,SF,25,CHA,66,18,1303,157,365,.430,2,21,.095,155,344,.451,.433,106,134,.791,62,157,219,77,81,10,74,141,422
353,Clifford Robinson\robincl02,PF,39,NJN,80,13,1863,219,513,.427,60,175,.343,159,338,.470,.485,52,79,.658,55,212,267,89,44,40,62,206,550
354,Nate Robinson\robinna01,PG,21,NYK,72,26,1544,230,565,.407,58,146,.397,172,419,.411,.458,152,202,.752,56,111,167,147,59,1,114,201,670
355,Jalen Rose\roseja01,SF-SG,33,TOT,72,45,1983,290,685,.423,59,172,.343,231,513,.450,.466,248,318,.780,28,183,211,181,30,13,115,156,887
355,Jalen Rose\roseja01,SF,33,TOR,46,22,1236,180,446,.404,31,115,.270,149,331,.450,.438,166,217,.765,15,114,129,113,20,10,65,101,557
355,Jalen Rose\roseja01,SG,33,NYK,26,23,747,110,239,.460,28,57,.491,82,182,.451,.519,82,101,.812,13,69,82,68,10,3,50,55,330
356,Malik Rose\rosema01,PF,31,NYK,72,35,1119,105,281,.374,1,1,1.000,104,280,.371,.375,107,137,.781,84,175,259,67,43,14,80,145,318
357,Quinton Ross\rossqu01,SF,24,LAC,67,45,1515,130,308,.422,0,7,.000,130,301,.432,.422,57,75,.760,38,132,170,79,51,16,47,155,317
358,Michael Ruffin\ruffimi01,C,29,WAS,76,4,1010,34,77,.442,0,2,.000,34,75,.453,.442,37,74,.500,122,149,271,27,33,31,38,179,105
359,Kareem Rush\rushka01,SG,25,CHA,47,25,1111,181,469,.386,57,164,.348,124,305,.407,.447,55,77,.714,18,85,103,50,38,13,65,79,474
360,Bryon Russell\russebr01,SF,35,DEN,1,0,3,0,0,,0,0,,0,0,,,0,0,,0,1,1,1,0,0,0,0,0
361,John Salmons\salmojo01,SG,26,PHI,82,24,2059,219,521,.420,26,87,.299,193,434,.445,.445,155,200,.775,48,172,220,223,73,13,125,178,619
362,Jamal Sampson\sampsja01,PF,22,SAC,12,0,39,5,7,.714,0,0,,5,7,.714,.714,0,2,.000,5,13,18,5,0,4,0,5,10
363,Melvin Sanders\sandeme01,SG,25,SAS,16,0,113,16,33,.485,2,3,.667,14,30,.467,.515,7,10,.700,4,19,23,3,5,0,8,20,41
364,Brian Scalabrine\scalabr01,PF,27,BOS,71,1,938,74,193,.383,31,87,.356,43,106,.406,.464,26,36,.722,27,87,114,51,21,19,50,127,205
365,Alex Scales\scaleal01,SG,27,SAS,1,0,0,0,0,,0,0,,0,0,,,0,0,,0,0,0,0,0,0,0,0,0
366,Luke Schenscher\schenlu01,C,23,CHI,20,0,149,16,26,.615,0,0,,16,26,.615,.615,4,13,.308,8,21,29,7,1,3,5,21,36
367,Ha Seung-Jin\seungha01,C,20,POR,27,4,212,18,31,.581,0,0,,18,31,.581,.581,8,17,.471,14,35,49,1,3,8,14,41,44
368,Wayne Simien\simiewa01,PF,22,MIA,43,2,414,58,120,.483,0,0,,58,120,.483,.483,30,34,.882,38,50,88,7,13,1,24,70,146
369,Bobby Simmons\simmobo01,SF,25,MIL,75,74,2538,366,808,.453,105,250,.420,261,558,.468,.518,165,200,.825,91,242,333,172,86,21,123,254,1002
370,James Singleton\singlja01,SF,24,LAC,59,10,753,77,151,.510,10,20,.500,67,131,.511,.543,39,50,.780,63,134,197,29,19,21,28,95,203
371,Brian Skinner\skinnbr01,PF-C,29,TOT,65,5,944,82,160,.513,0,0,,82,160,.513,.513,27,56,.482,76,152,228,30,25,43,45,119,191
371,Brian Skinner\skinnbr01,PF,29,SAC,38,0,429,38,69,.551,0,0,,38,69,.551,.551,12,27,.444,30,71,101,17,11,20,18,54,88
371,Brian Skinner\skinnbr01,C,29,POR,27,5,515,44,91,.484,0,0,,44,91,.484,.484,15,29,.517,46,81,127,13,14,23,27,65,103
372,Charles Smith\smithch04,SG,30,TOT,22,4,210,30,72,.417,15,38,.395,15,34,.441,.521,5,8,.625,3,13,16,9,5,6,4,28,80
372,Charles Smith\smithch04,SG,30,POR,21,4,208,30,71,.423,15,37,.405,15,34,.441,.528,5,8,.625,3,13,16,9,5,6,4,27,80
372,Charles Smith\smithch04,SG,30,DEN,1,0,2,0,1,.000,0,1,.000,0,0,,.000,0,0,,0,0,0,0,0,0,0,1,0
373,Donta Smith\smithdo04,SG,22,ATL,23,0,127,15,27,.556,2,4,.500,13,23,.565,.593,6,12,.500,3,11,14,9,8,0,4,20,38
374,J.R. Smith\smithjr01,SG,20,NOK,55,25,989,144,366,.393,52,140,.371,92,226,.407,.464,83,101,.822,19,91,110,58,37,4,54,90,423
375,Joe Smith\smithjo02,PF,30,MIL,44,5,887,145,305,.475,0,2,.000,145,303,.479,.475,89,115,.774,83,147,230,31,24,13,40,120,379
376,Josh Smith\smithjo03,SF,20,ATL,80,73,2559,329,774,.425,34,110,.309,295,664,.444,.447,210,292,.719,176,355,531,191,64,208,162,260,902
377,Eric Snow\snower01,PG,32,CLE,82,82,2351,163,399,.409,1,10,.100,162,389,.416,.410,64,93,.688,38,160,198,346,76,19,116,218,391
378,Kirk Snyder\snydeki01,SG,22,NOK,68,45,1310,205,453,.453,46,129,.357,159,324,.491,.503,86,117,.735,55,106,161,102,29,23,70,106,542
379,Darius Songaila\songada01,PF,27,CHI,62,7,1329,236,491,.481,2,5,.400,234,486,.481,.483,94,115,.817,76,170,246,88,35,16,85,157,568
380,Pape Sow\sowpa01,C,24,TOR,42,25,590,53,123,.431,0,0,,53,123,.431,.431,41,57,.719,54,92,146,8,21,19,30,118,147
381,Jerry Stackhouse\stackje01,SG,31,DAL,55,11,1525,242,603,.401,36,130,.277,206,473,.436,.431,195,221,.882,32,121,153,160,37,10,121,96,715
382,DeShawn Stevenson\stevede01,SG,24,ORL,82,82,2648,359,781,.460,2,15,.133,357,766,.466,.461,180,242,.744,59,182,241,160,58,17,123,178,900
383,Peja Stojaković\stojape01,SF,28,TOT,71,71,2601,445,1018,.437,162,404,.401,283,614,.461,.517,238,260,.915,79,336,415,136,45,10,103,171,1290
383,Peja Stojaković\stojape01,SF,28,SAC,31,31,1147,171,424,.403,71,179,.397,100,245,.408,.487,98,105,.933,34,131,165,68,19,2,51,82,511
383,Peja Stojaković\stojape01,SF,28,IND,40,40,1454,274,594,.461,91,225,.404,183,369,.496,.538,140,155,.903,45,205,250,68,26,8,52,89,779
384,Awvee Storey\storeaw01,SF,28,WAS,25,1,116,16,41,.390,3,7,.429,13,34,.382,.427,8,14,.571,8,14,22,4,3,1,5,22,43
385,Damon Stoudamire\stoudda01,PG,32,MEM,27,27,862,114,287,.397,36,104,.346,78,183,.426,.460,53,62,.855,23,72,95,128,19,1,55,49,317
386,Salim Stoudamire\stoudsa01,SG,23,ATL,61,1,1236,204,492,.415,82,216,.380,122,276,.442,.498,99,110,.900,12,104,116,75,27,3,82,118,589
387,Amar'e Stoudemire\stoudam01,C,23,PHO,3,3,50,9,27,.333,0,1,.000,9,26,.346,.333,8,9,.889,6,10,16,2,1,3,1,4,26
388,Mike Sweetney\sweetmi01,C,23,CHI,66,44,1222,200,444,.450,0,0,,200,444,.450,.450,133,204,.652,118,232,350,59,19,56,95,209,533
389,Robert Swift\swiftro01,C,20,SEA,47,20,987,124,241,.515,0,0,,124,241,.515,.515,53,91,.582,94,170,264,8,15,56,49,142,301
390,Stromile Swift\swiftst01,C,26,HOU,66,5,1344,225,458,.491,0,2,.000,225,456,.493,.491,136,209,.651,103,188,291,25,38,50,91,198,586
391,Wally Szczerbiak\szczewa02,SF,28,TOT,72,71,2729,493,1012,.487,102,255,.400,391,757,.517,.538,278,310,.897,77,236,313,213,40,19,136,150,1366
391,Wally Szczerbiak\szczewa02,SF,28,MIN,40,40,1555,292,590,.495,58,143,.406,234,447,.523,.544,163,182,.896,36,154,190,112,21,15,86,90,805
391,Wally Szczerbiak\szczewa02,SF,28,BOS,32,31,1174,201,422,.476,44,112,.393,157,310,.506,.528,115,128,.898,41,82,123,101,19,4,50,60,561
392,Chris Taft\taftch01,C,20,GSW,17,0,144,23,38,.605,0,0,,23,38,.605,.605,1,6,.167,19,17,36,2,2,7,2,25,47
393,Donell Taylor\taylodo01,SG,23,WAS,51,1,465,53,136,.390,4,17,.235,49,119,.412,.404,30,43,.698,16,37,53,45,30,4,34,47,140
394,Maurice Taylor\tayloma01,PF,29,NYK,67,13,1210,182,389,.468,0,1,.000,182,388,.469,.468,58,83,.699,65,164,229,53,21,14,103,177,422
395,Sebastian Telfair\telfase01,PG,20,POR,68,30,1641,228,578,.394,57,162,.352,171,416,.411,.444,130,175,.743,19,101,120,247,66,6,115,167,643
396,Jason Terry\terryja01,PG,28,DAL,80,80,2798,516,1099,.470,171,416,.411,345,683,.505,.547,168,210,.800,31,127,158,306,100,27,135,196,1371
397,Billy Thomas\thomabi01,SG,30,WAS,17,0,131,13,40,.325,10,30,.333,3,10,.300,.450,2,2,1.000,5,9,14,9,10,1,6,19,38
398,Etan Thomas\thomaet01,C,27,WAS,71,9,1121,131,246,.533,0,0,,131,246,.533,.533,75,125,.600,99,180,279,14,20,68,51,148,337
399,James Thomas\thomaja02,PF,25,TOT,22,0,150,10,19,.526,0,0,,10,19,.526,.526,8,14,.571,12,27,39,1,0,3,7,35,28
399,James Thomas\thomaja02,PF,25,PHI,15,0,124,7,13,.538,0,0,,7,13,.538,.538,8,14,.571,8,23,31,1,0,3,7,32,22
399,James Thomas\thomaja02,PF,25,CHI,7,0,26,3,6,.500,0,0,,3,6,.500,.500,0,0,,4,4,8,0,0,0,0,3,6
400,John Thomas\thomajo02,C,30,TOT,16,0,127,6,15,.400,0,0,,6,15,.400,.400,3,4,.750,10,10,20,2,3,2,8,17,15
400,John Thomas\thomajo02,C,30,MEM,3,0,25,2,2,1.000,0,0,,2,2,1.000,1.000,0,0,,0,0,0,1,0,1,2,3,4
400,John Thomas\thomajo02,C,30,ATL,11,0,66,3,7,.429,0,0,,3,7,.429,.429,3,4,.750,3,7,10,1,2,0,4,10,9
400,John Thomas\thomajo02,C,30,NJN,2,0,36,1,6,.167,0,0,,1,6,.167,.167,0,0,,7,3,10,0,1,1,2,4,2
401,Kenny Thomas\thomake01,PF,28,SAC,82,55,2293,305,604,.505,0,1,.000,305,603,.506,.505,138,204,.676,199,419,618,168,72,39,135,196,748
402,Kurt Thomas\thomaku01,C,33,PHO,53,50,1411,190,391,.486,0,0,,190,391,.486,.486,75,92,.815,102,313,415,57,23,54,57,193,455
403,Tim Thomas\thomati01,PF-SF,28,TOT,29,10,666,113,262,.431,46,111,.414,67,151,.444,.519,28,42,.667,22,109,131,20,16,7,33,78,300
403,Tim Thomas\thomati01,SF,28,CHI,3,0,32,6,16,.375,1,6,.167,5,10,.500,.406,0,0,,0,4,4,2,0,1,1,1,13
403,Tim Thomas\thomati01,PF,28,PHO,26,10,634,107,246,.435,45,105,.429,62,141,.440,.526,28,42,.667,22,105,127,18,16,6,32,77,287
404,Dijon Thompson\thompdi01,SG,22,PHO,10,0,43,11,25,.440,4,11,.364,7,14,.500,.520,2,2,1.000,4,7,11,1,3,1,2,6,28
405,Jamaal Tinsley\tinslja01,PG,27,IND,42,27,1122,158,386,.409,16,70,.229,142,316,.449,.430,58,91,.637,35,98,133,211,49,6,109,96,390
406,Jake Tsakalidis\tsakaja01,C,26,MEM,51,19,732,100,165,.606,0,0,,100,165,.606,.606,57,87,.655,78,134,212,13,14,32,39,107,257
407,Nikoloz Tskitishvili\tskitni01,SF-PF,22,TOT,17,0,99,13,37,.351,1,3,.333,12,34,.353,.365,9,14,.643,9,13,22,3,1,2,6,8,36
407,Nikoloz Tskitishvili\tskitni01,PF,22,MIN,5,0,13,1,4,.250,0,0,,1,4,.250,.250,1,2,.500,0,2,2,0,0,0,2,0,3
407,Nikoloz Tskitishvili\tskitni01,SF,22,PHO,12,0,86,12,33,.364,1,3,.333,11,30,.367,.379,8,12,.667,9,11,20,3,1,2,4,8,33
408,Ronny Turiaf\turiaro01,C,23,LAL,23,1,161,15,30,.500,0,0,,15,30,.500,.500,15,27,.556,11,26,37,8,3,10,7,30,45
409,Hedo Türkoğlu\turkohe01,SF,26,ORL,78,59,2615,398,877,.454,114,283,.403,284,594,.478,.519,255,296,.861,70,263,333,216,70,21,130,234,1165
410,Ime Udoka\udokaim01,SF,28,NYK,8,0,114,9,24,.375,1,3,.333,8,21,.381,.396,3,6,.500,3,14,17,6,1,0,2,8,22
411,Beno Udrih\udrihbe01,PG,23,SAS,54,3,586,106,233,.455,24,70,.343,82,163,.503,.506,39,50,.780,18,34,52,92,14,2,53,55,275
412,Nick Van Exel\vanexni01,PG,34,SAS,65,2,986,136,343,.397,55,154,.357,81,189,.429,.477,28,41,.683,6,85,91,123,16,3,57,60,355
413,Keith Van Horn\vanhoke01,SF,30,DAL,53,0,1090,164,387,.424,50,136,.368,114,251,.454,.488,94,113,.832,54,138,192,37,31,11,71,121,472
414,Anderson Varejão\varejan01,C,23,CLE,48,4,760,79,150,.527,0,1,.000,79,149,.530,.527,61,119,.513,77,158,235,19,31,19,27,118,219
415,Jacque Vaughn\vaughja01,SG,30,NJN,80,6,1234,107,245,.437,1,6,.167,106,239,.444,.439,59,81,.728,16,75,91,123,42,1,52,140,274
416,Charlie Villanueva\villach01,PF,21,TOR,81,36,2361,435,940,.463,70,214,.327,365,726,.503,.500,113,160,.706,181,340,521,88,60,63,99,247,1053
417,Jake Voskuhl\voskuja01,C,28,CHA,51,2,818,114,261,.437,1,3,.333,113,258,.438,.439,41,60,.683,62,121,183,39,26,23,33,157,270
418,Jackson Vroman\vromaja01,PF,24,NOK,41,2,406,26,66,.394,0,0,,26,66,.394,.394,21,44,.477,33,53,86,11,12,11,21,78,73
419,Sasha Vujačić\vujacsa01,PG,21,LAL,82,4,1449,108,312,.346,59,172,.343,49,140,.350,.441,46,52,.885,33,126,159,139,48,3,50,150,321
420,Dwyane Wade\wadedw01,SG,24,MIA,75,75,2892,699,1413,.495,13,76,.171,686,1337,.513,.499,629,803,.783,107,323,430,503,146,58,268,217,2040
421,Von Wafer\wafervo01,SG,20,LAL,16,0,73,6,38,.158,2,17,.118,4,21,.190,.184,6,8,.750,5,3,8,4,3,0,1,12,20
422,Antoine Walker\walkean02,PF,29,MIA,82,19,2199,391,898,.435,137,383,.358,254,515,.493,.512,81,129,.628,103,318,421,166,47,30,150,187,1000
423,Samaki Walker\walkesa01,PF,29,IND,7,0,22,0,2,.000,0,0,,0,2,.000,.000,2,2,1.000,0,3,3,0,0,1,2,7,2
424,Ben Wallace*\wallabe01,C,31,DET,82,82,2890,237,465,.510,0,4,.000,237,461,.514,.510,123,296,.416,301,622,923,158,146,181,88,164,597
425,Gerald Wallace\wallage01,SF,23,CHA,55,52,1895,317,589,.538,14,50,.280,303,539,.562,.550,188,306,.614,123,289,412,96,138,115,99,150,836
426,Rasheed Wallace\wallara01,PF,31,DET,80,80,2780,459,1067,.430,155,434,.357,304,633,.480,.503,136,183,.743,90,457,547,182,82,130,85,232,1209
427,Matt Walsh\walshma01,SG,23,MIA,2,0,3,1,1,1.000,0,0,,1,1,1.000,1.000,0,2,.000,0,0,0,0,0,0,1,0,2
428,Luke Walton\waltolu01,SF,25,LAL,69,6,1333,135,328,.412,18,55,.327,117,273,.429,.439,57,76,.750,88,159,247,156,41,15,78,119,345
429,Hakim Warrick\warriha01,PF,23,MEM,68,2,724,101,228,.443,0,0,,101,228,.443,.443,76,115,.661,43,101,144,30,14,21,56,113,278
430,Earl Watson\watsoea01,PG,26,TOT,70,10,1578,219,509,.430,110,272,.404,109,237,.460,.538,75,111,.676,24,134,158,289,68,10,136,159,623
430,Earl Watson\watsoea01,PG,26,DEN,46,10,975,121,282,.429,68,172,.395,53,110,.482,.550,37,59,.627,17,69,86,160,37,7,75,95,347
430,Earl Watson\watsoea01,PG,26,SEA,24,0,603,98,227,.432,42,100,.420,56,127,.441,.524,38,52,.731,7,65,72,129,31,3,61,64,276
431,Chris Webber*\webbech01,PF,32,PHI,75,75,2893,617,1422,.434,21,77,.273,596,1345,.443,.441,263,348,.756,184,557,741,256,103,62,182,219,1518
432,Martell Webster\webstma02,SF,19,POR,61,18,1070,139,348,.399,65,182,.357,74,166,.446,.493,61,71,.859,29,101,130,34,21,14,43,90,404
433,Bonzi Wells\wellsbo01,SG,29,SAC,52,41,1684,284,613,.463,10,45,.222,274,568,.482,.471,129,190,.679,142,259,401,144,94,25,126,156,707
434,Jiří Welsch\welscji01,SF,26,MIL,58,2,866,86,222,.387,14,49,.286,72,173,.416,.419,65,87,.747,22,89,111,62,34,1,41,65,251
435,David Wesley\wesleda01,SG,35,HOU,71,59,2372,226,561,.403,99,271,.365,127,290,.438,.491,151,187,.807,24,154,178,204,59,6,120,212,702
436,David West\westda01,PF,25,NOK,74,74,2526,530,1036,.512,3,11,.273,527,1025,.514,.513,199,236,.843,168,380,548,92,61,64,105,214,1262
437,Delonte West\westde01,PG,22,BOS,71,71,2418,333,684,.487,84,218,.385,249,466,.534,.548,86,101,.851,57,232,289,329,84,46,133,197,836
438,Robert Whaley\whalero01,C,23,UTA,23,0,212,23,57,.404,0,0,,23,57,.404,.404,3,6,.500,16,27,43,17,7,8,14,41,49
439,Chris Wilcox\wilcoch01,C-PF,23,TOT,77,24,1529,257,450,.571,0,2,.000,257,448,.574,.571,112,153,.732,118,292,410,52,33,34,72,183,626
439,Chris Wilcox\wilcoch01,C,23,LAC,48,1,657,90,168,.536,0,2,.000,90,166,.542,.536,38,59,.644,46,127,173,18,15,21,32,103,218
439,Chris Wilcox\wilcoch01,PF,23,SEA,29,23,872,167,282,.592,0,0,,167,282,.592,.592,74,94,.787,72,165,237,34,18,13,40,80,408
440,Damien Wilkins\wilkida02,SF,26,SEA,82,12,1525,193,435,.444,14,56,.250,179,379,.472,.460,136,162,.840,79,113,192,107,72,12,85,144,536
441,Mike Wilks\wilksmi01,PG,26,TOT,47,0,348,29,90,.322,3,19,.158,26,71,.366,.339,25,41,.610,9,30,39,32,14,1,24,34,86
441,Mike Wilks\wilksmi01,PG,26,CLE,37,0,243,17,59,.288,2,14,.143,15,45,.333,.305,6,12,.500,6,21,27,18,8,1,15,27,42
441,Mike Wilks\wilksmi01,PG,26,SEA,10,0,105,12,31,.387,1,5,.200,11,26,.423,.403,19,29,.655,3,9,12,14,6,0,9,7,44
442,Aaron Williams\williaa01,C,34,TOT,48,5,791,91,176,.517,0,0,,91,176,.517,.517,40,58,.690,64,117,181,17,17,21,30,138,222
442,Aaron Williams\williaa01,C,34,TOR,14,3,99,10,19,.526,0,0,,10,19,.526,.526,5,6,.833,5,10,15,1,4,3,5,28,25
442,Aaron Williams\williaa01,C,34,NOK,34,2,692,81,157,.516,0,0,,81,157,.516,.516,35,52,.673,59,107,166,16,13,18,25,110,197
443,Alvin Williams\willial02,PG,31,TOR,1,0,10,0,3,.000,0,2,.000,0,1,.000,.000,1,2,.500,0,3,3,0,0,0,0,0,1
444,Deron Williams\willide01,PG,21,UTA,80,47,2307,339,805,.421,91,219,.416,248,586,.423,.478,95,135,.704,35,159,194,359,60,17,145,233,864
445,Eric Williams\willier01,SF,33,TOR,28,11,352,29,75,.387,5,18,.278,24,57,.421,.420,28,38,.737,10,40,50,15,7,2,15,55,91
446,Jason Williams\willija02,PG,30,MIA,59,56,1874,268,606,.442,107,288,.372,161,318,.506,.531,85,98,.867,6,133,139,287,53,5,100,101,728
447,Lou Williams\willilo02,PG,19,PHI,30,0,145,23,52,.442,2,9,.222,21,43,.488,.462,8,13,.615,3,16,19,10,5,0,13,13,56
448,Marvin Williams\willima02,PF,19,ATL,79,7,1952,235,531,.443,13,53,.245,222,478,.464,.455,189,253,.747,122,261,383,63,48,24,83,227,672
449,Mo Williams\willima01,PG,23,MIL,58,12,1531,267,629,.424,73,191,.382,194,438,.443,.483,96,113,.850,30,113,143,230,52,7,105,146,703
450,Corliss Williamson\willico02,SF,32,SAC,37,0,362,43,103,.417,2,2,1.000,41,101,.406,.427,38,49,.776,21,46,67,14,7,4,30,56,126
451,Loren Woods\woodslo01,C,27,TOR,27,4,324,28,59,.475,0,1,.000,28,58,.483,.475,6,14,.429,44,66,110,4,9,23,16,49,62
452,Qyntel Woods\woodsqy01,SF,24,NYK,49,16,1013,129,254,.508,22,60,.367,107,194,.552,.551,49,76,.645,44,146,190,47,32,13,61,96,329
453,Metta World Peace\artesro01,SF,26,TOT,56,56,2207,350,867,.404,78,253,.308,272,614,.443,.449,206,305,.675,75,211,286,203,122,41,131,164,984
453,Metta World Peace\artesro01,SF,26,IND,16,16,603,109,237,.460,18,54,.333,91,183,.497,.498,74,121,.612,26,52,78,35,42,11,43,45,310
453,Metta World Peace\artesro01,SF,26,SAC,40,40,1604,241,630,.383,60,199,.302,181,431,.420,.430,132,184,.717,49,159,208,168,80,30,88,119,674
454,Antoine Wright\wrighan01,SG,21,NJN,39,0,370,29,81,.358,1,15,.067,28,66,.424,.364,11,22,.500,8,22,30,12,4,3,21,42,70
455,Bracey Wright\wrighbr02,SG,21,MIN,7,0,135,21,51,.412,6,17,.353,15,34,.441,.471,14,16,.875,3,15,18,5,1,0,8,8,62
456,Dorell Wright\wrighdo01,SF,20,MIA,20,2,132,20,43,.465,3,6,.500,17,37,.459,.500,15,17,.882,2,30,32,8,3,1,14,12,58
457,Lorenzen Wright\wrighlo02,C,30,MEM,78,58,1689,194,406,.478,0,2,.000,194,404,.480,.478,66,117,.564,142,253,395,48,52,46,67,201,454
458,Derrick Zimmerman\zimmede01,PG,24,NJN,2,0,32,2,3,.667,0,0,,2,3,.667,.667,0,0,,1,3,4,7,0,0,4,4,4