Rk,Player,Pos,Age,Tm,G,GS,MP,FG,FGA,FG%,3P,3PA,3P%,2P,2PA,2P%,eFG%,FT,FTA,FT%,ORB,DRB,TRB,AST,STL,BLK,TOV,PF,PTS
1,Shareef Abdur-Rahim\abdursh01,PF,31,SAC,6,0,51,3,14,.214,0,0,,3,14,.214,.214,4,4,1.000,6,4,10,4,1,0,1,9,10
2,Arron Afflalo\afflaar01,SG,22,DET,75,9,970,99,241,.411,10,48,.208,89,193,.461,.432,68,87,.782,36,101,137,52,31,8,34,83,276
3,Maurice Ager\agerma01,SG,23,TOT,26,3,165,21,65,.323,3,19,.158,18,46,.391,.346,6,12,.500,4,9,13,8,0,1,6,17,51
3,Maurice Ager\agerma01,SG,23,DAL,12,3,77,5,27,.185,0,8,.000,5,19,.263,.185,5,6,.833,1,3,4,4,0,1,3,11,15
3,Maurice Ager\agerma01,SG,23,NJN,14,0,88,16,38,.421,3,11,.273,13,27,.481,.461,1,6,.167,3,6,9,4,0,0,3,6,36
4,Blake Ahearn\ahearbl01,PG,23,MIA,12,0,177,15,57,.263,10,34,.294,5,23,.217,.351,30,31,.968,1,18,19,19,6,0,16,20,70
5,LaMarcus Aldridge\aldrila01,PF,22,POR,76,76,2649,561,1160,.484,1,7,.143,560,1153,.486,.484,227,298,.762,220,358,578,122,55,94,126,240,1350
6,Malik Allen\allenma01,PF,29,TOT,73,16,1096,157,327,.480,1,2,.500,156,325,.480,.482,23,25,.920,66,130,196,44,19,31,45,149,338
6,Malik Allen\allenma01,PF,29,NJN,48,12,763,124,261,.475,1,2,.500,123,259,.475,.477,12,13,.923,42,86,128,29,15,21,32,89,261
6,Malik Allen\allenma01,PF,29,DAL,25,4,333,33,66,.500,0,0,,33,66,.500,.500,11,12,.917,24,44,68,15,4,10,13,60,77
7,Ray Allen*\allenra02,SG,32,BOS,73,73,2624,439,986,.445,180,452,.398,259,534,.485,.537,215,237,.907,75,193,268,225,65,16,127,147,1273
8,Tony Allen\allento01,SG,26,BOS,75,11,1373,169,389,.434,18,57,.316,151,332,.455,.458,138,181,.762,34,134,168,114,62,21,109,168,494
9,Lance Allred\allrela01,C,26,CLE,3,0,10,1,4,.250,0,0,,1,4,.250,.250,1,2,.500,0,1,1,0,0,0,0,1,3
10,Morris Almond\almonmo01,SG,22,UTA,9,0,39,4,15,.267,1,4,.250,3,11,.273,.300,4,6,.667,0,2,2,3,1,0,2,5,13
11,Rafer Alston\alstora01,PG,31,HOU,74,74,2526,364,924,.394,143,407,.351,221,517,.427,.471,98,137,.715,28,232,260,392,98,18,160,139,969
12,Lou Amundson\amundlo01,PF,25,PHI,16,0,64,8,16,.500,0,0,,8,16,.500,.500,2,7,.286,7,5,12,0,1,1,2,13,18
13,Chris Andersen\anderch01,C,29,NOH,5,0,34,2,7,.286,0,0,,2,7,.286,.286,2,4,.500,2,7,9,0,0,4,1,6,6
14,Derek Anderson\anderde01,SG,33,CHA,28,0,396,47,125,.376,19,52,.365,28,73,.384,.452,28,38,.737,9,43,52,44,12,1,25,49,141
15,Carmelo Anthony\anthoca01,SF,23,DEN,77,77,2806,728,1481,.492,58,164,.354,670,1317,.509,.511,464,590,.786,178,393,571,259,98,39,253,253,1978
16,Joel Anthony\anthojo01,PF,25,MIA,24,1,498,28,60,.467,0,0,,28,60,.467,.467,29,49,.592,38,55,93,3,9,31,17,55,85
17,Gilbert Arenas\arenagi01,PG,26,WAS,13,8,425,78,196,.398,22,78,.282,56,118,.475,.454,74,96,.771,6,45,51,66,23,1,49,30,252
18,Trevor Ariza\arizatr01,SF,22,TOT,35,3,546,69,136,.507,5,18,.278,64,118,.542,.526,49,75,.653,30,78,108,44,31,11,23,45,192
18,Trevor Ariza\arizatr01,SF,22,ORL,11,0,115,14,31,.452,0,3,.000,14,28,.500,.452,8,15,.533,5,19,24,8,5,3,5,9,36
18,Trevor Ariza\arizatr01,SF,22,LAL,24,3,431,55,105,.524,5,15,.333,50,90,.556,.548,41,60,.683,25,59,84,36,26,8,18,36,156
19,Darrell Armstrong\armstda01,PG,39,NJN,50,2,549,40,110,.364,23,69,.333,17,41,.415,.468,20,30,.667,17,50,67,73,28,2,41,53,123
20,Hilton Armstrong\armsthi01,C,23,NOH,65,3,732,67,148,.453,0,0,,67,148,.453,.453,44,70,.629,65,98,163,23,15,34,59,130,178
21,Carlos Arroyo\arroyca01,PG,28,ORL,62,20,1269,157,348,.451,29,84,.345,128,264,.485,.493,87,102,.853,10,103,113,219,26,2,77,85,430
22,Chucky Atkins\atkinch01,SG,33,DEN,24,0,352,42,122,.344,25,79,.316,17,43,.395,.447,4,9,.444,3,28,31,47,9,1,10,27,113
23,James Augustine\augusja01,PF,23,ORL,25,0,149,18,34,.529,0,0,,18,34,.529,.529,4,8,.500,16,14,30,2,5,2,6,18,40
24,Kelenna Azubuike\azubuke01,SG,24,GSW,81,17,1732,261,587,.445,71,195,.364,190,392,.485,.505,99,138,.717,107,217,324,75,45,34,58,159,692
25,Renaldo Balkman\balkmre01,SF,23,NYK,65,0,952,91,186,.489,1,12,.083,90,174,.517,.492,41,95,.432,83,133,216,40,44,30,37,132,224
26,Marcus Banks\banksma01,PG,26,TOT,36,3,569,86,191,.450,40,102,.392,46,89,.517,.555,27,35,.771,4,41,45,61,14,13,37,65,239
26,Marcus Banks\banksma01,PG,26,PHO,24,1,310,44,109,.404,25,65,.385,19,44,.432,.518,12,16,.750,3,17,20,25,8,8,16,38,125
26,Marcus Banks\banksma01,PG,26,MIA,12,2,259,42,82,.512,15,37,.405,27,45,.600,.604,15,19,.789,1,24,25,36,6,5,21,27,114
27,Leandro Barbosa\barbole01,SG,25,PHO,82,12,2421,472,1021,.462,164,422,.389,308,599,.514,.543,175,213,.822,40,191,231,216,75,18,117,195,1283
28,J.J. Barea\bareajo01,PG,23,DAL,44,9,460,71,170,.418,21,54,.389,50,116,.431,.479,28,35,.800,4,43,47,58,14,1,35,48,191
29,Andrea Bargnani\bargnan01,PF,22,TOR,78,53,1861,280,725,.386,90,261,.345,190,464,.409,.448,142,169,.840,50,238,288,89,23,37,88,211,792
30,Matt Barnes\barnema02,PF,27,GSW,73,18,1414,187,442,.423,53,181,.293,134,261,.513,.483,59,79,.747,94,230,324,139,48,36,85,159,486
31,Andre Barrett\barrean01,PG,25,LAC,4,0,25,2,5,.400,1,3,.333,1,2,.500,.500,1,2,.500,0,1,1,7,0,0,1,1,6
32,Earl Barron\barroea01,C,26,MIA,46,15,889,132,327,.404,1,13,.077,131,314,.417,.405,61,87,.701,67,131,198,29,19,8,48,114,326
33,Brent Barry\barrybr01,SF,36,SAS,31,1,554,77,160,.481,48,112,.429,29,48,.604,.631,19,20,.950,12,43,55,54,17,3,18,43,221
34,Brandon Bass\bassbr01,C,22,DAL,79,1,1557,246,493,.499,0,4,.000,246,489,.503,.499,162,197,.822,120,227,347,58,22,48,82,150,654
35,Maceo Baston\bastoma01,PF,32,TOR,15,2,103,17,25,.680,0,0,,17,25,.680,.680,7,10,.700,9,17,26,3,2,4,4,20,41
36,Shane Battier\battish01,SF,29,HOU,80,78,2907,265,619,.428,139,369,.377,126,250,.504,.540,75,101,.743,131,276,407,155,77,90,78,196,744
37,Marco Belinelli\belinma01,SG,21,GSW,33,0,241,36,93,.387,16,41,.390,20,52,.385,.473,7,9,.778,3,11,14,15,5,0,12,15,95
38,Charlie Bell\bellch01,SG,28,MIL,68,5,1628,185,486,.381,74,217,.341,111,269,.413,.457,70,87,.805,31,136,167,210,52,2,76,121,514
39,Raja Bell\bellra01,SG,31,PHO,75,75,2646,317,753,.421,176,439,.401,141,314,.449,.538,79,91,.868,47,227,274,168,54,27,65,220,889
40,Mike Bibby\bibbymi01,PG,29,TOT,48,44,1573,248,603,.411,93,248,.375,155,355,.437,.488,78,100,.780,16,144,160,290,54,4,119,97,667
40,Mike Bibby\bibbymi01,PG,29,SAC,15,12,473,78,192,.406,24,61,.393,54,131,.412,.469,23,31,.742,11,45,56,75,19,2,38,34,203
40,Mike Bibby\bibbymi01,PG,29,ATL,33,32,1100,170,411,.414,69,187,.369,101,224,.451,.498,55,69,.797,5,99,104,215,35,2,81,63,464
41,Andris Biedriņš\biedran01,C,21,GSW,76,59,2078,340,543,.626,0,0,,340,543,.626,.626,116,187,.620,256,488,744,75,56,94,85,262,796
42,Chauncey Billups\billuch01,PG,31,DET,78,78,2522,393,877,.448,137,342,.401,256,535,.479,.526,401,437,.918,42,170,212,529,101,17,160,130,1324
43,Steve Blake\blakest01,PG,27,POR,81,78,2424,261,640,.408,121,298,.406,140,342,.409,.502,49,64,.766,31,164,195,413,55,4,113,133,692
44,Andray Blatche\blatcan01,PF,21,WAS,82,15,1675,254,536,.474,3,13,.231,251,523,.480,.477,107,154,.695,164,261,425,92,53,114,112,258,618
45,Mark Blount\blounma01,C,32,MIA,69,46,1542,238,515,.462,17,44,.386,221,471,.469,.479,88,138,.638,69,194,263,41,33,34,70,133,581
46,Keith Bogans\boganke01,SG,27,ORL,82,35,2198,241,588,.410,148,409,.362,93,179,.520,.536,81,110,.736,42,224,266,104,59,10,53,164,711
47,Andrew Bogut\bogutan01,C,23,MIL,78,78,2720,465,910,.511,0,7,.000,465,903,.515,.511,189,322,.587,245,518,763,199,64,135,172,254,1119
48,Matt Bonner\bonnema01,PF,27,SAS,68,3,853,121,291,.416,46,137,.336,75,154,.487,.495,38,44,.864,53,139,192,32,14,17,39,111,326
49,Josh Boone\boonejo01,PF,23,NJN,70,53,1773,238,434,.548,0,0,,238,434,.548,.548,99,217,.456,192,317,509,55,36,61,68,155,575
50,Calvin Booth\boothca01,C,31,PHI,31,0,204,9,27,.333,0,0,,9,27,.333,.333,6,10,.600,6,32,38,8,6,18,4,35,24
51,Carlos Boozer\boozeca01,PF,26,UTA,81,81,2827,709,1297,.547,0,1,.000,709,1296,.547,.547,290,393,.738,197,647,844,233,100,41,210,293,1708
52,Chris Bosh*\boshch01,C,23,TOR,67,67,2425,507,1027,.494,10,25,.400,497,1002,.496,.499,472,559,.844,174,409,583,171,63,67,153,157,1496
53,Bruce Bowen\bowenbr01,SF,36,SAS,81,81,2448,174,428,.407,90,215,.419,84,213,.394,.512,45,69,.652,33,201,234,91,54,22,46,177,483
54,Ryan Bowen\bowenry01,SF,32,NOH,53,4,660,49,100,.490,0,1,.000,49,99,.495,.490,16,29,.552,55,45,100,25,32,11,15,77,114
55,Earl Boykins\boykiea01,PG,31,CHA,36,0,577,61,172,.355,14,44,.318,47,128,.367,.395,49,59,.831,9,25,34,96,13,0,41,21,185
56,Elton Brand\brandel01,PF,28,LAC,8,6,274,52,114,.456,0,0,,52,114,.456,.456,37,47,.787,21,43,64,16,3,15,17,21,141
57,Corey Brewer\breweco01,SF,21,MIN,79,35,1803,182,486,.374,7,36,.194,175,450,.389,.382,88,110,.800,82,210,292,111,76,25,89,188,459
58,Ronnie Brewer\brewero02,SG,22,UTA,76,76,2088,354,634,.558,11,50,.220,343,584,.587,.567,195,257,.759,97,121,218,134,129,19,69,110,914
59,Primož Brezec\brezepr01,C,28,TOT,50,18,475,44,94,.468,0,0,,44,94,.468,.468,24,40,.600,30,51,81,11,3,7,24,83,112
59,Primož Brezec\brezepr01,C,28,CHA,20,18,267,17,43,.395,0,0,,17,43,.395,.395,3,5,.600,14,30,44,6,0,3,15,35,37
59,Primož Brezec\brezepr01,C,28,DET,17,0,98,10,13,.769,0,0,,10,13,.769,.769,7,14,.500,7,12,19,4,2,2,5,23,27
59,Primož Brezec\brezepr01,C,28,TOR,13,0,110,17,38,.447,0,0,,17,38,.447,.447,14,21,.667,9,9,18,1,1,2,4,25,48
60,Aaron Brooks\brookaa01,PG,23,HOU,51,0,608,93,225,.413,36,109,.330,57,116,.491,.493,42,49,.857,13,43,56,87,13,5,44,69,264
61,Andre Brown\brownan01,PF,26,MEM,33,1,286,39,78,.500,0,0,,39,78,.500,.500,22,49,.449,37,55,92,8,7,4,14,38,100
62,Devin Brown\brownde02,SG,29,CLE,78,20,1762,217,531,.409,45,146,.308,172,385,.447,.451,107,142,.754,65,198,263,175,52,7,99,144,586
63,Kwame Brown\brownkw01,C,25,TOT,38,15,713,72,142,.507,0,0,,72,142,.507,.507,40,98,.408,51,137,188,45,22,23,51,82,184
63,Kwame Brown\brownkw01,C,25,LAL,23,14,509,53,103,.515,0,0,,53,103,.515,.515,26,64,.406,31,100,131,28,16,19,37,58,132
63,Kwame Brown\brownkw01,C,25,MEM,15,1,204,19,39,.487,0,0,,19,39,.487,.487,14,34,.412,20,37,57,17,6,4,14,24,52
64,P.J. Brown\brownpj01,PF,38,BOS,18,0,209,14,41,.341,0,1,.000,14,40,.350,.341,11,16,.688,29,39,68,10,5,8,10,29,39
65,Shannon Brown\brownsh01,SG,22,TOT,21,4,240,44,126,.349,9,30,.300,35,96,.365,.385,17,29,.586,6,14,20,17,11,3,24,29,114
65,Shannon Brown\brownsh01,SG,22,CLE,15,4,218,41,111,.369,9,29,.310,32,82,.390,.410,14,23,.609,5,13,18,17,10,1,19,27,105
65,Shannon Brown\brownsh01,SG,22,CHI,6,0,22,3,15,.200,0,1,.000,3,14,.214,.200,3,6,.500,1,1,2,0,1,2,5,2,9
66,Kobe Bryant*\bryanko01,SG,29,LAL,82,82,3192,775,1690,.459,150,415,.361,625,1275,.490,.503,623,742,.840,94,423,517,441,151,40,257,227,2323
67,Greg Buckner\buckngr01,SG,31,MIN,31,4,520,45,117,.385,15,50,.300,30,67,.448,.449,19,22,.864,10,55,65,39,21,2,29,63,124
68,Caron Butler\butleca01,SF,27,WAS,58,58,2314,439,943,.466,66,185,.357,373,758,.492,.501,236,262,.901,93,295,388,284,128,20,150,160,1180
69,Rasual Butler\butlera01,SF,28,NOH,51,8,875,91,260,.350,44,133,.331,47,127,.370,.435,26,31,.839,16,84,100,36,15,21,10,66,252
70,Andrew Bynum\bynuman01,C,20,LAL,35,25,1008,189,297,.636,0,0,,189,297,.636,.636,82,118,.695,105,251,356,61,12,72,52,98,460
71,José Calderón\caldejo01,PG,26,TOR,82,56,2484,367,707,.519,79,184,.429,288,523,.551,.575,109,120,.908,34,202,236,678,87,6,126,134,922
72,Marcus Camby\cambyma01,C,33,DEN,79,79,2758,286,635,.450,6,20,.300,280,615,.455,.455,143,202,.708,230,807,1037,259,85,285,118,216,721
73,Brian Cardinal\cardibr01,PF,30,MEM,37,1,440,43,126,.341,25,81,.309,18,45,.400,.440,13,19,.684,26,70,96,22,10,2,23,62,124
74,Rodney Carney\carnero01,SF,23,PHI,70,6,1039,158,392,.403,38,120,.317,120,272,.441,.452,55,81,.679,50,99,149,32,39,23,34,96,409
75,Matt Carroll\carroma01,SG,27,CHA,80,18,2016,252,589,.428,105,241,.436,147,348,.422,.517,111,138,.804,33,193,226,73,46,19,58,187,720
76,Anthony Carter\cartean01,PG,32,DEN,70,67,1960,218,476,.458,45,129,.349,173,347,.499,.505,64,85,.753,27,173,200,388,107,28,124,172,545
77,Vince Carter\cartevi01,SG,31,NJN,76,72,2959,587,1287,.456,98,273,.359,489,1014,.482,.494,350,429,.816,112,341,453,389,93,33,181,241,1622
78,Sam Cassell\cassesa01,PG,38,TOT,55,34,1274,233,532,.438,23,76,.303,210,456,.461,.460,127,144,.882,17,119,136,214,37,6,97,98,616
78,Sam Cassell\cassesa01,PG,38,LAC,38,33,975,183,402,.455,14,54,.259,169,348,.486,.473,106,119,.891,12,93,105,179,28,3,78,69,486
78,Sam Cassell\cassesa01,PG,38,BOS,17,1,299,50,130,.385,9,22,.409,41,108,.380,.419,21,25,.840,5,26,31,35,9,3,19,29,130
79,Tyson Chandler\chandty01,C,25,NOH,79,79,2783,377,605,.623,0,1,.000,377,604,.624,.623,175,295,.593,322,606,928,81,45,84,136,243,929
80,Wilson Chandler\chandwi01,SF,20,NYK,35,16,685,106,242,.438,9,30,.300,97,212,.458,.457,34,54,.630,38,89,127,33,15,16,27,83,255
81,Josh Childress\childjo01,SF,24,ATL,76,0,2274,327,573,.571,22,60,.367,305,513,.595,.590,222,275,.807,174,199,373,117,71,43,98,129,898
82,Jarron Collins\collija03,C,29,UTA,70,9,702,36,82,.439,0,1,.000,36,81,.444,.439,46,74,.622,40,76,116,37,10,6,22,106,118
83,Jason Collins\collija04,C,29,TOT,74,26,1172,53,113,.469,0,1,.000,53,112,.473,.469,34,74,.459,64,114,178,25,23,25,48,194,140
83,Jason Collins\collija04,C,29,NJN,43,23,684,23,54,.426,0,0,,23,54,.426,.426,14,36,.389,35,54,89,19,11,8,23,110,60
83,Jason Collins\collija04,C,29,MEM,31,3,488,30,59,.508,0,1,.000,30,58,.517,.508,20,38,.526,29,60,89,6,12,17,25,84,80
84,Mardy Collins\collima01,SG,23,NYK,46,8,634,57,175,.326,8,32,.250,49,143,.343,.349,23,38,.605,19,56,75,89,24,8,56,56,145
85,Nick Collison\collini01,PF,27,SEA,78,35,2223,322,641,.502,0,2,.000,322,639,.504,.502,123,167,.737,254,476,730,113,47,60,118,250,767
86,Mike Conley\conlemi01,PG,20,MEM,53,46,1381,189,442,.428,30,91,.330,159,351,.453,.462,90,123,.732,21,118,139,222,44,2,89,85,498
87,Brian Cook\cookbr01,PF,27,TOT,51,2,629,88,234,.376,43,115,.374,45,119,.378,.468,19,21,.905,28,81,109,27,13,12,39,93,238
87,Brian Cook\cookbr01,PF,27,LAL,6,2,70,4,21,.190,2,10,.200,2,11,.182,.238,4,4,1.000,4,6,10,3,2,0,4,6,14
87,Brian Cook\cookbr01,PF,27,ORL,45,0,559,84,213,.394,41,105,.390,43,108,.398,.491,15,17,.882,24,75,99,24,11,12,35,87,224
88,Daequan Cook\cookda02,SG,20,MIA,59,19,1441,196,514,.381,79,238,.332,117,276,.424,.458,47,57,.825,20,157,177,75,23,9,63,157,518
89,Jamal Crawford\crawfja01,SG,27,NYK,80,80,3190,570,1391,.410,176,494,.356,394,897,.439,.473,329,381,.864,37,170,207,398,81,17,192,144,1645
90,Javaris Crittenton\crittja01,SG,20,TOT,50,0,679,98,233,.421,10,37,.270,88,196,.449,.442,72,104,.692,27,83,110,51,19,2,55,47,278
90,Javaris Crittenton\crittja01,SG,20,LAL,22,0,171,26,53,.491,1,3,.333,25,50,.500,.500,19,28,.679,7,14,21,18,7,0,22,12,72
90,Javaris Crittenton\crittja01,SG,20,MEM,28,0,508,72,180,.400,9,34,.265,63,146,.432,.425,53,76,.697,20,69,89,33,12,2,33,35,206
91,Austin Croshere\croshau01,PF,32,GSW,44,0,457,61,137,.445,22,61,.361,39,76,.513,.526,29,32,.906,33,71,104,30,8,6,22,60,173
92,Eddy Curry\curryed01,C,25,NYK,59,58,1530,297,544,.546,0,0,,297,544,.546,.546,187,300,.623,111,164,275,32,14,29,126,157,781
93,Samuel Dalembert\dalemsa01,C,26,PHI,82,82,2724,339,661,.513,0,1,.000,339,660,.514,.513,186,263,.707,304,545,849,45,40,192,155,269,864
94,Erick Dampier\dampier01,C,32,DAL,72,64,1755,178,277,.643,0,0,,178,277,.643,.643,84,146,.575,207,332,539,63,24,106,80,226,440
95,Antonio Daniels\daniean01,PG,32,WAS,71,63,2161,205,447,.459,17,74,.230,188,373,.504,.478,170,219,.776,23,180,203,340,69,2,91,78,597
96,Marquis Daniels\daniema01,SG,27,IND,74,1,1546,241,561,.430,27,102,.265,214,459,.466,.454,97,139,.698,66,146,212,137,79,18,112,121,606
97,Jermareo Davidson\davidje01,SF,23,CHA,38,2,322,51,125,.408,0,0,,51,125,.408,.408,18,28,.643,21,41,62,13,7,15,17,46,120
98,Baron Davis\davisba01,PG,28,GSW,82,82,3196,650,1526,.426,173,525,.330,477,1001,.477,.483,318,424,.750,96,289,385,623,191,43,232,247,1791
99,Glen Davis\davisgl01,C,22,BOS,69,1,940,107,221,.484,0,0,,107,221,.484,.484,99,150,.660,95,113,208,28,31,20,65,160,313
100,Paul Davis\davispa01,PF,23,LAC,22,1,194,24,65,.369,0,0,,24,65,.369,.369,6,10,.600,25,22,47,10,6,6,9,33,54
101,Ricky Davis\davisri01,SF,28,MIA,82,47,2963,420,971,.433,135,333,.405,285,638,.447,.502,155,197,.787,55,298,353,276,87,14,191,187,1130
102,Carlos Delfino\delfica01,SG,25,TOR,82,0,1928,251,632,.397,120,314,.382,131,318,.412,.492,116,156,.744,66,293,359,145,69,11,75,177,738
103,Luol Deng\denglu01,SF,22,CHI,63,59,2128,429,896,.479,8,22,.364,421,874,.482,.483,204,265,.770,136,258,394,155,57,29,120,117,1070
104,Boris Diaw\diawbo01,PF,25,PHO,82,19,2308,308,646,.477,13,41,.317,295,605,.488,.487,96,129,.744,97,281,378,317,61,39,155,166,725
105,Yakhouba Diawara\diawaya01,SG,25,DEN,54,14,542,55,134,.410,21,66,.318,34,68,.500,.489,22,31,.710,23,39,62,37,8,3,16,61,153
106,Guillermo Díaz\diazgu01,SG,22,LAC,6,0,18,1,4,.250,0,1,.000,1,3,.333,.250,3,5,.600,2,0,2,1,0,0,0,0,5
107,Dan Dickau\dickada01,PG,29,LAC,67,8,1040,124,296,.419,36,108,.333,88,188,.468,.480,68,82,.829,13,84,97,172,32,3,55,108,352
108,Kaniel Dickens\dickeka01,PF,29,CLE,5,0,12,1,3,.333,0,0,,1,3,.333,.333,0,0,,0,1,1,1,0,1,0,1,2
109,Travis Diener\dienetr01,PG,25,IND,66,21,1356,159,430,.370,74,233,.318,85,197,.431,.456,64,71,.901,26,89,115,251,35,4,55,107,456
110,Ike Diogu\dioguik01,PF,24,IND,30,1,305,64,134,.478,0,0,,64,134,.478,.478,40,47,.851,38,47,85,10,7,3,20,43,168
111,DeSagana Diop\diopde01,C,26,TOT,79,23,1295,94,180,.522,0,0,,94,180,.522,.522,38,70,.543,160,232,392,40,26,88,58,146,226
111,DeSagana Diop\diopde01,C,26,DAL,52,18,894,67,115,.583,0,0,,67,115,.583,.583,24,40,.600,111,159,270,26,20,63,42,100,158
111,DeSagana Diop\diopde01,C,26,NJN,27,5,401,27,65,.415,0,0,,27,65,.415,.415,14,30,.467,49,73,122,14,6,25,16,46,68
112,Juan Dixon\dixonju01,PG,29,TOT,53,0,668,106,258,.411,30,72,.417,76,186,.409,.469,21,26,.808,15,60,75,97,21,2,54,62,263
112,Juan Dixon\dixonju01,PG,29,TOR,36,0,424,59,160,.369,17,39,.436,42,121,.347,.422,18,19,.947,9,38,47,65,21,2,35,38,153
112,Juan Dixon\dixonju01,PG,29,DET,17,0,244,47,98,.480,13,33,.394,34,65,.523,.546,3,7,.429,6,22,28,32,0,0,19,24,110
113,Michael Doleac\doleami01,C,30,MIN,24,8,257,28,63,.444,0,0,,28,63,.444,.444,1,2,.500,16,33,49,7,10,10,12,44,57
114,Keyon Dooling\doolike01,PG,27,ORL,72,1,1334,198,423,.468,22,65,.338,176,358,.492,.494,163,193,.845,7,94,101,133,36,5,61,131,581
115,Quincy Douby\doubyqu01,PG,23,SAC,74,0,876,132,335,.394,42,122,.344,90,213,.423,.457,48,52,.923,17,66,83,53,30,12,59,80,354
116,Jared Dudley\dudleja01,PF,22,CHA,73,14,1384,163,348,.468,9,41,.220,154,307,.502,.481,87,118,.737,121,165,286,81,55,10,50,128,422
117,Chris Duhon\duhonch01,PG,25,CHI,66,18,1490,133,344,.387,54,155,.348,79,189,.418,.465,65,80,.813,19,97,116,263,48,2,71,92,385
118,Tim Duncan*\duncati01,C,31,SAS,78,78,2651,585,1178,.497,0,4,.000,585,1174,.498,.497,338,463,.730,237,644,881,218,56,152,178,185,1508
119,Mike Dunleavy\dunlemi02,SG,27,IND,82,82,2953,532,1117,.476,165,389,.424,367,728,.504,.550,336,403,.834,59,365,424,288,86,31,190,208,1565
120,Ronald Dupree\duprero01,SF,27,TOT,5,0,21,1,3,.333,0,0,,1,3,.333,.333,2,2,1.000,1,7,8,1,1,0,0,0,4
120,Ronald Dupree\duprero01,SF,27,DET,1,0,3,0,0,,0,0,,0,0,,,0,0,,0,0,0,0,0,0,0,0,0
120,Ronald Dupree\duprero01,SF,27,SEA,4,0,18,1,3,.333,0,0,,1,3,.333,.333,2,2,1.000,1,7,8,1,1,0,0,0,4
121,Kevin Durant\duranke01,SG,19,SEA,80,80,2768,587,1366,.430,59,205,.288,528,1161,.455,.451,391,448,.873,70,278,348,192,78,75,232,122,1624
122,Monta Ellis\ellismo01,SG,22,GSW,81,72,3071,652,1227,.531,12,52,.231,640,1175,.545,.536,320,417,.767,133,271,404,315,124,27,173,195,1636
123,Francisco Elson\elsonfr01,C,31,TOT,63,5,813,92,236,.390,0,1,.000,92,235,.391,.390,26,37,.703,50,150,200,24,15,20,47,96,210
123,Francisco Elson\elsonfr01,C,31,SAS,41,3,534,62,148,.419,0,0,,62,148,.419,.419,20,24,.833,33,102,135,16,9,14,30,62,144
123,Francisco Elson\elsonfr01,C,31,SEA,22,2,279,30,88,.341,0,1,.000,30,87,.345,.341,6,13,.462,17,48,65,8,6,6,17,34,66
124,Melvin Ely\elyme01,C,29,NOH,52,1,621,85,180,.472,0,0,,85,180,.472,.472,32,58,.552,28,117,145,22,7,18,42,79,202
125,Maurice Evans\evansma01,SG,29,TOT,75,47,1720,262,545,.481,81,209,.388,181,336,.539,.555,59,83,.711,92,126,218,81,46,10,40,142,664
125,Maurice Evans\evansma01,SG,29,LAL,7,0,96,9,28,.321,1,7,.143,8,21,.381,.339,12,15,.800,4,5,9,12,5,1,0,10,31
125,Maurice Evans\evansma01,SG,29,ORL,68,47,1624,253,517,.489,80,202,.396,173,315,.549,.567,47,68,.691,88,121,209,69,41,9,40,132,633
126,Reggie Evans\evansre01,PF,27,PHI,81,61,1879,152,346,.439,1,1,1.000,151,345,.438,.441,120,257,.467,224,387,611,65,86,8,108,213,425
127,Jordan Farmar\farmajo01,PG,21,LAL,82,0,1690,291,631,.461,114,307,.371,177,324,.546,.552,53,78,.679,39,144,183,225,77,5,108,105,749
128,Nick Fazekas\fazekni01,PF,22,TOT,26,0,269,46,82,.561,0,2,.000,46,80,.575,.561,15,22,.682,34,55,89,11,8,11,13,25,107
128,Nick Fazekas\fazekni01,PF,22,DAL,4,0,9,2,5,.400,0,0,,2,5,.400,.400,0,0,,1,2,3,0,0,0,0,0,4
128,Nick Fazekas\fazekni01,PF,22,LAC,22,0,260,44,77,.571,0,2,.000,44,75,.587,.571,15,22,.682,33,53,86,11,8,11,13,25,103
129,Raymond Felton\feltora01,PG,23,CHA,79,79,2972,412,997,.413,56,200,.280,356,797,.447,.441,260,325,.800,37,199,236,583,96,12,213,184,1140
130,Kyrylo Fesenko\fesenky01,C,21,UTA,9,0,70,6,16,.375,0,0,,6,16,.375,.375,2,4,.500,14,11,25,2,0,3,8,19,14
131,Michael Finley\finlemi01,SG,34,SAS,82,61,2204,315,761,.414,132,357,.370,183,404,.453,.501,64,80,.800,27,227,254,114,29,10,56,93,826
132,Derek Fisher\fishede01,PG,33,LAL,82,82,2249,339,777,.436,112,276,.406,227,501,.453,.508,166,188,.883,24,146,170,239,86,3,90,188,956
133,T.J. Ford\fordtj01,PG,24,TOR,51,26,1199,246,524,.469,15,51,.294,231,473,.488,.484,110,125,.880,23,77,100,313,54,0,102,93,617
134,Jeff Foster\fosteje01,C,31,IND,77,52,1884,205,373,.550,0,3,.000,205,370,.554,.550,86,145,.593,264,404,668,129,56,32,62,221,496
135,Randy Foye\foyera01,PG,24,MIN,39,31,1259,198,462,.429,61,148,.412,137,314,.436,.495,53,65,.815,13,115,128,164,36,3,79,102,510
136,Adonal Foyle\foylead01,C,32,ORL,82,0,774,70,153,.458,0,0,,70,153,.458,.458,16,34,.471,71,137,208,18,16,45,32,94,156
137,Richie Frahm\frahmri01,SG,30,LAC,10,2,163,20,54,.370,7,25,.280,13,29,.448,.435,0,2,.000,4,10,14,8,2,0,6,7,47
138,Steve Francis\francst01,PG,30,HOU,10,3,199,19,57,.333,4,17,.235,15,40,.375,.368,13,23,.565,8,15,23,30,9,5,14,25,55
139,Channing Frye\fryech01,C,24,POR,78,20,1342,221,453,.488,3,10,.300,218,443,.492,.491,85,109,.780,107,247,354,57,29,27,55,208,530
140,Dan Gadzuric\gadzuda01,C,29,MIL,51,4,534,64,154,.416,0,1,.000,64,153,.418,.416,33,63,.524,67,77,144,11,20,24,34,83,161
141,Jorge Garbajosa\garbajo01,PF,30,TOR,7,0,74,8,25,.320,6,16,.375,2,9,.222,.440,0,0,,2,13,15,3,3,0,1,2,22
142,Francisco García\garcifr01,SF,26,SAC,79,20,2096,348,752,.463,113,289,.391,235,463,.508,.538,162,208,.779,52,212,264,128,96,50,128,232,971
143,Thomas Gardner\gardnth01,SG,22,CHI,4,0,45,9,23,.391,3,12,.250,6,11,.545,.457,0,2,.000,3,1,4,1,0,0,4,4,21
144,Kevin Garnett*\garneke01,PF,31,BOS,71,71,2328,534,990,.539,0,11,.000,534,979,.545,.539,269,336,.801,135,520,655,244,100,89,138,163,1337
145,Pat Garrity\garripa01,PF,31,ORL,31,0,284,27,80,.338,8,37,.216,19,43,.442,.388,4,5,.800,9,35,44,13,6,1,17,35,66
146,Pau Gasol\gasolpa01,C,27,TOT,66,66,2351,475,890,.534,4,16,.250,471,874,.539,.536,292,362,.807,155,398,553,211,30,98,124,139,1246
146,Pau Gasol\gasolpa01,C,27,MEM,39,39,1433,279,557,.501,4,15,.267,275,542,.507,.504,176,215,.819,94,248,342,116,16,56,80,85,738
146,Pau Gasol\gasolpa01,C,27,LAL,27,27,918,196,333,.589,0,1,.000,196,332,.590,.589,116,147,.789,61,150,211,95,14,42,44,54,508
147,Rudy Gay\gayru01,SF,21,MEM,81,81,3000,625,1355,.461,134,387,.346,491,968,.507,.511,248,316,.785,140,359,499,158,111,79,190,230,1632
148,Mickaël Gelabale\gelabmi01,SG,24,SEA,39,0,465,69,157,.439,16,37,.432,53,120,.442,.490,14,18,.778,16,42,58,33,10,9,27,31,168
149,Devean George\georgde01,SF,30,DAL,53,4,821,74,207,.357,22,68,.324,52,139,.374,.411,24,34,.706,28,109,137,35,19,13,24,90,194
150,Daniel Gibson\gibsoda01,PG,21,CLE,58,26,1765,201,465,.432,118,268,.440,83,197,.421,.559,85,105,.810,30,104,134,145,47,14,76,163,605
151,Eddie Gill\gilled01,PG,29,TOT,14,1,154,12,31,.387,5,15,.333,7,16,.438,.468,9,9,1.000,1,21,22,22,7,2,9,18,38
151,Eddie Gill\gilled01,PG,29,NJN,13,1,149,12,29,.414,5,14,.357,7,15,.467,.500,9,9,1.000,1,21,22,21,7,2,8,18,38
151,Eddie Gill\gilled01,PG,29,SEA,1,0,5,0,2,.000,0,1,.000,0,1,.000,.000,0,0,,0,0,0,1,0,0,1,0,0
152,Manu Ginóbili*\ginobma01,SG,30,SAS,74,23,2299,453,984,.460,156,389,.401,297,595,.499,.540,380,442,.860,63,291,354,332,109,33,200,173,1442
153,Gordan Giriček\giricgo01,SG,30,TOT,56,0,831,133,302,.440,36,99,.364,97,203,.478,.500,23,26,.885,16,80,96,62,24,4,52,82,325
153,Gordan Giriček\giricgo01,SG,30,UTA,22,0,279,41,102,.402,12,34,.353,29,68,.426,.461,1,1,1.000,6,25,31,16,13,1,21,24,95
153,Gordan Giriček\giricgo01,SG,30,PHI,12,0,110,13,41,.317,5,15,.333,8,26,.308,.378,6,8,.750,1,13,14,11,3,1,8,9,37
153,Gordan Giriček\giricgo01,SG,30,PHO,22,0,442,79,159,.497,19,50,.380,60,109,.550,.557,16,17,.941,9,42,51,35,8,2,23,49,193
154,Ryan Gomes\gomesry01,PF,25,MIN,82,74,2434,392,857,.457,59,179,.330,333,678,.491,.492,190,229,.830,133,342,475,145,65,10,96,154,1033
155,Drew Gooden\goodedr01,PF,26,TOT,69,65,2122,332,740,.449,0,6,.000,332,734,.452,.449,162,215,.753,175,415,590,81,48,53,122,203,826
155,Drew Gooden\goodedr01,PF,26,CLE,51,51,1564,232,523,.444,0,3,.000,232,520,.446,.444,110,151,.728,117,306,423,50,35,30,91,144,574
155,Drew Gooden\goodedr01,PF,26,CHI,18,14,558,100,217,.461,0,3,.000,100,214,.467,.461,52,64,.813,58,109,167,31,13,23,31,59,252
156,Ben Gordon\gordobe01,SG,24,CHI,72,27,2291,464,1069,.434,142,346,.410,322,723,.445,.500,266,293,.908,40,181,221,213,55,8,150,171,1336
157,Marcin Gortat\gortama01,C,23,ORL,6,0,41,8,17,.471,0,0,,8,17,.471,.471,2,3,.667,8,8,16,2,1,1,2,4,18
158,Joey Graham\grahajo01,SF,25,TOR,38,3,331,49,113,.434,2,3,.667,47,110,.427,.442,38,45,.844,18,49,67,15,3,0,23,47,138
159,Stephen Graham\grahast01,SF,25,IND,22,0,128,34,58,.586,7,14,.500,27,44,.614,.647,12,16,.750,4,18,22,9,4,1,10,14,87
160,Danny Granger\grangda01,SF,24,IND,80,80,2876,537,1205,.446,171,423,.404,366,782,.468,.517,322,378,.852,93,393,486,166,95,84,171,290,1567
161,Aaron Gray\grayaa01,C,23,CHI,61,1,613,103,204,.505,0,1,.000,103,203,.507,.505,56,99,.566,70,98,168,41,21,16,57,117,262
162,Gerald Green\greenge01,SF,22,TOT,30,0,362,52,151,.344,15,39,.385,37,112,.330,.394,34,41,.829,13,51,64,29,8,4,32,45,153
162,Gerald Green\greenge01,SF,22,MIN,29,0,358,49,148,.331,15,39,.385,34,109,.312,.382,34,41,.829,11,51,62,29,8,4,32,43,147
162,Gerald Green\greenge01,SF,22,HOU,1,0,4,3,3,1.000,0,0,,3,3,1.000,1.000,0,0,,2,0,2,0,0,0,0,2,6
163,Jeff Green\greenje02,SF,21,SEA,80,52,2253,320,749,.427,21,76,.276,299,673,.444,.441,177,238,.744,101,278,379,119,46,49,158,198,838
164,Taurean Green\greenta01,SG-PG,21,TOT,17,0,74,7,25,.280,2,11,.182,5,14,.357,.320,11,12,.917,0,10,10,11,2,0,9,5,27
164,Taurean Green\greenta01,PG,21,POR,8,0,44,4,16,.250,1,8,.125,3,8,.375,.281,8,8,1.000,0,4,4,8,1,0,7,3,17
164,Taurean Green\greenta01,SG,21,DEN,9,0,30,3,9,.333,1,3,.333,2,6,.333,.389,3,4,.750,0,6,6,3,1,0,2,2,10
165,Willie Green\greenwi01,SG,26,PHI,74,74,1970,379,870,.436,51,179,.285,328,691,.475,.465,112,148,.757,32,150,182,151,54,22,109,119,921
166,Orien Greene\greenor01,SG,25,SAC,7,2,61,3,11,.273,0,1,.000,3,10,.300,.273,0,0,,0,6,6,3,3,1,7,9,6
167,Adrian Griffin\griffad01,SG-SF,33,TOT,35,2,307,30,76,.395,0,0,,30,76,.395,.395,5,9,.556,28,31,59,27,17,2,21,27,65
167,Adrian Griffin\griffad01,SG,33,CHI,22,2,222,24,60,.400,0,0,,24,60,.400,.400,3,7,.429,19,18,37,22,12,1,16,19,51
167,Adrian Griffin\griffad01,SF,33,SEA,13,0,85,6,16,.375,0,0,,6,16,.375,.375,2,2,1.000,9,13,22,5,5,1,5,8,14
168,Richard Hamilton\hamilri01,SG,29,DET,72,72,2424,499,1030,.484,62,141,.440,437,889,.492,.515,184,221,.833,75,160,235,299,73,10,132,171,1244
169,Anfernee Hardaway\hardaan01,SF,36,MIA,16,8,325,22,60,.367,8,19,.421,14,41,.341,.433,8,9,.889,3,32,35,35,19,1,13,24,60
170,Matt Harpring\harprma01,SF,31,UTA,76,0,1374,237,474,.500,2,10,.200,235,464,.506,.502,146,205,.712,96,144,240,82,45,14,95,162,622
171,Al Harrington\harrial01,C,27,GSW,81,59,2190,401,923,.434,153,408,.375,248,515,.482,.517,147,190,.774,107,332,439,132,74,16,90,266,1102
172,Othella Harrington\harriot01,C,34,CHA,22,0,166,18,42,.429,0,0,,18,42,.429,.429,10,16,.625,11,31,42,4,1,4,11,34,46
173,Devin Harris\harride01,PG,24,TOT,64,61,2022,321,693,.463,56,167,.335,265,526,.504,.504,248,301,.824,28,145,173,369,90,10,161,190,946
173,Devin Harris\harride01,PG,24,DAL,39,39,1184,187,387,.483,25,70,.357,162,317,.511,.516,161,196,.821,17,74,91,206,56,2,93,127,560
173,Devin Harris\harride01,PG,24,NJN,25,22,838,134,306,.438,31,97,.320,103,209,.493,.489,87,105,.829,11,71,82,163,34,8,68,63,386
174,Mike Harris\harrimi01,PF,24,HOU,17,0,159,27,54,.500,0,2,.000,27,52,.519,.500,8,13,.615,24,30,54,3,6,3,9,16,62
175,David Harrison\harrida01,C,25,IND,55,0,702,90,170,.529,0,0,,90,170,.529,.529,49,96,.510,43,75,118,14,20,59,58,164,229
176,Jason Hart\hartja01,PG,29,UTA,57,0,606,58,180,.322,11,31,.355,47,149,.315,.353,38,45,.844,5,50,55,86,30,3,28,75,165
177,Udonis Haslem\hasleud01,PF,27,MIA,49,48,1805,237,507,.467,0,0,,237,507,.467,.467,115,142,.810,107,336,443,68,39,18,67,145,589
178,Trenton Hassell\hassetr01,SG,28,TOT,63,6,773,57,135,.422,2,9,.222,55,126,.437,.430,7,10,.700,20,63,83,41,13,3,22,90,123
178,Trenton Hassell\hassetr01,SG,28,DAL,37,6,463,37,80,.463,1,4,.250,36,76,.474,.469,1,2,.500,11,33,44,26,9,1,14,55,76
178,Trenton Hassell\hassetr01,SG,28,NJN,26,0,310,20,55,.364,1,5,.200,19,50,.380,.373,6,8,.750,9,30,39,15,4,2,8,35,47
179,Spencer Hawes\hawessp01,C,19,SAC,71,8,931,146,318,.459,4,21,.190,142,297,.478,.465,38,58,.655,68,162,230,44,14,40,56,128,334
180,Chuck Hayes\hayesch01,PF,24,HOU,79,44,1575,113,221,.511,0,3,.000,113,218,.518,.511,11,24,.458,132,295,427,91,85,43,62,212,237
181,Jarvis Hayes\hayesja01,SF,26,DET,82,1,1287,217,504,.431,73,194,.376,144,310,.465,.503,45,60,.750,35,143,178,62,47,6,47,137,552
182,Brendan Haywood\haywobr01,C,28,WAS,80,80,2228,316,599,.528,0,0,,316,599,.528,.528,216,294,.735,273,303,576,71,31,133,108,216,848
183,Luther Head\headlu01,SG,25,HOU,73,17,1379,206,477,.432,79,225,.351,127,252,.504,.515,66,81,.815,18,117,135,138,44,9,70,75,557
184,Walter Herrmann\herrmwa01,PF,28,TOT,45,0,373,56,144,.389,20,64,.313,36,80,.450,.458,21,25,.840,22,51,73,18,7,1,12,24,153
184,Walter Herrmann\herrmwa01,PF,28,CHA,17,0,174,25,65,.385,9,26,.346,16,39,.410,.454,9,10,.900,10,26,36,4,4,0,4,12,68
184,Walter Herrmann\herrmwa01,PF,28,DET,28,0,199,31,79,.392,11,38,.289,20,41,.488,.462,12,15,.800,12,25,37,14,3,1,8,12,85
185,Nenê\hilarne01,PF,25,DEN,16,1,266,29,71,.408,0,1,.000,29,70,.414,.408,27,49,.551,30,57,87,15,9,14,21,46,85
186,Grant Hill*\hillgr01,SF,35,PHO,70,68,2222,358,712,.503,33,104,.317,325,608,.535,.526,170,196,.867,74,279,353,203,65,56,96,153,919
187,Kirk Hinrich\hinriki01,PG,27,CHI,75,72,2380,330,797,.414,84,240,.350,246,557,.442,.467,118,142,.831,28,216,244,452,87,19,157,224,862
188,Ryan Hollins\holliry01,PF,23,CHA,60,1,532,46,94,.489,0,0,,46,94,.489,.489,55,82,.671,53,54,107,14,10,30,25,96,147
189,Al Horford\horfoal01,C,21,ATL,81,77,2540,333,668,.499,0,5,.000,333,663,.502,.499,155,212,.731,248,537,785,124,60,76,137,267,821
190,Robert Horry\horryro01,PF,37,SAS,45,5,583,38,119,.319,18,70,.257,20,49,.408,.395,18,28,.643,35,74,109,47,21,19,22,55,112
191,Eddie House\houseed01,PG,29,BOS,78,2,1480,217,531,.409,117,298,.393,100,233,.429,.519,33,36,.917,19,148,167,152,59,10,76,114,584
192,Dwight Howard\howardw01,C,22,ORL,82,82,3088,583,974,.599,0,4,.000,583,970,.601,.599,529,897,.590,279,882,1161,110,74,176,263,274,1695
193,Josh Howard\howarjo01,SF,27,DAL,76,76,2757,567,1247,.455,67,210,.319,500,1037,.482,.482,312,384,.813,120,412,532,164,59,32,114,202,1513
194,Juwan Howard\howarju01,PF,34,DAL,50,0,353,23,64,.359,0,0,,23,64,.359,.359,11,14,.786,21,60,81,17,5,2,17,62,57
195,Troy Hudson\hudsotr01,PG,31,GSW,9,0,93,9,31,.290,4,12,.333,5,19,.263,.355,6,6,1.000,0,7,7,9,3,0,7,4,28
196,Larry Hughes\hughela01,PG-SG,29,TOT,68,57,2020,305,801,.381,67,194,.345,238,607,.392,.423,150,188,.798,39,191,230,181,99,17,116,139,827
196,Larry Hughes\hughela01,PG,29,CLE,40,32,1210,180,478,.377,43,126,.341,137,352,.389,.422,88,108,.815,27,116,143,94,60,11,72,91,491
196,Larry Hughes\hughela01,SG,29,CHI,28,25,810,125,323,.387,24,68,.353,101,255,.396,.424,62,80,.775,12,75,87,87,39,6,44,48,336
197,Kris Humphries\humphkr01,PF,22,TOR,70,0,925,161,333,.483,0,2,.000,161,331,.486,.483,75,124,.605,90,169,259,28,25,28,47,107,397
198,Lindsey Hunter\hunteli01,PG,37,DET,24,0,215,22,64,.344,7,26,.269,15,38,.395,.398,7,9,.778,4,9,13,33,13,2,13,30,58
199,Steven Hunter\huntest01,C,26,DEN,19,2,120,15,28,.536,0,0,,15,28,.536,.536,9,20,.450,10,19,29,0,0,6,7,20,39
200,Andre Iguodala\iguodan01,SF,24,PHI,82,82,3242,582,1277,.456,101,307,.329,481,970,.496,.495,365,506,.721,85,361,446,391,171,49,214,187,1630
201,Zydrunas Ilgauskas\ilgauzy01,C,32,CLE,73,73,2222,417,879,.474,0,1,.000,417,878,.475,.474,195,243,.802,263,419,682,104,34,120,135,247,1029
202,D.J. Mbenga\mbengdj01,C,27,TOT,42,0,326,39,84,.464,0,0,,39,84,.464,.464,5,12,.417,28,44,72,10,7,26,12,70,83
202,D.J. Mbenga\mbengdj01,C,27,GSW,16,0,130,9,23,.391,0,0,,9,23,.391,.391,1,2,.500,13,18,31,4,3,10,4,32,19
202,D.J. Mbenga\mbengdj01,C,27,LAL,26,0,196,30,61,.492,0,0,,30,61,.492,.492,4,10,.400,15,26,41,6,4,16,8,38,64
203,Allen Iverson*\iversal01,SG,32,DEN,82,82,3424,712,1556,.458,95,275,.345,617,1281,.482,.488,645,797,.809,47,196,243,586,160,12,245,109,2164
204,Royal Ivey\iveyro01,PG,26,MIL,75,20,1437,149,378,.394,35,107,.327,114,271,.421,.440,85,117,.726,38,80,118,160,45,7,75,166,418
205,Jarrett Jack\jackja01,SG,24,POR,82,16,2229,267,620,.431,65,190,.342,202,430,.470,.483,215,248,.867,31,203,234,313,61,1,178,129,814
206,Bobby Jackson\jacksbo01,SG-PG,34,TOT,72,5,1389,204,506,.403,81,226,.358,123,280,.439,.483,64,81,.790,33,148,181,139,45,5,59,96,553
206,Bobby Jackson\jacksbo01,SG,34,NOH,46,0,891,116,296,.392,53,144,.368,63,152,.414,.481,40,49,.816,23,87,110,76,32,3,31,59,325
206,Bobby Jackson\jacksbo01,PG,34,HOU,26,5,498,88,210,.419,28,82,.341,60,128,.469,.486,24,32,.750,10,61,71,63,13,2,28,37,228
207,Luke Jackson\jackslu02,SF,26,MIA,14,1,228,26,80,.325,11,30,.367,15,50,.300,.394,16,23,.696,7,26,33,17,8,0,9,22,79
208,Stephen Jackson\jacksst02,SF,29,GSW,73,73,2855,488,1204,.405,182,501,.363,306,703,.435,.481,308,370,.832,67,251,318,300,92,29,197,171,1466
209,Casey Jacobsen\jacobca01,SG,26,MEM,53,0,547,39,115,.339,16,72,.222,23,43,.535,.409,13,17,.765,12,53,65,20,5,1,16,34,107
210,Jerome James\jamesje01,C,32,NYK,2,0,5,1,1,1.000,0,0,,1,1,1.000,1.000,2,2,1.000,0,3,3,0,0,0,0,0,4
211,LeBron James\jamesle01,SF,23,CLE,75,74,3027,794,1642,.484,113,359,.315,681,1283,.531,.518,549,771,.712,133,459,592,539,138,81,255,165,2250
212,Mike James\jamesmi01,PG,32,TOT,54,1,720,101,290,.348,31,97,.320,70,193,.363,.402,39,48,.813,14,55,69,60,21,2,36,56,272
212,Mike James\jamesmi01,PG,32,HOU,33,1,537,79,226,.350,24,74,.324,55,152,.362,.403,33,42,.786,11,41,52,54,17,2,29,44,215
212,Mike James\jamesmi01,PG,32,NOH,21,0,183,22,64,.344,7,23,.304,15,41,.366,.398,6,6,1.000,3,14,17,6,4,0,7,12,57
213,Antawn Jamison\jamisan01,PF,31,WAS,79,79,3061,618,1417,.436,120,354,.339,498,1063,.468,.478,333,438,.760,215,591,806,120,106,34,113,195,1689
214,Marko Jarić\jaricma01,SG,29,MIN,75,56,2189,227,528,.430,46,127,.362,181,401,.451,.473,121,163,.742,38,184,222,311,97,32,128,180,621
215,Al Jefferson\jeffeal01,C,23,MIN,82,82,2919,721,1441,.500,0,5,.000,721,1436,.502,.500,284,394,.721,308,603,911,117,74,119,167,222,1726
216,Richard Jefferson\jefferi01,SF,27,NJN,82,82,3200,619,1328,.466,77,213,.362,542,1115,.486,.495,542,679,.798,93,249,342,252,76,21,199,225,1857
217,Jared Jeffries\jeffrja01,SF,26,NYK,73,19,1325,108,270,.400,4,25,.160,104,245,.424,.407,49,93,.527,118,125,243,66,36,23,64,132,269
218,Yi Jianlian\jianlyi01,PF,20,MIL,66,49,1647,219,520,.421,6,21,.286,213,499,.427,.427,122,145,.841,106,238,344,55,36,56,90,153,566
219,Alexander Johnson\johnsal01,PF,24,MIA,43,6,549,61,125,.488,0,0,,61,125,.488,.488,57,83,.687,32,62,94,13,13,10,42,80,179
220,Amir Johnson\johnsam01,PF,20,DET,62,0,764,92,165,.558,0,0,,92,165,.558,.558,37,55,.673,87,148,235,29,24,82,39,141,221
221,Anthony Johnson\johnsan02,PG,33,TOT,69,52,1531,155,355,.437,42,93,.452,113,262,.431,.496,35,43,.814,22,115,137,262,52,9,84,115,387
221,Anthony Johnson\johnsan02,PG,33,ATL,42,41,1121,115,267,.431,27,63,.429,88,204,.431,.481,26,32,.813,17,81,98,202,42,8,50,86,283
221,Anthony Johnson\johnsan02,PG,33,SAC,27,11,410,40,88,.455,15,30,.500,25,58,.431,.540,9,11,.818,5,34,39,60,10,1,34,29,104
222,DerMarr Johnson\johnsde03,SF,27,SAS,5,0,28,7,14,.500,3,9,.333,4,5,.800,.607,0,2,.000,0,1,1,1,1,0,0,4,17
223,Joe Johnson\johnsjo02,SG,26,ATL,82,82,3343,647,1497,.432,169,444,.381,478,1053,.454,.489,316,379,.834,83,284,367,474,84,18,223,168,1779
224,Linton Johnson\johnsli01,PF,27,TOT,8,0,63,9,19,.474,1,3,.333,8,16,.500,.500,2,2,1.000,5,9,14,4,0,1,5,11,21
224,Linton Johnson\johnsli01,PF,27,PHO,6,0,53,7,14,.500,1,2,.500,6,12,.500,.536,0,0,,5,8,13,3,0,1,2,10,15
224,Linton Johnson\johnsli01,PF,27,TOR,2,0,10,2,5,.400,0,1,.000,2,4,.500,.400,2,2,1.000,0,1,1,1,0,0,3,1,6
225,Bobby Jones\jonesbo02,SF,24,TOT,47,2,531,60,140,.429,18,53,.340,42,87,.483,.493,40,51,.784,29,63,92,28,15,3,28,85,178
225,Bobby Jones\jonesbo02,SF,24,DEN,25,0,222,26,64,.406,9,23,.391,17,41,.415,.477,23,28,.821,11,27,38,11,5,1,14,46,84
225,Bobby Jones\jonesbo02,SF,24,MEM,9,2,137,14,36,.389,3,13,.231,11,23,.478,.431,9,10,.900,10,17,27,11,5,2,5,17,40
225,Bobby Jones\jonesbo02,SF,24,HOU,4,0,9,2,4,.500,0,0,,2,4,.500,.500,0,0,,0,1,1,0,1,0,1,3,4
225,Bobby Jones\jonesbo02,SF,24,MIA,6,0,143,17,32,.531,6,15,.400,11,17,.647,.625,8,13,.615,8,16,24,5,2,0,7,18,48
225,Bobby Jones\jonesbo02,SF,24,SAS,3,0,20,1,4,.250,0,2,.000,1,2,.500,.250,0,0,,0,2,2,1,2,0,1,1,2
226,Dahntay Jones\jonesda02,SG,27,SAC,25,0,206,23,53,.434,1,6,.167,22,47,.468,.443,34,51,.667,7,28,35,12,8,6,10,28,81
227,Damon Jones\jonesda01,SG,31,CLE,67,3,1336,151,363,.416,115,276,.417,36,87,.414,.574,20,28,.714,5,67,72,126,19,1,36,66,437
228,Dwayne Jones\jonesdw02,PF,24,CLE,56,0,472,25,47,.532,0,1,.000,25,46,.543,.532,28,58,.483,69,71,140,10,10,25,17,88,78
229,Eddie Jones\jonesed02,SG,36,DAL,47,33,922,66,180,.367,34,116,.293,32,64,.500,.461,10,14,.714,18,114,132,69,26,8,29,72,176
230,Fred Jones\jonesfr01,SG,28,NYK,70,26,1757,182,432,.421,74,192,.385,108,240,.450,.507,94,126,.746,30,140,170,166,48,18,78,140,532
231,James Jones\jonesja02,SF,27,POR,58,3,1276,143,327,.437,91,205,.444,52,122,.426,.576,86,98,.878,43,118,161,34,24,15,28,96,463
232,Solomon Jones\jonesso01,PF,23,ATL,35,0,145,12,30,.400,0,2,.000,12,28,.429,.400,11,20,.550,19,23,42,0,3,5,11,28,35
233,Chris Kaman\kamanch01,C,25,LAC,56,55,2083,338,700,.483,0,4,.000,338,696,.486,.483,202,265,.762,173,538,711,107,33,155,164,179,878
234,Jason Kapono\kaponja01,SF,26,TOR,81,7,1530,243,498,.488,57,118,.483,186,380,.489,.545,37,43,.860,31,89,120,65,34,2,58,131,580
235,Coby Karl\karlco01,SG,24,LAL,17,0,71,9,26,.346,4,13,.308,5,13,.385,.423,8,10,.800,3,11,14,9,4,2,5,4,30
236,Viktor Khryapa\khryavi01,PF,25,CHI,9,0,105,12,31,.387,0,1,.000,12,30,.400,.387,8,14,.571,6,14,20,8,6,0,6,11,32
237,Jason Kidd*\kiddja01,PG,34,TOT,80,80,2906,305,793,.385,119,312,.381,186,481,.387,.460,135,165,.818,94,506,600,806,136,26,266,165,864
237,Jason Kidd*\kiddja01,PG,34,NJN,51,51,1895,201,549,.366,84,236,.356,117,313,.374,.443,91,111,.820,58,354,412,530,74,15,185,90,577
237,Jason Kidd*\kiddja01,PG,34,DAL,29,29,1011,104,244,.426,35,76,.461,69,168,.411,.498,44,54,.815,36,152,188,276,62,11,81,75,287
238,Tarence Kinsey\kinseta01,SG,23,MEM,11,0,96,16,38,.421,3,7,.429,13,31,.419,.461,5,6,.833,3,9,12,2,3,0,3,11,40
239,Andrei Kirilenko\kirilan01,SF,26,UTA,72,72,2217,275,544,.506,44,116,.379,231,428,.540,.546,198,257,.770,121,218,339,285,86,109,140,165,792
240,Linas Kleiza\kleizli01,SF,23,DEN,79,13,1889,311,659,.472,94,277,.339,217,382,.568,.543,164,213,.770,92,241,333,95,44,19,89,181,880
241,Brevin Knight\knighbr01,PG,32,LAC,74,39,1674,138,342,.404,0,6,.000,138,336,.411,.404,62,71,.873,15,127,142,328,100,11,71,160,338
242,Kyle Korver\korveky01,SG-PF,26,TOT,75,0,1732,255,575,.443,111,296,.375,144,279,.516,.540,119,130,.915,21,151,172,101,42,29,75,192,740
242,Kyle Korver\korveky01,PF,26,PHI,25,0,657,90,227,.396,38,108,.352,52,119,.437,.480,31,34,.912,12,61,73,33,20,6,28,67,249
242,Kyle Korver\korveky01,SG,26,UTA,50,0,1075,165,348,.474,73,188,.388,92,160,.575,.579,88,96,.917,9,90,99,68,22,23,47,125,491
243,Nenad Krstić\krstine01,C,24,NJN,45,38,812,123,300,.410,0,2,.000,123,298,.413,.410,52,69,.754,35,165,200,27,9,17,41,111,298
244,Raef LaFrentz\lafrera01,C,31,POR,39,0,291,27,61,.443,0,4,.000,27,57,.474,.443,11,19,.579,28,39,67,6,12,17,10,59,65
245,Carl Landry\landrca01,PF,24,HOU,42,0,711,135,219,.616,0,1,.000,135,218,.619,.616,72,109,.661,96,111,207,21,17,7,26,98,342
246,Keith Langford\langfke01,SG,24,SAS,2,0,10,1,4,.250,0,0,,1,4,.250,.250,0,0,,0,2,2,0,0,0,0,1,2
247,Stéphane Lasme\lasmest01,PF-SF,25,TOT,16,4,303,32,71,.451,0,0,,32,71,.451,.451,19,32,.594,26,27,53,3,13,22,15,35,83
247,Stéphane Lasme\lasmest01,SF,25,GSW,1,0,0,0,0,,0,0,,0,0,,,0,0,,0,0,0,0,0,0,0,0,0
247,Stéphane Lasme\lasmest01,PF,25,MIA,15,4,303,32,71,.451,0,0,,32,71,.451,.451,19,32,.594,26,27,53,3,13,22,15,35,83
248,Acie Law\lawac01,PG,23,ATL,56,6,865,95,237,.401,7,34,.206,88,203,.433,.416,38,48,.792,12,45,57,113,29,0,56,73,235
249,David Lee\leeda02,PF,24,NYK,81,29,2356,341,618,.552,0,2,.000,341,616,.554,.552,194,237,.819,242,482,724,95,55,29,97,210,876
250,Rashard Lewis\lewisra02,PF,28,ORL,81,81,3076,516,1135,.455,226,553,.409,290,582,.498,.554,218,260,.838,97,340,437,196,99,38,140,214,1476
251,Kyle Lowry\lowryky01,PG,21,MEM,82,9,2089,256,592,.432,36,140,.257,220,452,.487,.463,243,348,.698,41,209,250,296,92,22,127,185,791
252,Tyronn Lue\luety01,PG,30,TOT,50,3,736,113,253,.447,39,86,.453,74,167,.443,.524,25,32,.781,9,45,54,74,11,1,27,66,290
252,Tyronn Lue\luety01,PG,30,ATL,33,3,564,86,196,.439,30,69,.435,56,127,.441,.515,24,28,.857,9,32,41,59,11,0,22,38,226
252,Tyronn Lue\luety01,PG,30,DAL,17,0,172,27,57,.474,9,17,.529,18,40,.450,.553,1,4,.250,0,13,13,15,0,1,5,28,64
253,Mark Madsen\madsema01,PF,32,MIN,20,6,151,3,19,.158,0,0,,3,19,.158,.158,3,12,.250,18,20,38,4,3,2,9,25,9
254,Corey Maggette\maggeco01,SF,28,LAC,70,65,2502,458,1000,.458,78,203,.384,380,797,.477,.497,553,681,.812,78,316,394,189,71,7,195,210,1547
255,Jamaal Magloire\magloja01,C,29,TOT,31,2,286,18,55,.327,0,0,,18,55,.327,.327,20,44,.455,19,70,89,7,1,10,30,50,56
255,Jamaal Magloire\magloja01,C,29,NJN,24,2,259,15,49,.306,0,0,,15,49,.306,.306,14,31,.452,18,63,81,7,0,10,23,42,44
255,Jamaal Magloire\magloja01,C,29,DAL,7,0,27,3,6,.500,0,0,,3,6,.500,.500,6,13,.462,1,7,8,0,1,0,7,8,12
256,Ian Mahinmi\mahinia01,C,21,SAS,6,0,23,6,12,.500,0,0,,6,12,.500,.500,9,9,1.000,0,5,5,1,0,4,2,4,21
257,Stephon Marbury\marbust01,PG,30,NYK,24,19,805,111,265,.419,28,74,.378,83,191,.435,.472,83,116,.716,17,42,59,113,21,2,48,57,333
258,Shawn Marion\mariosh01,PF,29,TOT,63,62,2315,400,787,.508,66,198,.333,334,589,.567,.550,106,150,.707,136,507,643,138,125,85,86,150,972
258,Shawn Marion\mariosh01,PF,29,PHO,47,47,1713,304,578,.526,58,167,.347,246,411,.599,.576,77,108,.713,86,378,464,98,95,70,49,117,743
258,Shawn Marion\mariosh01,PF,29,MIA,16,15,602,96,209,.459,8,31,.258,88,178,.494,.478,29,42,.690,50,129,179,40,30,15,37,33,229
259,Sean Marks\marksse01,C,32,PHO,19,0,130,23,43,.535,1,4,.250,22,39,.564,.547,12,19,.632,9,27,36,4,3,10,8,23,59
260,Donyell Marshall\marshdo01,PF,34,TOT,26,1,340,32,98,.327,15,53,.283,17,45,.378,.403,19,22,.864,24,52,76,10,6,16,15,31,98
260,Donyell Marshall\marshdo01,PF,34,CLE,11,1,156,13,44,.295,8,23,.348,5,21,.238,.386,7,9,.778,9,21,30,5,2,9,6,16,41
260,Donyell Marshall\marshdo01,PF,34,SEA,15,0,184,19,54,.352,7,30,.233,12,24,.500,.417,12,13,.923,15,31,46,5,4,7,9,15,57
261,Darrick Martin\martida01,PG,36,TOR,17,0,141,10,43,.233,2,16,.125,8,27,.296,.256,5,6,.833,3,4,7,21,6,0,1,12,27
262,Kenyon Martin\martike01,PF,30,DEN,71,71,2159,376,699,.538,2,11,.182,374,688,.544,.539,123,212,.580,105,356,461,90,88,85,91,235,877
263,Kevin Martin\martike02,SG,24,SAC,61,57,2216,417,914,.456,107,266,.402,310,648,.478,.515,502,578,.869,48,225,273,129,62,5,131,150,1443
264,Desmond Mason\masonde01,SF,30,MIL,59,56,1702,230,477,.482,0,0,,230,477,.482,.482,114,173,.659,75,181,256,121,40,30,83,106,574
265,Roger Mason\masonro01,PG,27,WAS,80,9,1708,266,600,.443,130,327,.398,136,273,.498,.552,62,71,.873,17,113,130,134,40,18,69,140,724
266,Jason Maxiell\maxieja01,C,24,DET,82,7,1768,240,446,.538,0,1,.000,240,445,.539,.538,171,270,.633,177,256,433,46,21,94,71,183,651
267,Rashad McCants\mccanra01,SG,23,MIN,75,24,2020,428,944,.453,142,349,.407,286,595,.481,.529,116,155,.748,50,156,206,162,66,18,172,234,1114
268,Jelani McCoy\mccoyje01,C,30,DEN,6,1,33,1,1,1.000,0,0,,1,1,1.000,1.000,1,2,.500,1,6,7,0,0,5,4,7,3
269,Antonio McDyess\mcdyean01,PF,33,DET,78,78,2285,293,600,.488,0,2,.000,293,598,.490,.488,97,156,.622,204,462,666,89,61,53,75,246,683
270,Tracy McGrady*\mcgratr01,SG,28,HOU,66,62,2440,548,1307,.419,86,295,.292,462,1012,.457,.452,245,358,.684,42,297,339,387,68,30,160,91,1427
271,Dominic McGuire\mcguido01,SG,22,WAS,70,1,695,39,103,.379,1,6,.167,38,97,.392,.383,14,32,.438,53,86,139,40,20,26,40,76,93
272,Jeff McInnis\mcinnje01,PG,33,CHA,54,26,1410,108,249,.434,3,19,.158,105,230,.457,.440,23,30,.767,16,80,96,220,23,3,76,120,242
273,Josh McRoberts\mcrobjo01,PF,20,POR,8,0,28,6,10,.600,0,1,.000,6,9,.667,.600,0,0,,2,8,10,2,1,0,2,1,12
274,Chris Mihm\mihmch01,C,28,LAL,23,5,278,32,95,.337,0,0,,32,95,.337,.337,18,27,.667,28,49,77,13,4,14,17,42,82
275,C.J. Miles\milescj01,SG,20,UTA,60,13,689,113,236,.479,30,77,.390,83,159,.522,.542,41,52,.788,16,62,78,53,32,8,27,98,297
276,Darko Miličić\milicda01,C,22,MEM,70,64,1663,219,500,.438,0,1,.000,219,499,.439,.438,67,121,.554,127,297,424,58,32,114,101,185,505
277,Andre Miller\millean02,PG,31,PHI,82,82,3016,569,1156,.492,3,34,.088,566,1122,.504,.494,257,333,.772,95,229,324,565,105,6,206,181,1398
278,Brad Miller\millebr01,C,31,SAC,72,72,2513,337,728,.463,28,90,.311,309,638,.484,.482,262,309,.848,167,514,681,264,69,74,164,247,964
279,Mike Miller\millemi01,SG,27,MEM,70,70,2474,414,824,.502,155,359,.432,259,465,.557,.596,164,212,.774,51,416,467,240,35,16,182,145,1147
280,Paul Millsap\millspa01,PF,22,UTA,82,2,1702,253,502,.504,0,4,.000,253,498,.508,.504,155,229,.677,167,293,460,81,72,73,87,269,661
281,Yao Ming*\mingya01,C,27,HOU,55,55,2044,432,852,.507,0,2,.000,432,850,.508,.507,345,406,.850,172,422,594,129,25,111,183,171,1209
282,Cuttino Mobley\moblecu01,SG,32,LAC,77,38,2702,377,870,.433,67,192,.349,310,678,.457,.472,163,199,.819,50,225,275,202,78,34,123,152,984
283,Nazr Mohammed\mohamna01,C,30,TOT,82,29,1650,272,528,.515,0,1,.000,272,527,.516,.515,95,163,.583,194,300,494,72,45,60,101,230,639
283,Nazr Mohammed\mohamna01,C,30,DET,21,0,228,28,59,.475,0,1,.000,28,58,.483,.475,13,30,.433,29,44,73,6,7,8,11,36,69
283,Nazr Mohammed\mohamna01,C,30,CHA,61,29,1422,244,469,.520,0,0,,244,469,.520,.520,82,133,.617,165,256,421,66,38,52,90,194,570
284,Jamario Moon\moonja01,SF,27,TOR,78,75,2166,279,575,.485,40,122,.328,239,453,.528,.520,63,85,.741,92,392,484,90,80,108,51,152,661
285,Mikki Moore\mooremi01,PF,32,SAC,82,79,2385,282,489,.577,0,2,.000,282,487,.579,.577,134,182,.736,160,334,494,84,35,46,110,310,698
286,Randolph Morris\morrira01,C,22,NYK,18,2,181,21,58,.362,0,0,,21,58,.362,.362,14,29,.483,12,25,37,2,4,2,9,37,56
287,Alonzo Mourning*\mournal01,C,37,MIA,25,0,389,52,95,.547,0,0,,52,95,.547,.547,45,76,.592,34,59,93,7,4,42,25,56,149
288,Troy Murphy\murphtr01,PF,27,IND,75,61,2106,315,693,.455,94,236,.398,221,457,.484,.522,192,241,.797,108,435,543,165,49,32,96,217,916
289,Ronald Murray\murraro01,PG,28,TOT,42,19,874,154,367,.420,20,63,.317,134,304,.441,.447,68,98,.694,23,60,83,144,38,4,84,50,396
289,Ronald Murray\murraro01,PG,28,DET,19,2,347,57,139,.410,6,27,.222,51,112,.455,.432,22,37,.595,13,23,36,64,13,1,31,19,142
289,Ronald Murray\murraro01,PG,28,IND,23,17,527,97,228,.425,14,36,.389,83,192,.432,.456,46,61,.754,10,37,47,80,25,3,53,31,254
290,Dikembe Mutombo*\mutomdi01,C,41,HOU,39,25,619,43,80,.538,0,0,,43,80,.538,.538,32,45,.711,68,131,199,5,11,48,17,55,118
291,Boštjan Nachbar\nachbbo01,PF,27,NJN,75,1,1660,245,609,.402,94,262,.359,151,347,.435,.479,154,196,.786,56,204,260,88,44,21,85,182,738
292,Eduardo Nájera\najered01,PF,31,DEN,78,3,1664,174,368,.473,53,147,.361,121,221,.548,.545,63,89,.708,113,224,337,95,69,40,59,199,464
293,Steve Nash*\nashst01,PG,33,PHO,81,81,2780,485,962,.504,179,381,.470,306,581,.527,.597,222,245,.906,28,254,282,898,53,5,295,113,1371
294,Juan Carlos Navarro\navarju01,SG,27,MEM,82,30,2117,308,766,.402,156,432,.361,152,334,.455,.504,124,146,.849,34,176,210,177,48,1,134,94,896
295,Jameer Nelson\nelsoja01,PG,25,ORL,69,62,1961,283,603,.469,64,154,.416,219,449,.488,.522,125,151,.828,28,215,243,383,63,4,141,167,755
296,Rasho Nesterović\nestera01,C,31,TOR,71,39,1486,257,467,.550,1,3,.333,256,464,.552,.551,37,49,.755,130,212,342,82,20,52,60,132,552
297,Ira Newble\newblir01,SG-SF,33,TOT,49,13,698,76,174,.437,16,49,.327,60,125,.480,.483,20,26,.769,47,78,125,18,28,8,34,69,188
297,Ira Newble\newblir01,SG,33,CLE,41,13,650,71,158,.449,15,45,.333,56,113,.496,.497,20,26,.769,41,73,114,14,27,7,31,64,177
297,Ira Newble\newblir01,SF,33,SEA,2,0,17,2,7,.286,0,2,.000,2,5,.400,.286,0,0,,0,0,0,1,0,0,0,0,4
297,Ira Newble\newblir01,SF,33,LAL,6,0,31,3,9,.333,1,2,.500,2,7,.286,.389,0,0,,6,5,11,3,1,1,3,5,7
298,Demetris Nichols\nichode01,SF,23,TOT,14,0,44,6,23,.261,3,13,.231,3,10,.300,.326,0,0,,0,5,5,1,0,3,4,4,15
298,Demetris Nichols\nichode01,SF,23,CLE,3,0,14,1,8,.125,0,3,.000,1,5,.200,.125,0,0,,0,1,1,0,0,0,2,0,2
298,Demetris Nichols\nichode01,SF,23,CHI,11,0,30,5,15,.333,3,10,.300,2,5,.400,.433,0,0,,0,4,4,1,0,3,2,4,13
299,Joakim Noah\noahjo01,C,22,CHI,74,31,1534,177,367,.482,0,1,.000,177,366,.484,.482,134,194,.691,174,242,416,84,68,64,89,173,488
300,Andrés Nocioni\nocioan01,SF,28,CHI,82,27,2021,379,877,.432,126,346,.364,253,531,.476,.504,196,243,.807,48,294,342,95,25,43,133,245,1080
301,Steve Novak\novakst01,SF,24,HOU,35,0,264,49,102,.480,34,71,.479,15,31,.484,.647,3,4,.750,4,31,35,6,2,3,4,17,135
302,Dirk Nowitzki\nowitdi01,PF,29,DAL,77,77,2769,630,1314,.479,79,220,.359,551,1094,.504,.510,478,544,.879,95,564,659,266,51,71,160,198,1817
303,Patrick O'Bryant\obryapa01,C,21,GSW,24,0,99,16,29,.552,0,0,,16,29,.552,.552,3,5,.600,10,19,29,4,4,9,7,27,35
304,Jermaine O'Neal\onealje01,C,29,IND,42,34,1206,225,512,.439,0,5,.000,225,507,.444,.439,121,163,.742,82,201,283,93,20,87,106,129,571
305,Shaquille O'Neal*\onealsh01,C,35,TOT,61,61,1748,331,558,.593,0,0,,331,558,.593,.593,170,338,.503,166,388,554,93,32,88,181,228,832
305,Shaquille O'Neal*\onealsh01,C,35,MIA,33,33,945,191,329,.581,0,0,,191,329,.581,.581,88,178,.494,99,159,258,45,19,54,98,134,470
305,Shaquille O'Neal*\onealsh01,C,35,PHO,28,28,803,140,229,.611,0,0,,140,229,.611,.611,82,160,.513,67,229,296,48,13,34,83,94,362
306,Fabricio Oberto\obertfa01,C,32,SAS,82,64,1644,180,296,.608,0,1,.000,180,295,.610,.608,37,61,.607,153,277,430,95,37,20,51,203,397
307,Lamar Odom\odomla01,PF,28,LAL,77,77,2921,417,795,.525,31,113,.274,386,682,.566,.544,229,328,.698,197,622,819,273,75,72,156,222,1094
308,Emeka Okafor\okafoem01,C,25,CHA,82,82,2718,460,860,.535,0,0,,460,860,.535,.535,213,374,.570,255,621,876,70,62,138,164,241,1133
309,Mehmet Okur\okurme01,C,28,UTA,72,72,2390,374,841,.445,114,294,.388,260,547,.475,.512,185,230,.804,132,424,556,145,55,29,104,236,1047
310,Kevin Ollie\ollieke01,SG,35,PHI,40,0,300,29,69,.420,0,1,.000,29,68,.426,.420,12,15,.800,4,15,19,38,10,0,5,28,70
311,Bo Outlaw\outlabo01,PF,36,ORL,2,0,7,2,3,.667,0,0,,2,3,.667,.667,0,0,,0,0,0,0,0,0,1,1,4
312,Travis Outlaw\outlatr01,PF,23,POR,82,6,2186,417,964,.433,40,101,.396,377,863,.437,.453,218,294,.741,96,280,376,106,59,63,107,173,1092
313,Andre Owens\owensan01,PG,27,IND,31,7,392,40,107,.374,18,40,.450,22,67,.328,.458,25,34,.735,13,34,47,47,13,3,24,37,123
314,Zaza Pachulia\pachuza01,C,23,ATL,62,5,944,107,245,.437,0,3,.000,107,242,.442,.437,108,153,.706,89,159,248,36,24,13,69,140,322
315,Jannero Pargo\pargoja01,SG,28,NOH,80,5,1497,254,652,.390,65,186,.349,189,466,.406,.439,71,81,.877,26,104,130,192,50,5,93,123,644
316,Anthony Parker\parkean01,SG,32,TOR,82,82,2634,395,829,.476,133,304,.438,262,525,.499,.557,102,125,.816,50,284,334,183,79,17,87,157,1025
317,Smush Parker\parkesm01,PG,26,TOT,28,2,592,64,184,.348,18,78,.231,46,106,.434,.397,19,28,.679,4,47,51,84,24,6,44,60,165
317,Smush Parker\parkesm01,PG,26,MIA,9,0,183,17,54,.315,6,24,.250,11,30,.367,.370,3,4,.750,2,17,19,15,5,3,8,13,43
317,Smush Parker\parkesm01,PG,26,LAC,19,2,409,47,130,.362,12,54,.222,35,76,.461,.408,16,24,.667,2,30,32,69,19,3,36,47,122
318,Tony Parker\parketo01,PG,25,SAS,69,68,2312,515,1043,.494,17,66,.258,498,977,.510,.502,248,347,.715,30,191,221,411,55,8,164,93,1295
319,Ruben Patterson\patteru01,SF,32,LAC,20,5,327,39,86,.453,0,2,.000,39,84,.464,.453,24,43,.558,24,40,64,17,21,7,27,37,102
320,Chris Paul\paulch01,PG,22,NOH,80,80,3006,630,1291,.488,92,249,.369,538,1042,.516,.524,332,390,.851,62,259,321,925,217,4,201,185,1684
321,Sasha Pavlović\pavloal01,SG,24,CLE,51,45,1188,146,403,.362,34,114,.298,112,289,.388,.404,53,77,.688,35,93,128,82,29,6,55,117,379
322,Oleksiy Pecherov\pecheol01,C,22,WAS,35,0,320,44,125,.352,17,60,.283,27,65,.415,.420,20,31,.645,21,45,66,7,6,5,17,30,125
323,Kendrick Perkins\perkike01,C,23,BOS,78,78,1912,214,348,.615,0,1,.000,214,347,.617,.615,114,183,.623,145,329,474,84,31,114,125,242,542
324,Kosta Perović\perovko01,C,22,GSW,7,0,38,3,10,.300,0,0,,3,10,.300,.300,4,6,.667,6,7,13,1,0,2,1,6,10
325,Morris Peterson\petermo01,SG,30,NOH,76,76,1796,215,516,.417,113,287,.394,102,229,.445,.526,65,85,.765,36,170,206,67,47,7,41,125,608
326,Johan Petro\petrojo01,C,22,SEA,72,28,1310,184,439,.419,0,1,.000,184,438,.420,.419,64,87,.736,98,272,370,32,35,42,73,173,432
327,Eric Piatkowski\piatker01,SF,37,PHO,16,0,113,12,33,.364,11,26,.423,1,7,.143,.530,4,4,1.000,1,11,12,10,0,1,6,11,39
328,Paul Pierce*\piercpa01,SF,30,BOS,80,80,2874,509,1098,.464,143,365,.392,366,733,.499,.529,409,485,.843,53,358,411,363,101,36,221,200,1570
329,Mickaël Piétrus\pietrmi01,SF,25,GSW,66,16,1316,170,387,.439,66,183,.361,104,204,.510,.525,66,98,.673,67,175,242,49,66,43,48,200,472
330,Scot Pollard\pollasc01,C,32,BOS,22,0,173,12,23,.522,0,0,,12,23,.522,.522,15,22,.682,14,23,37,3,3,6,5,43,39
331,James Posey\poseyja01,PF,31,BOS,74,2,1821,173,414,.418,106,279,.380,67,135,.496,.546,93,115,.809,30,292,322,114,72,19,65,182,545
332,Leon Powe\powele01,C,24,BOS,56,5,809,154,269,.572,0,1,.000,154,268,.575,.572,137,193,.710,95,132,227,15,15,16,43,127,445
333,Josh Powell\poweljo01,C,25,LAC,64,25,1228,145,315,.460,0,3,.000,145,312,.465,.460,63,87,.724,115,216,331,47,14,23,65,130,353
334,Kasib Powell\powelka01,SF,26,MIA,11,4,304,35,95,.368,8,33,.242,27,62,.435,.411,6,9,.667,8,36,44,18,9,2,5,18,84
335,Ronnie Price\pricero01,PG,24,UTA,61,3,588,88,204,.431,26,75,.347,62,129,.481,.495,26,38,.684,8,38,46,78,32,3,30,83,228
336,Tayshaun Prince\princta01,SF,27,DET,82,82,2694,421,940,.448,53,146,.363,368,794,.463,.476,185,241,.768,109,289,398,268,42,33,91,90,1080
337,Gabe Pruitt\pruitga01,PG,21,BOS,15,0,95,14,39,.359,3,12,.250,11,27,.407,.397,1,2,.500,1,7,8,13,5,0,5,10,32
338,Joel Przybilla\przybjo01,C,28,POR,77,67,1819,144,250,.576,0,1,.000,144,249,.578,.576,83,122,.680,195,454,649,27,13,93,95,234,371
339,Chris Quinn\quinnch01,PG,24,MIA,60,25,1340,158,373,.424,64,159,.403,94,214,.439,.509,85,98,.867,11,107,118,178,46,4,55,90,465
340,Vladimir Radmanović\radmavl01,SF,27,LAL,65,41,1483,198,437,.453,95,234,.406,103,203,.507,.562,52,65,.800,56,159,215,123,46,12,73,147,543
341,Shavlik Randolph\randosh01,PF,24,PHI,9,0,27,4,14,.286,0,0,,4,14,.286,.286,0,0,,9,2,11,3,1,3,2,5,8
342,Zach Randolph\randoza01,C,26,NYK,69,68,2244,486,1058,.459,22,80,.275,464,978,.474,.470,223,289,.772,184,526,710,140,59,16,186,194,1217
343,Theo Ratliff\ratlith01,C-PF,34,TOT,26,9,437,41,85,.482,0,1,.000,41,84,.488,.482,29,43,.674,32,57,89,14,7,37,21,59,111
343,Theo Ratliff\ratlith01,PF,34,MIN,10,6,214,23,45,.511,0,1,.000,23,44,.523,.511,17,25,.680,13,26,39,7,3,19,12,30,63
343,Theo Ratliff\ratlith01,C,34,DET,16,3,223,18,40,.450,0,0,,18,40,.450,.450,12,18,.667,19,31,50,7,4,18,9,29,48
344,Michael Redd\reddmi01,SG,28,MIL,72,71,2702,550,1243,.442,130,359,.362,420,884,.475,.495,402,490,.820,85,224,309,247,65,13,181,120,1632
345,J.J. Redick\redicjj01,SG,23,ORL,34,0,276,48,108,.444,17,43,.395,31,65,.477,.523,27,34,.794,1,22,23,16,4,0,15,29,140
346,Chris Richard\richach01,C,23,MIN,52,3,556,41,87,.471,0,0,,41,87,.471,.471,16,27,.593,52,83,135,18,10,12,24,83,98
347,Jason Richardson\richaja01,SF,27,CHA,82,82,3149,648,1468,.441,243,599,.406,405,869,.466,.524,249,331,.752,80,361,441,258,116,57,166,241,1788
348,Jeremy Richardson\richaje01,SF-SG,23,TOT,27,1,132,16,44,.364,7,19,.368,9,25,.360,.443,2,2,1.000,1,8,9,2,3,0,6,13,41
348,Jeremy Richardson\richaje01,SF,23,MEM,3,0,15,0,6,.000,0,2,.000,0,4,.000,.000,0,0,,0,1,1,1,0,0,1,2,0
348,Jeremy Richardson\richaje01,SG,23,SAS,5,1,29,3,7,.429,2,5,.400,1,2,.500,.571,2,2,1.000,0,1,1,1,1,0,0,5,10
348,Jeremy Richardson\richaje01,SF,23,ATL,19,0,88,13,31,.419,5,12,.417,8,19,.421,.500,0,0,,1,6,7,0,2,0,5,6,31
349,Quentin Richardson\richaqu01,SF,27,NYK,65,65,1841,199,555,.359,69,214,.322,130,341,.381,.421,60,88,.682,56,259,315,116,44,15,69,153,527
350,Luke Ridnour\ridnolu01,PG,26,SEA,61,5,1223,147,368,.399,21,71,.296,126,297,.424,.428,78,91,.857,13,81,94,241,37,14,80,120,393
351,Nate Robinson\robinna01,PG,23,NYK,72,17,1883,331,782,.423,97,292,.332,234,490,.478,.485,154,196,.786,51,171,222,212,60,1,103,186,913
352,Sergio Rodríguez\rodrise01,PG,21,POR,72,0,628,69,196,.352,17,58,.293,52,138,.377,.395,25,38,.658,13,45,58,123,24,0,53,57,180
353,Rajon Rondo\rondora01,PG,21,BOS,77,77,2306,351,713,.492,5,19,.263,346,694,.499,.496,107,175,.611,78,244,322,393,129,13,147,187,814
354,Malik Rose\rosema01,PF,33,NYK,49,3,494,66,180,.367,2,7,.286,64,173,.370,.372,37,51,.725,31,72,103,28,16,7,40,80,171
355,Quinton Ross\rossqu01,SG,26,LAC,76,44,1505,131,335,.391,9,21,.429,122,314,.389,.404,40,60,.667,54,118,172,88,43,33,29,132,311
356,Brandon Roy\roybr01,SG,23,POR,74,74,2792,531,1170,.454,73,215,.340,458,955,.480,.485,281,373,.753,81,267,348,430,79,16,136,147,1416
357,Michael Ruffin\ruffimi01,C,31,MIL,46,2,632,33,62,.532,0,0,,33,62,.532,.532,25,63,.397,90,96,186,24,31,19,19,93,91
358,Kareem Rush\rushka01,SG,27,IND,71,15,1504,228,569,.401,102,262,.389,126,307,.410,.490,30,42,.714,19,149,168,89,42,19,62,108,588
359,John Salmons\salmojo01,SG,28,SAC,81,41,2517,381,799,.477,39,120,.325,342,679,.504,.501,214,260,.823,76,273,349,208,93,31,170,171,1015
360,Cheikh Samb\sambch01,C,23,DET,4,0,31,3,4,.750,0,0,,3,4,.750,.750,1,2,.500,3,4,7,0,1,2,1,8,7
361,Brian Scalabrine\scalabr01,PF,29,BOS,48,9,512,29,94,.309,15,46,.326,14,48,.292,.388,15,20,.750,22,57,79,40,9,8,26,63,88
362,Luis Scola\scolalu01,PF,27,HOU,82,39,2024,345,670,.515,0,3,.000,345,667,.517,.515,157,235,.668,174,351,525,106,60,19,105,235,847
363,Thabo Sefolosha\sefolth01,SG,23,CHI,69,22,1436,180,421,.428,29,88,.330,151,333,.453,.462,75,104,.721,50,205,255,129,61,30,93,128,464
364,Mouhamed Sene\senesa01,C,21,SEA,13,0,62,11,24,.458,0,0,,11,24,.458,.458,8,17,.471,7,9,16,1,0,7,0,9,30
365,Ramon Sessions\sessira01,PG,21,MIL,17,7,450,51,117,.436,3,7,.429,48,110,.436,.449,32,41,.780,8,50,58,127,17,3,36,26,137
366,Bobby Simmons\simmobo01,SF,27,MIL,70,21,1521,209,496,.421,60,171,.351,149,325,.458,.482,53,70,.757,67,159,226,80,50,5,78,140,531
367,Cedric Simmons\simmoce01,PF,22,TOT,14,0,87,4,14,.286,0,0,,4,14,.286,.286,0,10,.000,6,12,18,0,2,5,6,8,8
367,Cedric Simmons\simmoce01,PF,22,CLE,7,0,68,2,6,.333,0,0,,2,6,.333,.333,0,8,.000,5,10,15,0,2,5,4,7,4
367,Cedric Simmons\simmoce01,PF,22,CHI,7,0,19,2,8,.250,0,0,,2,8,.250,.250,0,2,.000,1,2,3,0,0,0,2,1,4
368,Courtney Sims\simsco01,C,24,IND,3,0,11,0,1,.000,0,0,,0,1,.000,.000,0,0,,1,1,2,1,0,0,0,2,0
369,Brian Skinner\skinnbr01,C,31,PHO,66,0,844,92,198,.465,2,3,.667,90,195,.462,.470,33,63,.524,63,175,238,15,21,77,39,112,219
370,Craig Smith\smithcr01,PF,24,MIN,77,11,1547,297,528,.563,0,9,.000,297,519,.572,.563,133,200,.665,123,230,353,60,36,17,89,217,727
371,J.R. Smith\smithjr01,SG,22,DEN,74,0,1421,311,674,.461,157,390,.403,154,284,.542,.578,128,178,.719,43,109,152,128,62,12,112,144,907
372,Jason Smith\smithja02,PF,21,PHI,76,1,1107,141,310,.455,4,14,.286,137,296,.463,.461,54,82,.659,77,153,230,20,22,50,48,142,340
373,Joe Smith\smithjo02,PF,32,TOT,77,36,1726,312,653,.478,0,3,.000,312,650,.480,.478,154,204,.755,163,238,401,66,34,47,71,186,778
373,Joe Smith\smithjo02,PF,32,CHI,50,35,1146,225,483,.466,0,1,.000,225,482,.467,.466,109,135,.807,108,157,265,47,25,31,49,113,559
373,Joe Smith\smithjo02,PF,32,CLE,27,1,580,87,170,.512,0,2,.000,87,168,.518,.512,45,69,.652,55,81,136,19,9,16,22,73,219
374,Josh Smith\smithjo03,PF,22,ATL,81,81,2873,518,1133,.457,25,99,.253,493,1034,.477,.468,333,469,.710,161,506,667,272,123,227,245,269,1394
375,Eric Snow\snower01,PG,34,CLE,22,5,305,6,38,.158,0,2,.000,6,36,.167,.158,10,22,.455,4,16,20,42,10,4,10,30,22
376,Kirk Snyder\snydeki01,SF-PF,24,TOT,36,18,761,96,189,.508,5,23,.217,91,166,.548,.521,64,88,.727,30,96,126,64,20,15,52,55,261
376,Kirk Snyder\snydeki01,PF,24,HOU,9,0,81,13,28,.464,2,9,.222,11,19,.579,.500,6,11,.545,5,7,12,8,1,1,4,6,34
376,Kirk Snyder\snydeki01,SF,24,MIN,27,18,680,83,161,.516,3,14,.214,80,147,.544,.525,58,77,.753,25,89,114,56,19,14,48,49,227
377,Darius Songaila\songada01,C,29,WAS,80,13,1554,214,467,.458,0,2,.000,214,465,.460,.458,67,73,.918,81,190,271,135,53,16,86,181,495
378,Jerry Stackhouse\stackje01,SG,33,DAL,58,13,1412,213,526,.405,60,184,.326,153,342,.447,.462,132,148,.892,33,100,133,145,28,10,86,82,618
379,DeShawn Stevenson\stevede01,SG,26,WAS,82,82,2564,301,780,.386,158,413,.383,143,367,.390,.487,157,197,.797,37,198,235,252,65,15,102,110,917
380,Peja Stojaković\stojape01,SF,30,NOH,77,77,2711,451,1026,.440,231,524,.441,220,502,.438,.552,130,140,.929,64,267,331,96,57,10,61,127,1263
381,Awvee Storey\storeaw01,SG,30,MIL,26,0,259,39,89,.438,0,7,.000,39,82,.476,.438,14,29,.483,31,23,54,16,7,1,10,41,92
382,Damon Stoudamire\stoudda01,PG,34,TOT,60,33,1037,120,337,.356,50,149,.336,70,188,.372,.430,27,34,.794,20,98,118,165,30,2,80,76,317
382,Damon Stoudamire\stoudda01,PG,34,MEM,29,29,624,77,194,.397,36,94,.383,41,100,.410,.490,21,26,.808,14,57,71,112,19,0,50,46,211
382,Damon Stoudamire\stoudda01,PG,34,SAS,31,4,413,43,143,.301,14,55,.255,29,88,.330,.350,6,8,.750,6,41,47,53,11,2,30,30,106
383,Salim Stoudamire\stoudsa01,PG,25,ATL,35,0,402,65,180,.361,29,85,.341,36,95,.379,.442,41,50,.820,4,20,24,28,7,5,21,34,200
384,Amar'e Stoudemire\stoudam01,C,25,PHO,79,79,2677,714,1211,.590,5,31,.161,709,1180,.601,.592,556,691,.805,178,541,719,118,64,163,174,294,1989
385,D.J. Strawberry\strawdj01,SG,22,PHO,33,0,270,29,92,.315,6,25,.240,23,67,.343,.348,9,19,.474,9,19,28,30,12,6,11,36,73
386,Rodney Stuckey\stuckro01,PG,21,DET,57,2,1081,153,382,.401,3,16,.188,150,366,.410,.404,127,156,.814,32,97,129,160,49,6,78,113,436
387,Robert Swift\swiftro01,C,22,SEA,8,4,98,6,17,.353,0,0,,6,17,.353,.353,2,2,1.000,6,12,18,1,5,6,10,16,14
388,Stromile Swift\swiftst01,PF,28,TOT,56,4,844,135,265,.509,0,2,.000,135,263,.513,.509,73,109,.670,64,135,199,26,15,54,51,113,343
388,Stromile Swift\swiftst01,PF,28,MEM,35,4,549,93,177,.525,0,2,.000,93,175,.531,.525,52,81,.642,46,83,129,22,10,36,39,74,238
388,Stromile Swift\swiftst01,PF,28,NJN,21,0,295,42,88,.477,0,0,,42,88,.477,.477,21,28,.750,18,52,70,4,5,18,12,39,105
389,Wally Szczerbiak\szczewa02,SF,30,TOT,75,2,1736,311,722,.431,90,218,.413,221,504,.438,.493,149,175,.851,34,183,217,104,23,12,76,103,861
389,Wally Szczerbiak\szczewa02,SF,30,SEA,50,1,1180,236,513,.460,71,166,.428,165,347,.476,.529,113,134,.843,16,120,136,69,14,5,56,67,656
389,Wally Szczerbiak\szczewa02,SF,30,CLE,25,1,556,75,209,.359,19,52,.365,56,157,.357,.404,36,41,.878,18,63,81,35,9,7,20,36,205
390,Sebastian Telfair\telfase01,PG,22,MIN,60,51,1933,223,556,.401,32,114,.281,191,442,.432,.430,78,105,.743,16,119,135,355,59,11,111,171,556
391,Jason Terry\terryja01,SG,30,DAL,82,34,2579,471,1008,.467,136,363,.375,335,645,.519,.535,191,223,.857,30,178,208,264,88,18,92,170,1269
392,Billy Thomas\thomabi01,SF,32,TOT,11,0,42,4,17,.235,4,16,.250,0,1,.000,.353,2,2,1.000,0,2,2,0,1,0,4,4,14
392,Billy Thomas\thomabi01,SF,32,NJN,4,0,8,0,3,.000,0,3,.000,0,0,,.000,2,2,1.000,0,0,0,0,0,0,1,0,2
392,Billy Thomas\thomabi01,SF,32,CLE,7,0,34,4,14,.286,4,13,.308,0,1,.000,.429,0,0,,0,2,2,0,1,0,3,4,12
393,Kenny Thomas\thomake01,PF,30,SAC,23,3,281,16,38,.421,0,0,,16,38,.421,.421,0,5,.000,18,43,61,13,6,1,21,38,32
394,Kurt Thomas\thomaku01,C-PF,35,TOT,70,48,1584,195,396,.492,0,1,.000,195,395,.494,.492,53,80,.663,130,377,507,67,56,57,46,188,443
394,Kurt Thomas\thomaku01,C,35,SEA,42,39,1060,139,271,.513,0,0,,139,271,.513,.513,39,56,.696,94,275,369,53,35,43,28,131,317
394,Kurt Thomas\thomaku01,PF,35,SAS,28,9,524,56,125,.448,0,1,.000,56,124,.452,.448,14,24,.583,36,102,138,14,21,14,18,57,126
395,Tim Thomas\thomati01,PF,30,LAC,63,51,1940,291,705,.413,83,271,.306,208,434,.479,.472,115,153,.752,62,261,323,171,40,29,98,192,780
396,Tyrus Thomas\thomaty01,PF,21,CHI,74,27,1330,186,440,.423,1,6,.167,185,434,.426,.424,129,174,.741,102,240,342,90,48,72,77,170,502
397,Al Thornton\thornal01,PF,24,LAC,79,31,2158,374,871,.429,43,130,.331,331,741,.447,.454,214,288,.743,98,260,358,98,46,43,128,195,1005
398,Jamaal Tinsley\tinslja01,PG,29,IND,39,36,1293,176,463,.380,40,141,.284,136,322,.422,.423,72,100,.720,24,117,141,326,66,10,130,97,464
399,Alando Tucker\tuckeal02,SF,23,PHO,6,0,48,8,22,.364,1,4,.250,7,18,.389,.386,5,6,.833,4,4,8,0,0,1,0,2,22
400,Ronny Turiaf\turiaro01,C,25,LAL,78,21,1458,188,397,.474,0,1,.000,188,396,.475,.474,140,186,.753,95,211,306,128,28,108,72,199,516
401,Hedo Türkoğlu\turkohe01,SF,28,ORL,82,82,3026,556,1219,.456,166,415,.400,390,804,.485,.524,324,391,.829,83,388,471,409,74,25,246,244,1602
402,Ime Udoka\udokaim01,PF,30,SAS,73,0,1316,159,375,.424,61,165,.370,98,210,.467,.505,44,58,.759,36,192,228,63,56,17,58,127,423
403,Beno Udrih\udrihbe01,PG,25,SAC,65,51,2080,328,708,.463,53,137,.387,275,571,.482,.501,125,147,.850,34,183,217,282,56,10,148,138,834
404,Anderson Varejão\varejan01,C,25,CLE,48,13,1320,136,295,.461,0,2,.000,136,293,.464,.461,49,82,.598,134,265,399,53,37,26,59,134,321
405,Jacque Vaughn\vaughja01,PG,32,SAS,74,9,1139,121,283,.428,3,10,.300,118,273,.432,.433,61,80,.763,13,61,74,159,23,1,54,97,306
406,Charlie Villanueva\villach01,PF,23,MIL,76,31,1829,354,814,.435,55,185,.297,299,629,.475,.469,123,157,.783,145,321,466,78,30,35,107,174,886
407,Marcus Vinicius\vincima01,SF,23,NOH,13,0,69,9,20,.450,5,12,.417,4,8,.500,.575,5,11,.455,1,7,8,2,1,1,3,4,28
408,Jake Voskuhl\voskuja01,C,30,MIL,44,0,386,37,80,.463,0,0,,37,80,.463,.463,24,29,.828,30,67,97,13,9,21,29,83,98
409,Sasha Vujačić\vujacsa01,SG,23,LAL,72,0,1279,219,482,.454,118,270,.437,101,212,.476,.577,76,91,.835,19,135,154,72,36,5,52,107,632
410,Dwyane Wade\wadedw01,SG,26,MIA,51,49,1954,439,937,.469,22,77,.286,417,860,.485,.480,354,467,.758,45,169,214,354,87,37,224,137,1254
411,Von Wafer\wafervo01,SG,22,TOT,29,0,154,17,61,.279,4,26,.154,13,35,.371,.311,8,12,.667,1,18,19,7,2,3,13,7,46
411,Von Wafer\wafervo01,SG,22,DEN,21,0,90,10,38,.263,1,15,.067,9,23,.391,.276,6,8,.750,1,9,10,5,2,1,11,4,27
411,Von Wafer\wafervo01,SG,22,POR,8,0,64,7,23,.304,3,11,.273,4,12,.333,.370,2,4,.500,0,9,9,2,0,2,2,3,19
412,Antoine Walker\walkean02,PF,31,MIN,46,1,892,136,375,.363,61,188,.324,75,187,.401,.444,35,66,.530,56,112,168,45,33,8,46,80,368
413,Ben Wallace*\wallabe01,C-PF,33,TOT,72,72,2205,138,352,.392,0,4,.000,138,348,.397,.392,72,169,.426,234,370,604,105,88,117,67,121,348
413,Ben Wallace*\wallabe01,C,33,CHI,50,50,1627,101,271,.373,0,4,.000,101,267,.378,.373,53,125,.424,175,266,441,92,69,80,49,86,255
413,Ben Wallace*\wallabe01,PF,33,CLE,22,22,578,37,81,.457,0,0,,37,81,.457,.457,19,44,.432,59,104,163,13,19,37,18,35,93
414,Gerald Wallace\wallage01,PF,25,CHA,62,59,2376,408,908,.449,71,221,.321,337,687,.491,.488,313,428,.731,58,315,373,216,131,58,180,189,1200
415,Rasheed Wallace\wallara01,C,33,DET,77,76,2346,376,870,.432,112,315,.356,264,555,.476,.497,115,150,.767,84,427,511,137,91,129,86,213,979
416,Luke Walton\waltolu01,SF,27,LAL,74,31,1729,215,478,.450,28,84,.333,187,394,.475,.479,77,109,.706,85,206,291,218,60,18,100,133,535
417,Hakim Warrick\warriha01,PF,25,MEM,75,30,1754,328,653,.502,13,48,.271,315,605,.521,.512,183,260,.704,123,233,356,53,36,28,85,156,852
418,Darius Washington\washida01,SG,22,SAS,18,0,146,21,48,.438,4,12,.333,17,36,.472,.479,7,13,.538,4,16,20,15,5,0,14,16,53
419,Darryl Watkins\watkida01,C,23,SAC,9,0,71,5,15,.333,0,0,,5,15,.333,.333,2,5,.400,5,7,12,0,2,2,7,8,12
420,C.J. Watson\watsocj01,PG,23,GSW,32,0,368,43,101,.426,9,26,.346,34,75,.453,.470,23,29,.793,13,19,32,35,15,0,18,19,118
421,Earl Watson\watsoea01,PG,28,SEA,78,73,2269,339,747,.454,49,132,.371,290,615,.472,.487,111,145,.766,43,182,225,531,69,11,175,158,838
422,Chris Webber*\webbech01,PF,34,GSW,9,8,126,15,31,.484,0,0,,15,31,.484,.484,5,12,.417,2,30,32,18,4,6,11,17,35
423,Martell Webster\webstma02,SF,21,POR,75,70,2132,277,656,.422,123,317,.388,154,339,.454,.516,122,166,.735,54,242,296,90,42,28,83,159,799
424,Bonzi Wells\wellsbo01,SG,31,TOT,73,7,1562,252,569,.443,12,50,.240,240,519,.462,.453,146,227,.643,84,247,331,97,75,32,103,157,662
424,Bonzi Wells\wellsbo01,SG,31,HOU,51,7,1124,175,412,.425,8,38,.211,167,374,.447,.434,111,174,.638,63,197,260,80,51,24,76,113,469
424,Bonzi Wells\wellsbo01,SG,31,NOH,22,0,438,77,157,.490,4,12,.333,73,145,.503,.503,35,53,.660,21,50,71,17,24,8,27,44,193
425,David West\westda01,PF,27,NOH,76,76,2870,629,1305,.482,6,25,.240,623,1280,.487,.484,300,353,.850,180,495,675,177,62,99,165,208,1564
426,Delonte West\westde01,PG,24,TOT,61,31,1533,196,475,.413,48,135,.356,148,340,.435,.463,67,91,.736,31,162,193,229,59,29,117,103,507
426,Delonte West\westde01,PG,24,SEA,35,5,727,97,250,.388,19,56,.339,78,194,.402,.426,26,39,.667,13,83,96,113,30,10,66,44,239
426,Delonte West\westde01,PG,24,CLE,26,26,806,99,225,.440,29,79,.367,70,146,.479,.504,41,52,.788,18,79,97,116,29,19,51,59,268
427,Mario West\westma02,SG,23,ATL,64,2,269,21,49,.429,0,4,.000,21,45,.467,.429,17,26,.654,26,22,48,13,12,4,9,61,59
428,Chris Wilcox\wilcoch01,PF,25,SEA,62,55,1739,334,638,.524,0,3,.000,334,635,.526,.524,160,248,.645,126,307,433,74,46,36,103,174,828
429,Damien Wilkins\wilkida02,SF,28,SEA,76,31,1843,271,673,.403,50,155,.323,221,518,.427,.440,106,144,.736,72,173,245,150,62,19,89,128,698
430,Mike Wilks\wilksmi01,PG,28,TOT,15,0,188,17,36,.472,3,8,.375,14,28,.500,.514,4,4,1.000,5,14,19,14,9,0,9,13,41
430,Mike Wilks\wilksmi01,PG,28,DEN,8,0,122,10,23,.435,2,5,.400,8,18,.444,.478,2,2,1.000,4,8,12,6,5,0,5,9,24
430,Mike Wilks\wilksmi01,PG,28,WAS,4,0,44,2,4,.500,1,2,.500,1,2,.500,.625,0,0,,1,5,6,3,3,0,1,2,5
430,Mike Wilks\wilksmi01,PG,28,SEA,3,0,22,5,9,.556,0,1,.000,5,8,.625,.556,2,2,1.000,0,1,1,5,1,0,3,2,12
431,Aaron Williams\williaa01,C,36,LAC,30,5,297,27,55,.491,0,0,,27,55,.491,.491,14,18,.778,15,46,61,9,12,15,13,44,68
432,Deron Williams\willide01,PG,23,UTA,82,82,3059,566,1117,.507,83,210,.395,483,907,.533,.544,330,411,.803,34,209,243,862,90,23,279,200,1545
433,Jason Williams\willija02,PG,32,MIA,67,53,1886,211,550,.384,97,275,.353,114,275,.415,.472,69,80,.863,12,118,130,307,83,5,91,93,588
434,Justin Williams\williju01,C,23,TOT,23,0,123,13,29,.448,0,0,,13,29,.448,.448,8,26,.308,20,29,49,0,5,5,4,17,34
434,Justin Williams\williju01,C,23,SAC,22,0,117,12,26,.462,0,0,,12,26,.462,.462,7,22,.318,19,29,48,0,5,5,3,14,31
434,Justin Williams\williju01,C,23,HOU,1,0,6,1,3,.333,0,0,,1,3,.333,.333,1,4,.250,1,0,1,0,0,0,1,3,3
435,Lou Williams\willilo02,PG,21,PHI,80,0,1862,319,752,.424,55,153,.359,264,599,.441,.461,227,290,.783,41,126,167,253,81,13,125,130,920
436,Marcus Williams\willima03,PG,22,NJN,53,7,854,111,293,.379,54,142,.380,57,151,.377,.471,37,47,.787,14,87,101,140,25,3,75,52,313
437,Marcus Williams\willima04,PF-SF,21,TOT,11,0,36,5,20,.250,0,0,,5,20,.250,.250,0,0,,4,8,12,3,1,1,0,3,10
437,Marcus Williams\willima04,SF,21,SAS,1,0,2,0,1,.000,0,0,,0,1,.000,.000,0,0,,0,0,0,0,0,1,0,0,0
437,Marcus Williams\willima04,PF,21,LAC,10,0,34,5,19,.263,0,0,,5,19,.263,.263,0,0,,4,8,12,3,1,0,0,3,10
438,Marvin Williams\willima02,SF,21,ATL,80,80,2765,424,918,.462,1,10,.100,423,908,.466,.462,336,409,.822,119,338,457,137,81,33,127,225,1185
439,Mo Williams\willima01,PG,25,MIL,66,66,2410,441,919,.480,89,231,.385,352,688,.512,.528,166,194,.856,37,193,230,419,78,10,182,188,1137
440,Sean Williams\willise01,C,21,NJN,73,29,1278,164,305,.538,0,0,,164,305,.538,.538,81,133,.609,115,207,322,28,28,106,70,193,409
441,Shawne Williams\willish03,SF,21,IND,65,3,967,159,372,.427,43,137,.314,116,235,.494,.485,76,106,.717,54,122,176,59,26,26,58,132,437
442,Shelden Williams\willish02,PF,24,TOT,64,0,776,92,212,.434,0,2,.000,92,210,.438,.434,71,105,.676,68,137,205,19,22,21,35,110,255
442,Shelden Williams\willish02,PF,24,ATL,36,0,414,37,100,.370,0,1,.000,37,99,.374,.370,35,51,.686,34,73,107,11,13,11,14,60,109
442,Shelden Williams\willish02,PF,24,SAC,28,0,362,55,112,.491,0,1,.000,55,111,.495,.491,36,54,.667,34,64,98,8,9,10,21,50,146
443,Loren Woods\woodslo01,C,29,HOU,7,0,17,3,5,.600,0,0,,3,5,.600,.600,0,0,,0,1,1,2,0,0,0,2,6
444,Metta World Peace\artesro01,SF,28,SAC,57,54,2172,436,962,.453,84,221,.380,352,741,.475,.497,212,295,.719,101,227,328,199,133,38,148,159,1168
445,Antoine Wright\wrighan01,SG,23,TOT,56,10,1232,136,329,.413,32,110,.291,104,219,.475,.462,46,67,.687,40,107,147,80,28,21,50,127,350
445,Antoine Wright\wrighan01,SG,23,NJN,41,10,1056,115,287,.401,27,101,.267,88,186,.473,.448,41,58,.707,35,90,125,67,26,17,39,105,298
445,Antoine Wright\wrighan01,SG,23,DAL,15,0,176,21,42,.500,5,9,.556,16,33,.485,.560,5,9,.556,5,17,22,13,2,4,11,22,52
446,Brandan Wright\wrighbr03,PF,20,GSW,38,6,376,62,112,.554,0,0,,62,112,.554,.554,27,40,.675,38,61,99,9,6,22,13,36,151
447,Dorell Wright\wrighdo01,SF,22,MIA,44,34,1104,143,293,.488,4,11,.364,139,282,.493,.495,57,69,.826,48,172,220,60,29,41,29,79,347
448,Julian Wright\wrighju01,SF,20,NOH,57,1,640,90,169,.533,10,24,.417,80,145,.552,.562,33,52,.635,33,84,117,40,29,12,34,43,223
449,Lorenzen Wright\wrighlo02,C,32,TOT,18,1,161,6,21,.286,0,0,,6,21,.286,.286,3,6,.500,8,30,38,4,3,3,4,31,15
449,Lorenzen Wright\wrighlo02,C,32,ATL,13,1,148,5,17,.294,0,0,,5,17,.294,.294,3,6,.500,7,30,37,3,3,3,2,26,13
449,Lorenzen Wright\wrighlo02,C,32,SAC,5,0,13,1,4,.250,0,0,,1,4,.250,.250,0,0,,1,0,1,1,0,0,2,5,2
450,Nick Young\youngni01,SG,22,WAS,75,2,1158,210,478,.439,40,100,.400,170,378,.450,.481,101,124,.815,23,92,115,63,35,7,94,130,561
451,Thaddeus Young\youngth01,PF,19,PHI,74,22,1554,264,490,.539,6,19,.316,258,471,.548,.545,76,103,.738,120,192,312,58,73,8,64,126,610