Rk,Player,Pos,Age,Tm,G,GS,MP,FG,FGA,FG%,3P,3PA,3P%,2P,2PA,2P%,eFG%,FT,FTA,FT%,ORB,DRB,TRB,AST,STL,BLK,TOV,PF,PTS
1,Alex Acker\ackeral01,SG,26,TOT,25,0,199,30,76,.395,7,20,.350,23,56,.411,.441,5,10,.500,8,16,24,12,5,4,7,9,72
1,Alex Acker\ackeral01,SG,26,DET,7,0,20,4,11,.364,0,4,.000,4,7,.571,.364,1,2,.500,0,2,2,1,2,1,0,0,9
1,Alex Acker\ackeral01,SG,26,LAC,18,0,179,26,65,.400,7,16,.438,19,49,.388,.454,4,8,.500,8,14,22,11,3,3,7,9,63
2,Hassan Adams\adamsha01,SG,24,TOR,12,0,52,4,13,.308,0,0,,4,13,.308,.308,3,6,.500,1,6,7,1,1,1,4,4,11
3,Arron Afflalo\afflaar01,SG,23,DET,74,8,1234,131,300,.437,43,107,.402,88,193,.456,.508,58,71,.817,30,104,134,44,28,13,43,144,363
4,Maurice Ager\agerma01,SG,24,NJN,20,0,97,15,43,.349,0,6,.000,15,37,.405,.349,4,8,.500,3,7,10,3,1,2,4,17,34
5,Blake Ahearn\ahearbl01,PG,24,SAS,3,0,19,2,6,.333,2,4,.500,0,2,.000,.500,2,2,1.000,0,1,1,2,1,0,1,3,8
6,Alexis Ajinça\ajincal01,PF,20,CHA,31,4,182,25,69,.362,0,2,.000,25,67,.373,.362,20,28,.714,9,21,30,3,7,6,12,34,70
7,LaMarcus Aldridge\aldrila01,PF,23,POR,81,81,3004,601,1243,.484,7,28,.250,594,1215,.489,.486,261,334,.781,234,371,605,157,77,77,121,207,1470
8,Joe Alexander\alexajo01,SF,22,MIL,59,0,716,102,245,.416,16,46,.348,86,199,.432,.449,58,83,.699,44,71,115,42,15,29,52,107,278
9,Malik Allen\allenma01,PF,30,MIL,49,3,579,73,170,.429,0,1,.000,73,169,.432,.429,10,21,.476,35,68,103,35,7,12,20,89,156
10,Ray Allen*\allenra02,SG,33,BOS,79,79,2876,499,1040,.480,199,486,.409,300,554,.542,.575,237,249,.952,66,212,278,218,69,13,134,157,1434
11,Tony Allen\allento01,SG,27,BOS,46,2,887,137,284,.482,6,27,.222,131,257,.510,.493,79,109,.725,22,82,104,66,54,23,77,98,359
12,Morris Almond\almonmo01,SG,23,UTA,25,1,255,33,81,.407,5,17,.294,28,64,.438,.438,21,26,.808,9,27,36,7,4,4,16,31,92
13,Rafer Alston\alstora01,PG,32,TOT,77,76,2447,316,820,.385,112,331,.338,204,489,.417,.454,156,208,.750,33,194,227,406,108,10,140,135,900
13,Rafer Alston\alstora01,PG,32,HOU,48,48,1591,193,522,.370,80,230,.348,113,292,.387,.446,86,109,.789,25,119,144,258,57,7,88,72,552
13,Rafer Alston\alstora01,PG,32,ORL,29,28,856,123,298,.413,32,101,.317,91,197,.462,.466,70,99,.707,8,75,83,148,51,3,52,63,348
14,Lou Amundson\amundlo01,PF,26,PHO,76,0,1044,134,250,.536,0,1,.000,134,249,.538,.536,53,120,.442,128,142,270,28,32,65,56,154,321
15,Chris Andersen\anderch01,C,30,DEN,71,1,1460,160,292,.548,2,10,.200,158,282,.560,.551,130,181,.718,163,279,442,31,41,175,69,174,452
16,Ryan Anderson\anderry01,PF,20,NJN,66,30,1312,160,407,.393,69,189,.365,91,218,.417,.478,98,116,.845,104,207,311,52,44,20,63,157,487
17,Carmelo Anthony\anthoca01,SF,24,DEN,66,66,2277,535,1207,.443,63,170,.371,472,1037,.455,.469,371,468,.793,106,344,450,222,75,24,199,195,1504
18,Joel Anthony\anthojo01,C,26,MIA,65,28,1048,57,118,.483,0,0,,57,118,.483,.483,30,46,.652,89,108,197,27,20,93,41,139,144
19,Gilbert Arenas\arenagi01,PG,27,WAS,2,2,63,6,23,.261,2,7,.286,4,16,.250,.304,12,16,.750,1,8,9,20,0,1,1,4,26
20,Trevor Ariza\arizatr01,SF,23,LAL,82,20,1999,274,596,.460,61,191,.319,213,405,.526,.511,120,169,.710,111,241,352,145,137,24,87,166,729
21,Hilton Armstrong\armsthi01,C,24,NOH,70,29,1092,138,246,.561,0,2,.000,138,244,.566,.561,62,98,.633,81,114,195,29,26,45,80,181,338
22,Darrell Arthur\arthuda01,PF,20,MEM,76,64,1464,191,436,.438,0,2,.000,191,434,.440,.438,40,60,.667,108,238,346,43,52,52,47,206,422
23,Chucky Atkins\atkinch01,PG,34,TOT,33,0,412,34,113,.301,15,57,.263,19,56,.339,.367,15,16,.938,5,19,24,59,10,2,23,27,98
23,Chucky Atkins\atkinch01,PG,34,DEN,14,0,115,9,27,.333,5,17,.294,4,10,.400,.426,4,4,1.000,0,6,6,28,2,1,10,5,27
23,Chucky Atkins\atkinch01,PG,34,OKC,19,0,297,25,86,.291,10,40,.250,15,46,.326,.349,11,12,.917,5,13,18,31,8,1,13,22,71
24,D.J. Augustin\augusdj01,PG,21,CHA,72,12,1908,267,621,.430,108,246,.439,159,375,.424,.517,208,233,.893,17,116,133,250,42,2,119,140,850
25,Kelenna Azubuike\azubuke01,SF,25,GSW,74,51,2375,392,845,.464,94,210,.448,298,635,.469,.520,185,229,.808,112,258,370,117,57,50,95,183,1063
26,Renaldo Balkman\balkmre01,PF,24,DEN,53,10,780,110,197,.558,2,7,.286,108,190,.568,.563,42,65,.646,86,117,203,34,47,23,35,98,264
27,Marcus Banks\banksma01,PG,27,TOT,22,0,206,21,57,.368,3,19,.158,18,38,.474,.395,11,18,.611,1,17,18,28,11,2,14,26,56
27,Marcus Banks\banksma01,PG,27,MIA,16,0,166,15,39,.385,2,14,.143,13,25,.520,.410,10,15,.667,0,15,15,22,10,2,11,21,42
27,Marcus Banks\banksma01,PG,27,TOR,6,0,40,6,18,.333,1,5,.200,5,13,.385,.361,1,3,.333,1,2,3,6,1,0,3,5,14
28,Leandro Barbosa\barbole01,SG,26,PHO,70,11,1705,366,759,.482,90,240,.375,276,519,.532,.542,171,194,.881,34,147,181,162,82,7,93,115,993
29,J.J. Barea\bareajo01,SG,24,DAL,79,15,1600,246,557,.442,55,154,.357,191,403,.474,.491,70,93,.753,36,141,177,269,37,5,105,121,617
30,Andrea Bargnani\bargnan01,PF,23,TOR,78,59,2453,431,958,.450,119,291,.409,312,667,.468,.512,221,266,.831,70,346,416,94,34,97,135,242,1202
31,Matt Barnes\barnema02,PF,28,PHO,77,40,2082,285,674,.423,117,341,.343,168,333,.505,.510,101,136,.743,79,342,421,212,52,26,130,209,788
32,Brent Barry\barrybr01,SG,37,HOU,56,1,857,70,172,.407,49,131,.374,21,41,.512,.549,19,20,.950,17,77,94,78,24,3,48,45,208
33,Brandon Bass\bassbr01,C,23,DAL,81,0,1574,252,508,.496,0,6,.000,252,502,.502,.496,182,210,.867,129,238,367,43,27,55,86,140,686
34,Maceo Baston\bastoma01,PF,33,IND,27,0,217,25,46,.543,0,1,.000,25,45,.556,.543,17,27,.630,22,30,52,7,6,10,12,39,67
35,Tony Battie\battito01,PF,32,ORL,77,3,1202,158,323,.489,2,9,.222,156,314,.497,.492,54,82,.659,92,186,278,31,26,25,46,112,372
36,Shane Battier\battish01,SG,30,HOU,60,59,2031,145,354,.410,91,237,.384,54,117,.462,.538,55,67,.821,52,233,285,137,48,54,49,114,436
37,Nicolas Batum\batumni01,SF,20,POR,79,76,1454,161,361,.446,62,168,.369,99,193,.513,.532,42,52,.808,84,136,220,74,50,40,50,139,426
38,Jerryd Bayless\bayleje01,PG,20,POR,53,0,655,69,189,.365,7,27,.259,62,162,.383,.384,83,103,.806,8,49,57,78,16,2,56,81,228
39,Michael Beasley\beaslmi01,PF,20,MIA,81,19,2009,452,957,.472,33,81,.407,419,876,.478,.490,186,241,.772,110,329,439,83,41,37,121,184,1123
40,Marco Belinelli\belinma01,SG,22,GSW,42,23,882,140,317,.442,52,131,.397,88,186,.473,.524,40,52,.769,10,61,71,88,36,1,59,73,372
41,Charlie Bell\bellch01,SG,29,MIL,70,23,1783,217,524,.414,87,240,.363,130,284,.458,.497,66,80,.825,32,102,134,151,50,7,76,138,587
42,Raja Bell\bellra01,SG,32,TOT,67,66,2315,299,684,.437,114,271,.421,185,413,.448,.520,87,102,.853,41,202,243,142,50,8,86,166,799
42,Raja Bell\bellra01,SG,32,PHO,22,22,712,76,177,.429,44,94,.468,32,83,.386,.554,16,21,.762,8,56,64,29,13,2,18,57,212
42,Raja Bell\bellra01,SG,32,CHA,45,44,1603,223,507,.440,70,177,.395,153,330,.464,.509,71,81,.877,33,146,179,113,37,6,68,109,587
43,Mike Bibby\bibbymi01,PG,30,ATL,79,79,2740,437,1005,.435,167,428,.390,270,577,.468,.518,135,171,.789,38,240,278,392,98,11,128,145,1176
44,Andris Biedriņš\biedran01,C,22,GSW,62,58,1863,308,533,.578,0,1,.000,308,532,.579,.578,119,216,.551,223,470,693,121,63,96,110,236,735
45,Chauncey Billups\billuch01,PG,32,TOT,79,79,2789,410,980,.418,162,397,.408,248,583,.425,.501,418,458,.913,32,207,239,506,93,18,177,161,1400
45,Chauncey Billups\billuch01,PG,32,DET,2,2,70,7,21,.333,2,7,.286,5,14,.357,.381,9,10,.900,1,9,10,15,3,1,4,3,25
45,Chauncey Billups\billuch01,PG,32,DEN,77,77,2719,403,959,.420,160,390,.410,243,569,.427,.504,409,448,.913,31,198,229,491,90,17,173,158,1375
46,Steve Blake\blakest01,PG,28,POR,69,69,2188,277,647,.428,140,328,.427,137,319,.429,.536,63,75,.840,28,145,173,348,69,4,108,126,757
47,Andray Blatche\blatcan01,C,22,WAS,71,36,1703,297,630,.471,5,21,.238,292,609,.479,.475,114,162,.704,126,252,378,118,53,74,117,211,713
48,Mark Blount\blounma01,C,33,MIA,20,0,207,30,78,.385,11,27,.407,19,51,.373,.455,8,13,.615,10,31,41,4,1,7,14,17,79
49,Keith Bogans\boganke01,SG,28,TOT,65,15,1272,119,324,.367,74,218,.339,45,106,.425,.481,52,57,.912,31,171,202,64,43,4,41,105,364
49,Keith Bogans\boganke01,SG,28,ORL,36,15,787,63,175,.360,42,126,.333,21,49,.429,.480,21,24,.875,15,96,111,31,23,2,19,61,189
49,Keith Bogans\boganke01,SG,28,MIL,29,0,485,56,149,.376,32,92,.348,24,57,.421,.483,31,33,.939,16,75,91,33,20,2,22,44,175
50,Andrew Bogut\bogutan01,C,24,MIL,36,33,1124,183,317,.577,0,0,,183,317,.577,.577,56,98,.571,117,252,369,72,23,37,86,130,422
51,Matt Bonner\bonnema01,PF,28,SAS,81,67,1928,266,536,.496,118,268,.440,148,268,.552,.606,17,23,.739,97,289,386,82,47,26,37,190,667
52,Josh Boone\boonejo01,C,24,NJN,62,7,995,113,214,.528,0,0,,113,214,.528,.528,32,85,.376,104,154,258,31,22,48,31,106,258
53,Calvin Booth\boothca01,C,32,TOT,8,0,56,5,10,.500,0,0,,5,10,.500,.500,6,8,.750,5,6,11,0,1,2,1,10,16
53,Calvin Booth\boothca01,C,32,MIN,1,0,1,0,0,,0,0,,0,0,,,0,0,,1,0,1,0,0,0,0,0,0
53,Calvin Booth\boothca01,C,32,SAC,7,0,55,5,10,.500,0,0,,5,10,.500,.500,6,8,.750,4,6,10,0,1,2,1,10,16
54,Carlos Boozer\boozeca01,PF,27,UTA,37,37,1197,251,512,.490,0,0,,251,512,.490,.490,97,139,.698,111,274,385,79,39,7,79,132,599
55,Chris Bosh*\boshch01,C,24,TOR,77,77,2928,615,1263,.487,12,49,.245,603,1214,.497,.492,504,617,.817,215,556,771,191,67,77,174,189,1746
56,Bruce Bowen\bowenbr01,SF,37,SAS,80,10,1506,79,187,.422,42,98,.429,37,89,.416,.535,14,26,.538,16,129,145,40,36,13,25,123,214
57,Ryan Bowen\bowenry01,SF,33,NOH,21,3,219,22,38,.579,0,0,,22,38,.579,.579,3,5,.600,10,14,24,9,14,5,5,37,47
58,Elton Brand\brandel01,PF,29,PHI,29,23,920,163,365,.447,0,0,,163,365,.447,.447,73,108,.676,77,177,254,37,17,45,68,78,399
59,Corey Brewer\breweco01,SF,22,MIN,15,8,307,37,90,.411,5,12,.417,32,78,.410,.439,14,19,.737,18,31,49,25,15,3,13,37,93
60,Ronnie Brewer\brewero02,SF,23,UTA,81,80,2605,421,828,.508,22,85,.259,399,743,.537,.522,247,352,.702,101,199,300,179,138,30,110,128,1111
61,Aaron Brooks\brookaa01,PG,24,HOU,80,35,1998,316,783,.404,113,309,.366,203,474,.428,.476,149,172,.866,33,124,157,238,46,8,125,152,894
62,Andre Brown\brownan01,PF,27,CHA,4,0,41,1,7,.143,0,0,,1,7,.143,.143,2,2,1.000,7,5,12,1,1,0,5,9,4
63,Bobby Brown\brownbo02,SG-PG,24,TOT,68,2,931,141,360,.392,45,130,.346,96,230,.417,.454,34,43,.791,14,38,52,117,21,3,63,95,361
63,Bobby Brown\brownbo02,SG,24,SAC,47,1,675,94,247,.381,31,94,.330,63,153,.412,.443,26,34,.765,8,28,36,87,15,1,47,74,245
63,Bobby Brown\brownbo02,PG,24,MIN,21,1,256,47,113,.416,14,36,.389,33,77,.429,.478,8,9,.889,6,10,16,30,6,2,16,21,116
64,Dee Brown\brownde03,PG,24,TOT,19,11,261,18,49,.367,7,24,.292,11,25,.440,.439,3,5,.600,7,22,29,36,10,0,17,28,46
64,Dee Brown\brownde03,PG,24,WAS,17,11,233,17,44,.386,6,20,.300,11,24,.458,.455,1,3,.333,7,21,28,33,10,0,14,22,41
64,Dee Brown\brownde03,PG,24,PHO,2,0,28,1,5,.200,1,4,.250,0,1,.000,.300,2,2,1.000,0,1,1,3,0,0,3,6,5
65,Devin Brown\brownde02,SG,30,NOH,63,5,869,111,313,.355,28,97,.289,83,216,.384,.399,78,100,.780,31,88,119,54,32,5,54,81,328
66,Kwame Brown\brownkw01,C,26,DET,58,30,999,90,169,.533,0,0,,90,169,.533,.533,63,122,.516,91,199,290,32,24,24,50,138,243
67,Shannon Brown\brownsh01,SG,23,TOT,48,0,477,78,165,.473,14,37,.378,64,128,.500,.515,32,39,.821,11,33,44,38,22,7,38,42,202
67,Shannon Brown\brownsh01,SG,23,CHA,30,0,341,56,123,.455,8,28,.286,48,95,.505,.488,24,30,.800,8,16,24,28,18,5,29,33,144
67,Shannon Brown\brownsh01,SG,23,LAL,18,0,136,22,42,.524,6,9,.667,16,33,.485,.595,8,9,.889,3,17,20,10,4,2,9,9,58
68,Kobe Bryant*\bryanko01,SG,30,LAL,82,82,2960,800,1712,.467,118,336,.351,682,1376,.496,.502,483,564,.856,90,339,429,399,120,37,210,189,2201
69,Greg Buckner\buckngr01,SF,32,MEM,63,0,878,61,159,.384,13,51,.255,48,108,.444,.425,20,25,.800,32,98,130,57,29,8,38,108,155
70,Caron Butler\butleca01,SG,28,WAS,67,67,2585,491,1085,.453,65,210,.310,426,875,.487,.482,345,402,.858,118,296,414,290,106,20,210,165,1392
71,Rasual Butler\butlera01,SF,29,NOH,82,74,2614,348,803,.433,140,359,.390,208,444,.468,.521,86,110,.782,49,222,271,75,51,61,59,159,922
72,Andrew Bynum\bynuman01,C,21,LAL,50,50,1446,281,502,.560,0,0,,281,502,.560,.560,152,215,.707,137,261,398,71,18,90,85,157,714
73,Will Bynum\bynumwi01,PG,26,DET,57,1,803,156,342,.456,3,19,.158,153,323,.474,.461,95,119,.798,19,56,75,157,34,2,76,85,410
74,José Calderón\caldejo01,PG,27,TOR,68,68,2333,320,644,.497,82,202,.406,238,442,.538,.561,151,154,.981,16,178,194,607,74,7,143,114,873
75,Marcus Camby\cambyma01,C,34,LAC,62,55,1925,254,496,.512,1,4,.250,253,492,.514,.513,132,182,.725,161,529,690,127,51,132,93,129,641
76,Brian Cardinal\cardibr01,PF,31,MIN,64,4,909,65,169,.385,30,92,.326,35,77,.455,.473,30,35,.857,39,103,142,76,37,13,48,135,190
77,Rodney Carney\carnero01,SG,24,MIN,67,6,1199,176,423,.416,79,226,.350,97,197,.492,.509,50,66,.758,36,90,126,26,45,29,43,94,481
78,Matt Carroll\carroma01,SG,28,TOT,55,10,616,65,171,.380,13,53,.245,52,118,.441,.418,21,25,.840,7,62,69,27,21,6,33,67,164
78,Matt Carroll\carroma01,SG,28,CHA,34,10,475,56,138,.406,12,45,.267,44,93,.473,.449,15,19,.789,5,50,55,24,18,5,26,53,139
78,Matt Carroll\carroma01,SG,28,DAL,21,0,141,9,33,.273,1,8,.125,8,25,.320,.288,6,6,1.000,2,12,14,3,3,1,7,14,25
79,Anthony Carter\cartean01,PG,33,DEN,78,5,1787,167,386,.433,21,88,.239,146,298,.490,.460,57,78,.731,40,165,205,364,96,13,155,142,412
80,Vince Carter\cartevi01,SG,32,NJN,80,80,2946,588,1345,.437,151,392,.385,437,953,.459,.493,335,410,.817,74,336,410,376,82,38,166,234,1662
81,Mario Chalmers\chalmma01,PG,22,MIA,82,82,2626,278,662,.420,114,311,.367,164,351,.467,.506,148,193,.767,37,191,228,403,160,8,165,240,818
82,Tyson Chandler\chandty01,C,26,NOH,45,45,1445,160,283,.565,0,0,,160,283,.565,.565,77,133,.579,163,230,393,22,15,56,70,144,397
83,Wilson Chandler\chandwi01,SF,21,NYK,82,70,2735,455,1054,.432,103,314,.328,352,740,.476,.481,171,215,.795,91,354,445,170,71,75,139,250,1184
84,Speedy Claxton\claxtsp01,PG,30,ATL,2,0,15,2,7,.286,0,0,,2,7,.286,.286,1,2,.500,0,0,0,3,0,0,0,1,5
85,Jarron Collins\collija03,C,30,UTA,26,3,201,16,35,.457,0,0,,16,35,.457,.457,8,11,.727,20,17,37,7,2,1,9,35,40
86,Jason Collins\collija04,C,30,MIN,31,22,422,22,70,.314,0,0,,22,70,.314,.314,13,28,.464,28,42,70,11,9,13,12,73,57
87,Mardy Collins\collima01,PG-SG,24,TOT,48,14,890,105,247,.425,13,31,.419,92,216,.426,.451,28,46,.609,31,76,107,111,31,10,58,80,251
87,Mardy Collins\collima01,SG,24,NYK,9,0,75,8,23,.348,0,3,.000,8,20,.400,.348,4,9,.444,2,6,8,10,2,0,5,7,20
87,Mardy Collins\collima01,PG,24,LAC,39,14,815,97,224,.433,13,28,.464,84,196,.429,.462,24,37,.649,29,70,99,101,29,10,53,73,231
88,Nick Collison\collini01,C,28,OKC,71,40,1831,243,428,.568,0,2,.000,243,426,.570,.568,98,136,.721,181,308,489,66,51,50,73,239,584
89,Mike Conley\conlemi01,PG,21,MEM,82,61,2508,323,730,.442,88,217,.406,235,513,.458,.503,161,197,.817,25,251,276,354,90,8,143,146,895
90,Brian Cook\cookbr01,PF,28,TOT,30,0,171,28,76,.368,13,30,.433,15,46,.326,.454,5,6,.833,7,25,32,5,3,3,13,26,74
90,Brian Cook\cookbr01,PF,28,ORL,21,0,146,23,60,.383,11,25,.440,12,35,.343,.475,5,6,.833,6,21,27,4,3,0,11,23,62
90,Brian Cook\cookbr01,PF,28,HOU,9,0,25,5,16,.313,2,5,.400,3,11,.273,.375,0,0,,1,4,5,1,0,3,2,3,12
91,Daequan Cook\cookda02,SF,21,MIA,75,4,1833,242,645,.375,153,395,.387,89,250,.356,.494,49,56,.875,19,170,189,71,39,10,42,125,686
92,Jamal Crawford\crawfja01,PG-SG,28,TOT,65,65,2479,419,1022,.410,142,394,.360,277,628,.441,.479,300,344,.872,23,170,193,288,57,13,148,92,1280
92,Jamal Crawford\crawfja01,SG,28,NYK,11,11,392,73,169,.432,35,77,.455,38,92,.413,.536,35,46,.761,2,15,17,48,9,0,26,13,216
92,Jamal Crawford\crawfja01,PG,28,GSW,54,54,2087,346,853,.406,107,317,.338,239,536,.446,.468,265,298,.889,21,155,176,240,48,13,122,79,1064
93,Joe Crawford\crawfjo01,SF,22,NYK,2,0,23,3,10,.300,1,4,.250,2,6,.333,.350,2,2,1.000,1,3,4,1,1,0,0,2,9
94,Javaris Crittenton\crittja01,PG-SG,21,TOT,63,10,1174,131,285,.460,2,15,.133,129,270,.478,.463,53,92,.576,57,109,166,150,40,6,82,101,317
94,Javaris Crittenton\crittja01,SG,21,MEM,7,0,44,7,15,.467,0,1,.000,7,14,.500,.467,5,11,.455,4,2,6,5,1,0,3,5,19
94,Javaris Crittenton\crittja01,PG,21,WAS,56,10,1130,124,270,.459,2,14,.143,122,256,.477,.463,48,81,.593,53,107,160,145,39,6,79,96,298
95,Austin Croshere\croshau01,PF,33,TOT,14,0,100,14,39,.359,5,15,.333,9,24,.375,.423,7,12,.583,11,23,34,9,1,1,6,5,40
95,Austin Croshere\croshau01,PF,33,MIL,11,0,77,12,30,.400,5,11,.455,7,19,.368,.483,7,11,.636,7,17,24,6,1,1,4,4,36
95,Austin Croshere\croshau01,PF,33,SAS,3,0,23,2,9,.222,0,4,.000,2,5,.400,.222,0,1,.000,4,6,10,3,0,0,2,1,4
96,Eddy Curry\curryed01,C,26,NYK,3,0,12,2,2,1.000,0,0,,2,2,1.000,1.000,1,3,.333,0,4,4,0,0,0,2,5,5
97,Samuel Dalembert\dalemsa01,C,27,PHI,82,82,2036,216,434,.498,0,2,.000,216,432,.500,.498,91,124,.734,214,487,701,18,33,146,117,248,523
98,Erick Dampier\dampier01,C,33,DAL,80,80,1836,182,280,.650,0,0,,182,280,.650,.650,90,141,.638,216,349,565,77,24,95,74,191,454
99,Antonio Daniels\daniean01,PG,33,TOT,74,9,1021,99,236,.419,22,60,.367,77,176,.438,.466,80,100,.800,5,72,77,177,26,1,62,55,300
99,Antonio Daniels\daniean01,PG,33,WAS,13,5,288,18,45,.400,5,11,.455,13,34,.382,.456,25,33,.758,0,22,22,47,7,0,13,14,66
99,Antonio Daniels\daniean01,PG,33,NOH,61,4,733,81,191,.424,17,49,.347,64,142,.451,.469,55,67,.821,5,50,55,130,19,1,49,41,234
100,Marquis Daniels\daniema01,SF,28,IND,54,43,1700,311,689,.451,18,90,.200,293,599,.489,.464,93,129,.721,80,168,248,114,62,26,94,120,733
101,Jermareo Davidson\davidje01,SF,24,GSW,14,0,111,17,35,.486,0,0,,17,35,.486,.486,8,17,.471,10,24,34,1,2,3,5,12,42
102,Baron Davis\davisba01,PG,29,LAC,65,60,2248,355,959,.370,99,328,.302,256,631,.406,.422,159,210,.757,46,192,238,501,108,35,193,193,968
103,Glen Davis\davisgl01,C,23,BOS,76,16,1637,199,450,.442,2,5,.400,197,445,.443,.444,130,178,.730,121,180,301,69,53,19,71,230,530
104,Paul Davis\davispa01,PF,24,LAC,27,1,320,40,98,.408,0,1,.000,40,97,.412,.408,27,34,.794,28,39,67,12,10,3,13,44,107
105,Ricky Davis\davisri01,SG,29,LAC,36,9,785,83,245,.339,35,111,.315,48,134,.358,.410,31,36,.861,9,51,60,82,19,5,39,63,232
106,Luol Deng\denglu01,SF,23,CHI,49,46,1665,265,591,.448,8,20,.400,257,571,.450,.455,152,191,.796,80,215,295,94,60,25,72,85,690
107,Boris Diaw\diawbo01,PF,26,TOT,81,59,2754,448,884,.507,75,181,.414,373,703,.531,.549,101,147,.687,118,314,432,333,61,53,215,202,1072
107,Boris Diaw\diawbo01,PF,26,PHO,22,0,538,80,141,.567,5,14,.357,75,127,.591,.585,18,26,.692,24,60,84,46,11,9,37,39,183
107,Boris Diaw\diawbo01,PF,26,CHA,59,59,2216,368,743,.495,70,167,.419,298,576,.517,.542,83,121,.686,94,254,348,287,50,44,178,163,889
108,Yakhouba Diawara\diawaya01,SF,26,MIA,63,21,851,76,217,.350,51,163,.313,25,54,.463,.468,10,19,.526,26,56,82,27,13,6,16,75,213
109,Travis Diener\dienetr01,PG,26,IND,55,0,719,74,179,.413,46,118,.390,28,61,.459,.542,12,15,.800,6,80,86,122,26,5,21,42,206
110,Ike Diogu\dioguik01,PF,25,TOT,29,1,215,39,74,.527,1,2,.500,38,72,.528,.534,40,53,.755,26,30,56,3,3,3,12,23,119
110,Ike Diogu\dioguik01,PF,25,POR,19,0,73,6,19,.316,0,0,,6,19,.316,.316,15,20,.750,12,5,17,0,1,2,6,9,27
110,Ike Diogu\dioguik01,PF,25,SAC,10,1,142,33,55,.600,1,2,.500,32,53,.604,.609,25,33,.758,14,25,39,3,2,1,6,14,92
111,DeSagana Diop\diopde01,C,27,TOT,75,1,1036,74,171,.433,0,0,,74,171,.433,.433,22,66,.333,114,159,273,32,29,56,39,128,170
111,DeSagana Diop\diopde01,C,27,DAL,34,0,452,22,58,.379,0,0,,22,58,.379,.379,12,29,.414,45,73,118,13,12,25,11,55,56
111,DeSagana Diop\diopde01,C,27,CHA,41,1,584,52,113,.460,0,0,,52,113,.460,.460,10,37,.270,69,86,155,19,17,31,28,73,114
112,Juan Dixon\dixonju01,PG,30,WAS,50,6,816,101,256,.395,25,75,.333,76,181,.420,.443,34,39,.872,8,59,67,118,35,6,70,74,261
113,Keyon Dooling\doolike01,PG,28,NJN,77,18,2074,261,598,.436,99,235,.421,162,363,.446,.519,127,154,.825,24,131,155,270,71,8,105,135,748
114,Joey Dorsey\dorsejo01,PF,25,HOU,3,0,6,1,2,.500,0,0,,1,2,.500,.500,0,0,,0,1,1,1,0,0,0,0,2
115,Quincy Douby\doubyqu01,PG,24,TOT,27,0,300,42,110,.382,14,46,.304,28,64,.438,.445,17,19,.895,6,26,32,25,5,5,13,27,115
115,Quincy Douby\doubyqu01,PG,24,SAC,20,0,227,30,88,.341,10,37,.270,20,51,.392,.398,14,15,.933,3,22,25,13,2,5,6,23,84
115,Quincy Douby\doubyqu01,PG,24,TOR,7,0,73,12,22,.545,4,9,.444,8,13,.615,.636,3,4,.750,3,4,7,12,3,0,7,4,31
116,Chris Douglas-Roberts\douglch01,SG,22,NJN,44,3,585,81,176,.460,3,12,.250,78,164,.476,.469,51,62,.823,14,36,50,52,12,7,31,34,216
117,Goran Dragić\dragigo01,PG,22,PHO,55,1,728,88,224,.393,20,54,.370,68,170,.400,.438,50,65,.769,33,70,103,111,29,3,73,87,246
118,Jared Dudley\dudleja01,SF,23,TOT,68,7,1155,136,285,.477,29,74,.392,107,211,.507,.528,71,105,.676,82,123,205,56,57,8,43,105,372
118,Jared Dudley\dudleja01,SF,23,CHA,20,7,427,45,96,.469,3,8,.375,42,88,.477,.484,15,24,.625,25,34,59,19,18,2,10,40,108
118,Jared Dudley\dudleja01,SF,23,PHO,48,0,728,91,189,.481,26,66,.394,65,123,.528,.550,56,81,.691,57,89,146,37,39,6,33,65,264
119,Chris Duhon\duhonch01,PG,26,NYK,79,78,2906,287,681,.421,127,325,.391,160,356,.449,.515,179,209,.856,45,201,246,566,72,7,221,126,880
120,Tim Duncan*\duncati01,C,32,SAS,75,75,2524,558,1107,.504,0,2,.000,558,1105,.505,.504,334,483,.692,201,599,800,264,38,126,165,173,1450
121,Mike Dunleavy\dunlemi02,SG,28,IND,18,14,495,93,232,.401,32,90,.356,61,142,.430,.470,53,65,.815,14,54,68,44,12,9,38,36,271
122,Kevin Durant\duranke01,SF,20,OKC,74,74,2885,661,1390,.476,97,230,.422,564,1160,.486,.510,452,524,.863,77,405,482,205,96,53,225,134,1871
123,Monta Ellis\ellismo01,SG,23,GSW,25,25,892,194,430,.451,8,26,.308,186,404,.460,.460,78,94,.830,14,94,108,93,39,8,67,67,474
124,Francisco Elson\elsonfr01,C,32,MIL,59,23,977,83,169,.491,1,4,.250,82,165,.497,.494,33,39,.846,100,129,229,32,36,36,48,144,200
125,Melvin Ely\elyme01,C,30,NOH,31,4,373,37,95,.389,0,0,,37,95,.389,.389,23,36,.639,30,34,64,18,2,9,23,58,97
126,Maurice Evans\evansma01,SF,30,ATL,80,25,1840,208,482,.432,98,248,.395,110,234,.470,.533,60,73,.822,88,155,243,54,50,10,43,163,574
127,Reggie Evans\evansre01,PF,28,PHI,79,7,1137,79,178,.444,0,1,.000,79,177,.446,.444,104,175,.594,135,226,361,26,41,8,69,161,262
128,Jordan Farmar\farmajo01,PG,22,LAL,65,0,1192,161,412,.391,49,146,.336,112,266,.421,.450,45,77,.584,22,95,117,155,57,10,87,105,416
129,Desmon Farmer\farmede01,SG,27,SAS,3,0,54,4,14,.286,3,12,.250,1,2,.500,.393,2,2,1.000,0,6,6,2,0,0,4,6,13
130,Raymond Felton\feltora01,PG,24,CHA,82,81,3086,442,1083,.408,59,207,.285,383,876,.437,.435,219,272,.805,54,256,310,553,126,30,228,191,1162
131,Rudy Fernández\fernaru01,SG,23,POR,78,4,1993,268,630,.425,159,398,.399,109,232,.470,.552,120,143,.839,47,160,207,159,69,12,86,111,815
132,Kyrylo Fesenko\fesenky01,C,22,UTA,21,1,156,21,36,.583,0,0,,21,36,.583,.583,7,21,.333,14,23,37,4,7,15,9,35,49
133,Michael Finley\finlemi01,SF,35,SAS,81,77,2336,301,689,.437,131,319,.411,170,370,.459,.532,51,62,.823,26,244,270,114,37,17,61,82,784
134,Derek Fisher\fishede01,PG,34,LAL,82,82,2441,292,688,.424,120,302,.397,172,386,.446,.512,110,130,.846,25,163,188,261,95,6,72,187,814
135,T.J. Ford\fordtj01,PG,25,IND,74,49,2258,413,913,.452,35,104,.337,378,809,.467,.472,245,281,.872,59,200,259,392,89,16,180,180,1106
136,Jeff Foster\fosteje01,C,32,IND,74,26,1828,177,353,.501,2,7,.286,175,346,.506,.504,96,146,.658,215,293,508,130,53,49,88,229,452
137,Randy Foye\foyera01,SG,25,MIN,70,61,2494,399,981,.407,111,308,.360,288,673,.428,.463,230,272,.846,34,180,214,303,72,26,150,201,1139
138,Adonal Foyle\foylead01,C,33,TOT,10,0,62,7,11,.636,0,0,,7,11,.636,.636,3,6,.500,9,17,26,1,0,8,3,5,17
138,Adonal Foyle\foylead01,C,33,ORL,9,0,59,7,11,.636,0,0,,7,11,.636,.636,3,6,.500,9,17,26,1,0,8,3,4,17
138,Adonal Foyle\foylead01,C,33,MEM,1,0,3,0,0,,0,0,,0,0,,,0,0,,0,0,0,0,0,0,0,1,0
139,Channing Frye\fryech01,PF,25,POR,63,1,746,113,267,.423,11,33,.333,102,234,.436,.444,26,36,.722,41,99,140,24,17,16,29,106,263
140,Dan Gadzuric\gadzuda01,C,30,MIL,67,26,941,117,244,.480,0,2,.000,117,242,.483,.480,37,68,.544,95,160,255,39,32,43,41,162,271
141,Danilo Gallinari\gallida01,SG,20,NYK,28,2,412,56,125,.448,32,72,.444,24,53,.453,.576,26,27,.963,13,42,55,15,14,4,15,48,170
142,Francisco García\garcifr01,SF,27,SAC,65,36,1975,295,665,.444,88,221,.398,207,444,.466,.510,146,178,.820,56,162,218,150,80,67,112,196,824
143,Thomas Gardner\gardnth01,SG,23,ATL,16,0,98,9,36,.250,4,23,.174,5,13,.385,.306,2,4,.500,0,7,7,2,4,1,3,4,24
144,Kevin Garnett*\garneke01,PF,32,BOS,57,57,1772,393,740,.531,2,8,.250,391,732,.534,.532,111,132,.841,78,407,485,144,63,68,90,128,899
145,Marc Gasol\gasolma01,C,24,MEM,82,75,2521,350,661,.530,0,1,.000,350,660,.530,.530,275,375,.733,201,404,605,143,63,90,164,265,975
146,Pau Gasol\gasolpa01,C,28,LAL,81,81,2999,592,1045,.567,1,2,.500,591,1043,.567,.567,343,439,.781,262,518,780,284,52,81,157,172,1528
147,Rudy Gay\gayru01,SF,22,MEM,79,78,2945,572,1262,.453,85,242,.351,487,1020,.477,.487,264,344,.767,109,328,437,135,98,59,203,221,1493
148,Devean George\georgde01,SF,31,DAL,43,17,708,54,142,.380,22,76,.289,32,66,.485,.458,17,22,.773,25,53,78,15,23,11,17,57,147
149,Daniel Gibson\gibsoda01,PG,22,CLE,75,0,1795,206,527,.391,108,283,.382,98,244,.402,.493,66,86,.767,31,124,155,132,44,16,61,163,586
150,J.R. Giddens\giddejr01,SF,23,BOS,6,0,8,2,3,.667,0,0,,2,3,.667,.667,0,0,,2,1,3,0,1,0,1,1,4
151,Eddie Gill\gilled01,PG,30,MIL,6,0,43,6,9,.667,2,3,.667,4,6,.667,.778,0,0,,0,4,4,11,3,1,5,10,14
152,Manu Ginóbili*\ginobma01,SG,31,SAS,44,7,1181,223,491,.454,69,209,.330,154,282,.546,.524,168,190,.884,24,174,198,157,64,16,88,90,683
153,Ryan Gomes\gomesry01,SF,26,MIN,82,76,2614,420,974,.431,106,285,.372,314,689,.456,.486,146,181,.807,106,286,392,135,63,22,128,183,1092
154,Drew Gooden\goodedr01,PF,27,TOT,51,28,1264,237,506,.468,0,4,.000,237,502,.472,.468,131,156,.840,113,249,362,48,30,18,76,144,605
154,Drew Gooden\goodedr01,PF,27,CHI,31,27,918,161,352,.457,0,3,.000,161,349,.461,.457,84,97,.866,82,184,266,43,26,14,57,103,406
154,Drew Gooden\goodedr01,PF,27,SAC,1,0,26,5,9,.556,0,0,,5,9,.556,.556,2,2,1.000,3,10,13,2,0,0,3,2,12
154,Drew Gooden\goodedr01,PF,27,SAS,19,1,320,71,145,.490,0,1,.000,71,144,.493,.490,45,57,.789,28,55,83,3,4,4,16,39,187
155,Ben Gordon\gordobe01,SG,25,CHI,82,76,2999,598,1315,.455,173,422,.410,425,893,.476,.521,330,382,.864,52,231,283,279,71,22,200,184,1699
156,Eric Gordon\gordoer01,SG,20,LAC,78,65,2677,411,901,.456,131,337,.389,280,564,.496,.529,299,350,.854,45,156,201,215,78,35,164,172,1252
157,Marcin Gortat\gortama01,PF,24,ORL,63,3,794,106,187,.567,1,1,1.000,105,186,.565,.570,26,45,.578,96,190,286,14,18,53,25,111,239
158,Joey Graham\grahajo01,SF,26,TOR,78,10,1541,231,480,.481,3,16,.188,228,464,.491,.484,132,160,.825,95,197,292,48,35,12,74,191,597
159,Stephen Graham\grahast01,SG,26,IND,52,6,684,106,256,.414,20,66,.303,86,190,.453,.453,50,62,.806,21,75,96,33,10,4,45,82,282
160,Danny Granger\grangda01,SF,25,IND,67,66,2424,571,1277,.447,182,450,.404,389,827,.470,.518,404,460,.878,49,292,341,183,69,97,165,207,1728
161,Aaron Gray\grayaa01,C,24,CHI,56,18,715,81,167,.485,0,1,.000,81,166,.488,.485,34,59,.576,84,136,220,46,14,18,40,135,196
162,Gerald Green\greenge01,SG,23,DAL,38,12,376,79,180,.439,14,46,.304,65,134,.485,.478,27,32,.844,14,40,54,15,10,5,33,51,199
163,Jeff Green\greenje02,PF,22,OKC,78,78,2873,476,1068,.446,96,247,.389,380,821,.463,.491,242,307,.788,120,399,519,155,81,33,173,202,1290
164,Willie Green\greenwi01,SG,27,PHI,81,60,1828,286,658,.435,51,161,.317,235,497,.473,.473,62,85,.729,29,97,126,158,53,13,64,154,685
165,Donté Greene\greendo01,SF,20,SAC,55,4,725,77,236,.326,26,100,.260,51,136,.375,.381,29,34,.853,19,67,86,30,16,14,37,68,209
166,Hamed Haddadi\haddaha01,C,23,MEM,19,0,120,15,31,.484,0,0,,15,31,.484,.484,18,30,.600,16,31,47,8,1,12,9,20,48
167,Malik Hairston\hairsma01,SG,21,SAS,15,0,155,24,49,.490,0,1,.000,24,48,.500,.490,2,7,.286,11,17,28,13,6,7,12,19,50
168,Richard Hamilton\hamilri01,SG,30,DET,67,51,2279,466,1043,.447,70,190,.368,396,853,.464,.480,223,263,.848,44,163,207,297,40,4,133,176,1225
169,Matt Harpring\harprma01,SG,32,UTA,63,2,693,111,241,.461,0,2,.000,111,239,.464,.461,55,72,.764,47,76,123,28,29,9,29,102,277
170,Al Harrington\harrial01,PF,28,TOT,73,56,2546,532,1212,.439,171,470,.364,361,742,.487,.509,234,295,.793,99,356,455,102,88,22,161,227,1469
170,Al Harrington\harrial01,PF,28,GSW,5,5,166,23,70,.329,11,28,.393,12,42,.286,.407,5,10,.500,10,18,28,10,7,0,7,14,62
170,Al Harrington\harrial01,PF,28,NYK,68,51,2380,509,1142,.446,160,442,.362,349,700,.499,.516,229,285,.804,89,338,427,92,81,22,154,213,1407
171,Devin Harris\harride01,PG,25,NJN,69,69,2494,455,1039,.438,64,220,.291,391,819,.477,.469,496,605,.820,30,201,231,476,114,13,212,164,1470
172,Jason Hart\hartja01,PG,30,TOT,39,2,348,30,94,.319,0,6,.000,30,88,.341,.319,18,23,.783,13,33,46,48,12,4,22,39,78
172,Jason Hart\hartja01,PG,30,LAC,28,2,312,25,84,.298,0,4,.000,25,80,.313,.298,15,19,.789,12,30,42,43,12,4,19,35,65
172,Jason Hart\hartja01,PG,30,DEN,11,0,36,5,10,.500,0,2,.000,5,8,.625,.500,3,4,.750,1,3,4,5,0,0,3,4,13
173,Udonis Haslem\hasleud01,PF,28,MIA,75,75,2560,333,643,.518,0,0,,333,643,.518,.518,128,170,.753,169,449,618,85,43,25,82,204,794
174,Trenton Hassell\hassetr01,SF,29,NJN,53,31,1094,86,191,.450,2,8,.250,84,183,.459,.455,20,25,.800,50,96,146,51,21,16,30,92,194
175,Spencer Hawes\hawessp01,C,20,SAC,77,51,2259,373,800,.466,40,115,.348,333,685,.486,.491,90,136,.662,148,401,549,149,44,93,160,249,876
176,Chuck Hayes\hayesch01,C,25,HOU,71,1,858,42,113,.372,0,4,.000,42,109,.385,.372,7,19,.368,74,176,250,42,34,19,25,134,91
177,Jarvis Hayes\hayesja01,SF,27,NJN,74,1,1832,257,577,.445,94,244,.385,163,333,.489,.527,36,52,.692,27,240,267,54,52,7,49,162,644
178,Brendan Haywood\haywobr01,C,29,WAS,6,5,175,24,50,.480,0,0,,24,50,.480,.480,10,21,.476,13,31,44,8,4,15,9,14,58
179,Luther Head\headlu01,PG-SG,26,TOT,32,4,498,55,144,.382,20,54,.370,35,90,.389,.451,19,24,.792,6,46,52,58,17,2,25,37,149
179,Luther Head\headlu01,PG,26,HOU,22,4,322,39,101,.386,14,38,.368,25,63,.397,.455,14,16,.875,3,24,27,35,6,1,16,15,106
179,Luther Head\headlu01,SG,26,MIA,10,0,176,16,43,.372,6,16,.375,10,27,.370,.442,5,8,.625,3,22,25,23,11,1,9,22,43
180,Walter Herrmann\herrmwa01,SF,29,DET,59,0,630,82,207,.396,41,120,.342,41,87,.471,.495,19,25,.760,28,79,107,22,7,4,17,43,224
181,Roy Hibbert\hibbero01,C,22,IND,70,42,1009,198,420,.471,0,0,,198,420,.471,.471,98,147,.667,115,128,243,49,20,76,55,215,494
182,J.J. Hickson\hicksjj01,C,20,CLE,62,0,705,100,194,.515,0,0,,100,194,.515,.515,45,67,.672,52,113,165,9,14,30,45,81,245
183,Nenê\hilarne01,C,26,DEN,77,76,2510,428,709,.604,1,5,.200,427,704,.607,.604,266,368,.723,183,415,598,108,95,101,147,278,1123
184,George Hill\hillge01,PG,22,SAS,77,7,1270,150,372,.403,24,73,.329,126,299,.421,.435,114,146,.781,30,128,158,136,45,21,74,150,438
185,Grant Hill*\hillgr01,SF,36,PHO,82,68,2445,390,745,.523,24,76,.316,366,669,.547,.540,181,224,.808,64,341,405,186,90,54,126,182,985
186,Steven Hill\hillst01,PF,23,OKC,1,0,2,1,1,1.000,0,0,,1,1,1.000,1.000,0,0,,2,1,3,0,0,0,0,0,2
187,Kirk Hinrich\hinriki01,SG,28,CHI,51,4,1339,183,419,.437,69,169,.408,114,250,.456,.519,68,86,.791,16,107,123,197,66,19,87,126,503
188,Ryan Hollins\holliry01,C,24,TOT,45,3,444,50,94,.532,0,0,,50,94,.532,.532,43,72,.597,46,51,97,7,7,32,24,78,143
188,Ryan Hollins\holliry01,C,24,CHA,18,1,184,19,35,.543,0,0,,19,35,.543,.543,26,39,.667,19,17,36,4,3,17,10,34,64
188,Ryan Hollins\holliry01,C,24,DAL,27,2,260,31,59,.525,0,0,,31,59,.525,.525,17,33,.515,27,34,61,3,4,15,14,44,79
189,Al Horford\horfoal01,C,22,ATL,67,67,2242,312,594,.525,0,1,.000,312,593,.526,.525,149,205,.727,145,479,624,163,53,95,103,190,773
190,Eddie House\houseed01,PG,30,BOS,81,0,1479,249,560,.445,151,340,.444,98,220,.445,.579,42,53,.792,11,146,157,92,61,7,55,113,691
191,Dwight Howard\howardw01,C,23,ORL,79,79,2821,560,979,.572,0,2,.000,560,977,.573,.572,504,849,.594,336,757,1093,112,77,231,240,270,1624
192,Josh Howard\howarjo01,SF,28,DAL,52,51,1663,353,783,.451,58,168,.345,295,615,.480,.488,172,220,.782,59,204,263,83,55,30,89,135,936
193,Juwan Howard\howarju01,SF-PF,35,TOT,42,2,472,75,147,.510,0,0,,75,147,.510,.510,23,34,.676,30,46,76,26,7,6,26,71,173
193,Juwan Howard\howarju01,PF,35,DEN,3,0,22,1,2,.500,0,0,,1,2,.500,.500,0,0,,1,3,4,2,1,1,0,4,2
193,Juwan Howard\howarju01,SF,35,CHA,39,2,450,74,145,.510,0,0,,74,145,.510,.510,23,34,.676,29,43,72,24,6,5,26,67,171
194,Larry Hughes\hughela01,SF-SG,30,TOT,55,20,1479,224,557,.402,75,193,.389,149,364,.409,.469,117,145,.807,16,143,159,119,72,14,71,96,640
194,Larry Hughes\hughela01,SF,30,CHI,30,6,792,127,308,.412,40,102,.392,87,206,.422,.477,67,82,.817,6,88,94,59,36,9,36,51,361
194,Larry Hughes\hughela01,SG,30,NYK,25,14,687,97,249,.390,35,91,.385,62,158,.392,.460,50,63,.794,10,55,65,60,36,5,35,45,279
195,Kris Humphries\humphkr01,SF,23,TOR,29,0,265,38,90,.422,0,0,,38,90,.422,.422,38,48,.792,24,46,70,10,8,6,8,31,114
196,Lindsey Hunter\hunteli01,PG,38,CHI,28,0,266,27,82,.329,16,48,.333,11,34,.324,.427,3,5,.600,2,10,12,37,20,1,19,28,73
197,Othello Hunter\hunteot01,PF,22,ATL,16,0,92,11,20,.550,0,0,,11,20,.550,.550,0,5,.000,9,15,24,1,2,5,2,11,22
198,Andre Iguodala\iguodan01,SF,25,PHI,82,82,3269,542,1147,.473,80,261,.307,462,886,.521,.507,377,521,.724,92,379,471,434,131,36,222,152,1541
199,Zydrunas Ilgauskas\ilgauzy01,C,33,CLE,65,65,1765,342,724,.472,15,39,.385,327,685,.477,.483,139,174,.799,157,333,490,64,28,84,90,183,838
200,D.J. Mbenga\mbengdj01,C,28,LAL,23,0,181,27,57,.474,0,1,.000,27,56,.482,.474,7,8,.875,9,22,31,9,10,24,13,33,61
201,Allen Iverson*\iversal01,PG-SG,33,TOT,57,53,2093,348,834,.417,28,99,.283,320,735,.435,.434,271,347,.781,30,143,173,283,88,6,146,86,995
201,Allen Iverson*\iversal01,SG,33,DEN,3,3,123,18,40,.450,2,8,.250,16,32,.500,.475,18,25,.720,3,5,8,20,3,1,10,3,56
201,Allen Iverson*\iversal01,PG,33,DET,54,50,1970,330,794,.416,26,91,.286,304,703,.432,.432,253,322,.786,27,138,165,263,85,5,136,83,939
202,Royal Ivey\iveyro01,SG,27,PHI,71,0,861,69,208,.332,39,114,.342,30,94,.319,.425,34,43,.791,19,57,76,43,36,7,23,76,211
203,Jarrett Jack\jackja01,SG,25,IND,82,53,2716,386,853,.453,78,221,.353,308,632,.487,.498,224,263,.852,44,232,276,338,88,17,184,179,1074
204,Bobby Jackson\jacksbo01,PG,35,SAC,71,10,1484,193,485,.398,60,197,.305,133,288,.462,.460,86,101,.851,42,158,200,143,62,4,66,100,532
205,Darnell Jackson\jacksda01,PF,23,CLE,51,2,430,37,86,.430,0,2,.000,37,84,.440,.430,24,35,.686,32,55,87,8,10,4,14,77,98
206,Stephen Jackson\jacksst02,SF,30,GSW,59,59,2339,413,997,.414,103,305,.338,310,692,.448,.466,294,356,.826,70,233,303,381,88,31,229,153,1223
207,Jerome James\jamesje01,C,33,NYK,2,0,10,3,8,.375,0,0,,3,8,.375,.375,0,0,,1,2,3,0,1,1,1,2,6
208,LeBron James\jamesle01,SF,24,CLE,81,81,3054,789,1613,.489,132,384,.344,657,1229,.535,.530,594,762,.780,106,507,613,587,137,93,241,139,2304
209,Mike James\jamesmi01,PG,33,TOT,61,50,1649,197,514,.383,69,184,.375,128,330,.388,.450,68,82,.829,25,108,133,201,44,6,94,108,531
209,Mike James\jamesmi01,PG,33,NOH,8,0,74,8,25,.320,3,4,.750,5,21,.238,.380,1,2,.500,1,6,7,8,2,0,3,7,20
209,Mike James\jamesmi01,PG,33,WAS,53,50,1575,189,489,.387,66,180,.367,123,309,.398,.454,67,80,.838,24,102,126,193,42,6,91,101,511
210,Antawn Jamison\jamisan01,PF,32,WAS,81,81,3096,674,1441,.468,112,319,.351,562,1122,.501,.507,341,452,.754,196,525,721,153,95,25,125,218,1801
211,Marko Jarić\jaricma01,SG,30,MEM,53,0,605,48,145,.331,11,28,.393,37,117,.316,.369,29,41,.707,23,42,65,74,29,11,49,62,136
212,Nathan Jawai\jawaina01,PF,22,TOR,6,0,19,1,4,.250,0,0,,1,4,.250,.250,0,0,,1,1,2,0,0,0,2,3,2
213,Al Jefferson\jeffeal01,C,24,MIN,50,50,1836,485,975,.497,0,4,.000,485,971,.499,.497,186,252,.738,172,376,548,79,39,83,92,141,1156
214,Dontell Jefferson\jeffedo01,SG,25,CHA,6,0,84,11,22,.500,1,2,.500,10,20,.500,.523,6,9,.667,1,11,12,9,4,1,6,9,29
215,Richard Jefferson\jefferi01,SF,28,MIL,82,82,2939,537,1222,.439,116,292,.397,421,930,.453,.487,417,518,.805,57,317,374,199,66,14,165,252,1607
216,Jared Jeffries\jeffrja01,SF,27,NYK,56,36,1310,120,273,.440,1,12,.083,119,261,.456,.441,55,90,.611,128,103,231,80,47,33,65,153,296
217,Yi Jianlian\jianlyi01,PF,21,NJN,61,52,1421,191,500,.382,48,140,.343,143,360,.397,.430,95,123,.772,67,259,326,60,29,36,70,157,525
218,Amir Johnson\johnsam01,PF,21,DET,62,24,911,97,163,.595,0,0,,97,163,.595,.595,23,35,.657,102,130,232,20,20,60,33,171,217
219,Anthony Johnson\johnsan02,PG,34,ORL,80,12,1481,154,381,.404,52,133,.391,102,248,.411,.472,61,81,.753,29,118,147,200,46,5,82,111,421
220,Joe Johnson\johnsjo02,SG,27,ATL,79,79,3124,620,1420,.437,149,414,.360,471,1006,.468,.489,299,362,.826,65,281,346,455,84,19,195,176,1688
221,Linton Johnson\johnsli01,PF,28,TOT,10,0,55,4,11,.364,1,2,.500,3,9,.333,.409,0,0,,3,5,8,2,1,0,2,7,9
221,Linton Johnson\johnsli01,PF,28,CHA,2,0,13,0,0,,0,0,,0,0,,,0,0,,0,0,0,0,0,0,0,1,0
221,Linton Johnson\johnsli01,PF,28,CHI,8,0,42,4,11,.364,1,2,.500,3,9,.333,.409,0,0,,3,5,8,2,1,0,2,6,9
222,Trey Johnson\johnstr01,SG,24,CLE,4,0,14,0,5,.000,0,0,,0,5,.000,.000,4,4,1.000,0,1,1,0,0,0,1,4,4
223,Dahntay Jones\jonesda02,SG,28,DEN,79,71,1426,154,336,.458,11,17,.647,143,319,.448,.475,110,151,.728,58,110,168,78,49,19,68,199,429
224,Damon Jones\jonesda01,PG,32,MIL,18,0,108,11,34,.324,11,28,.393,0,6,.000,.485,0,0,,0,6,6,7,3,0,6,4,33
225,Dwayne Jones\jonesdw02,PF,25,CHA,6,0,52,4,7,.571,0,0,,4,7,.571,.571,4,6,.667,6,6,12,0,0,1,4,6,12
226,Fred Jones\jonesfr01,SF,29,LAC,52,21,1495,129,317,.407,54,147,.367,75,170,.441,.492,66,81,.815,23,103,126,188,53,11,66,112,378
227,James Jones\jonesja02,SF,28,MIA,40,1,630,55,149,.369,33,96,.344,22,53,.415,.480,26,31,.839,12,50,62,20,12,14,12,58,169
228,Solomon Jones\jonesso01,C,24,ATL,63,0,675,67,111,.604,1,2,.500,66,109,.606,.608,53,74,.716,52,90,142,15,7,34,27,125,188
229,DeAndre Jordan\jordade01,C,20,LAC,53,13,771,93,147,.633,0,0,,93,147,.633,.633,42,109,.385,72,165,237,11,11,59,41,96,228
230,Chris Kaman\kamanch01,C,26,LAC,31,24,921,161,305,.528,0,0,,161,305,.528,.528,51,75,.680,75,172,247,46,17,45,84,93,373
231,Jason Kapono\kaponja01,SG,27,TOR,80,12,1831,261,604,.432,98,229,.428,163,375,.435,.513,34,42,.810,26,137,163,105,22,3,70,144,654
232,Jason Kidd*\kiddja01,PG,35,DAL,81,81,2886,257,618,.416,131,323,.406,126,295,.427,.522,86,105,.819,85,415,500,702,160,39,185,168,731
233,Tarence Kinsey\kinseta01,SG,24,CLE,50,3,277,31,69,.449,7,18,.389,24,51,.471,.500,33,38,.868,10,28,38,10,12,0,22,34,102
234,Andrei Kirilenko\kirilan01,PF,27,UTA,67,10,1831,256,570,.449,20,73,.274,236,497,.475,.467,244,311,.785,84,235,319,175,83,77,121,127,776
235,Linas Kleiza\kleizli01,SF,24,DEN,82,7,1824,289,646,.447,87,267,.326,202,379,.533,.515,148,204,.725,92,235,327,64,31,14,82,155,813
236,Brevin Knight\knighbr01,PG,33,UTA,74,0,938,66,189,.349,0,6,.000,66,183,.361,.349,48,64,.750,13,75,88,190,68,4,66,98,180
237,Kyle Korver\korveky01,SF,27,UTA,78,2,1874,245,560,.438,103,267,.386,142,293,.485,.529,112,127,.882,35,223,258,137,47,30,90,170,705
238,Kosta Koufos\koufoko01,C,19,UTA,48,7,565,94,185,.508,0,0,,94,185,.508,.508,36,51,.706,50,88,138,20,12,31,26,70,224
239,Nenad Krstić\krstine01,C,25,OKC,46,29,1141,191,407,.469,0,0,,191,407,.469,.469,63,79,.797,85,168,253,29,21,49,45,114,445
240,Rob Kurz\kurzro01,PF,23,GSW,40,5,442,51,131,.389,15,38,.395,36,93,.387,.447,40,50,.800,33,48,81,20,14,19,16,78,157
241,Carl Landry\landrca01,PF,25,HOU,69,0,1467,240,418,.574,1,3,.333,239,415,.576,.575,157,193,.813,124,219,343,39,26,31,68,166,638
242,Acie Law\lawac01,PG,24,ATL,55,1,560,52,139,.374,9,29,.310,43,110,.391,.406,49,60,.817,6,52,58,86,11,3,29,43,162
243,Courtney Lee\leeco01,SG,23,ORL,77,42,1939,243,540,.450,82,203,.404,161,337,.478,.526,78,94,.830,18,160,178,91,76,14,69,157,646
244,David Lee\leeda02,C,25,NYK,81,74,2824,522,951,.549,0,3,.000,522,948,.551,.549,249,330,.755,256,695,951,174,80,22,150,260,1293
245,Rashard Lewis\lewisra02,PF,29,ORL,79,79,2859,478,1089,.439,220,554,.397,258,535,.482,.540,225,269,.836,92,361,453,205,81,51,158,194,1401
246,Shaun Livingston\livinsh01,PG,23,TOT,12,1,231,31,60,.517,0,0,,31,60,.517,.517,9,10,.900,3,25,28,20,7,2,9,12,71
246,Shaun Livingston\livinsh01,PG,23,MIA,4,0,41,3,8,.375,0,0,,3,8,.375,.375,3,4,.750,0,2,2,4,2,0,3,4,9
246,Shaun Livingston\livinsh01,PG,23,OKC,8,1,190,28,52,.538,0,0,,28,52,.538,.538,6,6,1.000,3,23,26,16,5,2,6,8,62
247,Brook Lopez\lopezbr01,C,20,NJN,82,75,2501,448,844,.531,0,2,.000,448,842,.532,.531,172,217,.793,225,440,665,86,44,151,147,257,1068
248,Robin Lopez\lopezro01,C,20,PHO,60,7,614,71,137,.518,0,1,.000,71,136,.522,.518,47,68,.691,52,66,118,8,11,41,28,97,189
249,Kevin Love\loveke01,C,20,MIN,81,37,2048,316,688,.459,2,19,.105,314,669,.469,.461,265,336,.789,274,460,734,84,35,50,118,205,899
250,Kyle Lowry\lowryky01,PG,22,TOT,77,21,1679,189,434,.435,25,98,.255,164,336,.488,.464,181,226,.801,26,163,189,275,69,17,117,146,584
250,Kyle Lowry\lowryky01,PG,22,MEM,49,21,1071,112,272,.412,17,69,.246,95,203,.468,.443,129,161,.801,13,98,111,178,48,8,79,89,370
250,Kyle Lowry\lowryky01,PG,22,HOU,28,0,608,77,162,.475,8,29,.276,69,133,.519,.500,52,65,.800,13,65,78,97,21,9,38,57,214
251,Tyronn Lue\luety01,PG,31,TOT,44,0,521,71,162,.438,27,62,.435,44,100,.440,.522,14,19,.737,6,40,46,60,8,0,23,54,183
251,Tyronn Lue\luety01,PG,31,MIL,30,0,392,54,119,.454,21,45,.467,33,74,.446,.542,12,16,.750,6,29,35,46,6,0,21,41,141
251,Tyronn Lue\luety01,PG,31,ORL,14,0,129,17,43,.395,6,17,.353,11,26,.423,.465,2,3,.667,0,11,11,14,2,0,2,13,42
252,Mark Madsen\madsema01,C,33,MIN,19,1,116,3,14,.214,0,0,,3,14,.214,.214,0,4,.000,10,8,18,4,1,1,3,18,6
253,Corey Maggette\maggeco01,PF,29,GSW,51,19,1588,292,634,.461,24,95,.253,268,539,.497,.479,342,415,.824,49,233,282,92,44,8,120,192,950
254,Jamaal Magloire\magloja01,C,30,MIA,55,12,709,65,131,.496,0,0,,65,131,.496,.496,29,60,.483,82,140,222,22,11,25,32,121,159
255,Stephon Marbury\marbust01,PG,31,BOS,23,4,414,38,111,.342,6,25,.240,32,86,.372,.369,6,13,.462,2,26,28,75,10,3,37,34,88
256,Shawn Marion\mariosh01,SF,30,TOT,69,68,2470,382,788,.485,10,53,.189,372,735,.506,.491,117,147,.796,180,409,589,139,88,66,105,132,891
256,Shawn Marion\mariosh01,SF,30,MIA,42,41,1516,215,446,.482,8,40,.200,207,406,.510,.491,67,85,.788,107,258,365,77,57,45,56,92,505
256,Shawn Marion\mariosh01,SF,30,TOR,27,27,954,167,342,.488,2,13,.154,165,329,.502,.491,50,62,.806,73,151,224,62,31,21,49,40,386
257,Sean Marks\marksse01,C,33,NOH,60,5,838,80,165,.485,2,10,.200,78,155,.503,.491,30,44,.682,62,125,187,14,7,33,35,121,192
258,Donyell Marshall\marshdo01,PF,35,PHI,25,0,189,33,73,.452,25,55,.455,8,18,.444,.623,3,6,.500,6,34,40,15,4,5,6,24,94
259,Cartier Martin\martica01,SF,24,CHA,33,1,266,28,77,.364,10,33,.303,18,44,.409,.429,20,25,.800,7,26,33,13,8,4,9,33,86
260,Kenyon Martin\martike01,PF,31,DEN,66,66,2111,318,648,.491,14,38,.368,304,610,.498,.502,119,197,.604,81,314,395,132,96,74,104,201,769
261,Kevin Martin\martike02,SG,25,SAC,51,46,1947,341,811,.420,115,277,.415,226,534,.423,.491,457,527,.867,29,154,183,138,61,8,146,116,1254
262,Desmond Mason\masonde01,SG,31,OKC,39,19,1064,124,285,.435,0,3,.000,124,282,.440,.435,46,85,.541,41,116,157,46,15,30,56,96,294
263,Roger Mason\masonro01,SG,28,SAS,82,71,2496,349,822,.425,166,394,.421,183,428,.428,.526,105,118,.890,16,235,251,173,40,12,100,160,969
264,Jason Maxiell\maxieja01,C,25,DET,78,4,1408,184,320,.575,0,1,.000,184,319,.577,.575,84,158,.532,169,155,324,24,25,63,45,157,452
265,Sean May\mayse01,PF,24,CHA,24,12,301,39,98,.398,1,1,1.000,38,97,.392,.403,14,20,.700,20,49,69,10,5,4,26,32,93
266,O.J. Mayo\mayooj01,SG,21,MEM,82,82,3120,562,1283,.438,145,378,.384,417,905,.461,.495,247,281,.879,56,252,308,262,91,13,226,204,1516
267,Luc Mbah a Moute\mbahalu01,PF,22,MIL,82,52,2114,227,491,.462,0,4,.000,227,487,.466,.462,140,192,.729,189,298,487,87,87,45,100,204,594
268,Rashad McCants\mccanra01,SG,24,TOT,58,3,1101,192,488,.393,63,189,.333,129,299,.431,.458,107,141,.759,21,89,110,68,47,14,64,103,554
268,Rashad McCants\mccanra01,SG,24,MIN,34,2,636,105,292,.360,38,119,.319,67,173,.387,.425,60,81,.741,11,52,63,32,27,6,45,63,308
268,Rashad McCants\mccanra01,SG,24,SAC,24,1,465,87,196,.444,25,70,.357,62,126,.492,.508,47,60,.783,10,37,47,36,20,8,19,40,246
269,Antonio McDyess\mcdyean01,PF,34,DET,62,30,1866,268,525,.510,0,0,,268,525,.510,.510,60,86,.698,185,422,607,83,41,50,51,191,596
270,JaVale McGee\mcgeeja01,C,21,WAS,75,14,1143,191,387,.494,0,0,,191,387,.494,.494,107,162,.660,120,174,294,23,33,75,61,155,489
271,Tracy McGrady*\mcgratr01,SG,29,HOU,35,35,1181,188,485,.388,44,117,.376,144,368,.391,.433,125,156,.801,20,134,154,175,42,15,69,38,545
272,Dominic McGuire\mcguido01,SF,23,WAS,79,57,2072,140,324,.432,2,4,.500,138,320,.431,.435,74,102,.725,113,315,428,198,62,74,92,153,356
273,Josh McRoberts\mcrobjo01,PF,21,IND,33,0,279,35,83,.422,0,10,.000,35,73,.479,.422,10,13,.769,26,48,74,16,12,16,12,41,80
274,Pops Mensah-Bonsu\mensapo01,PF,25,TOT,22,0,283,39,103,.379,0,2,.000,39,101,.386,.379,33,48,.688,55,58,113,6,9,5,19,43,111
274,Pops Mensah-Bonsu\mensapo01,PF,25,SAS,3,0,20,5,7,.714,0,0,,5,7,.714,.714,5,7,.714,5,5,10,0,1,1,2,6,15
274,Pops Mensah-Bonsu\mensapo01,PF,25,TOR,19,0,263,34,96,.354,0,2,.000,34,94,.362,.354,28,41,.683,50,53,103,6,8,4,17,37,96
275,Chris Mihm\mihmch01,C,29,LAL,18,0,105,15,40,.375,0,0,,15,40,.375,.375,6,7,.857,15,19,34,10,1,6,10,23,36
276,C.J. Miles\milescj01,SG,21,UTA,72,72,1623,258,562,.459,63,179,.352,195,383,.509,.515,78,89,.876,45,122,167,107,46,15,64,187,657
277,Darius Miles\milesda01,SF,27,MEM,34,0,298,48,99,.485,1,6,.167,47,93,.505,.490,23,31,.742,19,38,57,17,11,20,21,32,120
278,Darko Miličić\milicda01,C,23,MEM,61,15,1034,137,266,.515,0,0,,137,266,.515,.515,59,105,.562,83,181,264,34,22,51,48,134,333
279,Andre Miller\millean02,PG,32,PHI,82,82,2976,492,1041,.473,15,53,.283,477,988,.483,.480,338,409,.826,123,245,368,534,109,14,199,196,1337
280,Brad Miller\millebr01,C,32,TOT,70,43,2100,292,614,.476,23,56,.411,269,558,.482,.494,224,272,.824,150,395,545,234,52,36,130,223,831
280,Brad Miller\millebr01,C,32,SAC,43,43,1354,184,388,.474,20,43,.465,164,345,.475,.500,125,156,.801,83,261,344,148,30,24,83,135,513
280,Brad Miller\millebr01,C,32,CHI,27,0,746,108,226,.478,3,13,.231,105,213,.493,.485,99,116,.853,67,134,201,86,22,12,47,88,318
281,Mike Miller\millemi01,SF,28,MIN,73,47,2356,264,548,.482,85,225,.378,179,323,.554,.559,109,149,.732,73,410,483,326,30,31,145,139,722
282,Paul Millsap\millspa01,PF,23,UTA,76,38,2290,400,749,.534,0,4,.000,400,745,.537,.534,228,326,.699,251,403,654,138,78,73,129,288,1028
283,Yao Ming*\mingya01,C,28,HOU,77,77,2589,566,1032,.548,1,1,1.000,565,1031,.548,.549,381,440,.866,204,557,761,137,30,150,234,257,1514
284,Cuttino Mobley\moblecu01,SG,33,LAC,11,11,365,63,146,.432,12,35,.343,51,111,.459,.473,13,18,.722,9,20,29,12,15,2,18,21,151
285,Nazr Mohammed\mohamna01,C,31,CHA,39,1,341,41,101,.406,0,0,,41,101,.406,.406,22,40,.550,35,44,79,8,5,16,23,63,104
286,Jamario Moon\moonja01,SF,28,TOT,80,60,2068,222,474,.468,65,183,.355,157,291,.540,.537,68,80,.850,58,307,365,95,86,60,43,133,577
286,Jamario Moon\moonja01,SF,28,TOR,54,39,1379,150,317,.473,38,110,.345,112,207,.541,.533,55,65,.846,48,201,249,70,65,44,31,85,393
286,Jamario Moon\moonja01,SF,28,MIA,26,21,689,72,157,.459,27,73,.370,45,84,.536,.545,13,15,.867,10,106,116,25,21,16,12,48,184
287,Mikki Moore\mooremi01,PF-C,33,TOT,70,20,1202,114,206,.553,0,0,,114,206,.553,.553,48,61,.787,76,182,258,53,17,19,48,208,276
287,Mikki Moore\mooremi01,PF,33,SAC,46,20,746,63,121,.521,0,0,,63,121,.521,.521,34,42,.810,45,107,152,28,13,14,27,112,160
287,Mikki Moore\mooremi01,C,33,BOS,24,0,456,51,85,.600,0,0,,51,85,.600,.600,14,19,.737,31,75,106,25,4,5,21,96,116
288,Randolph Morris\morrira01,C,23,ATL,23,0,89,7,17,.412,0,0,,7,17,.412,.412,4,4,1.000,4,16,20,2,2,1,7,25,18
289,Adam Morrison\morriad01,SF,24,TOT,52,5,711,80,223,.359,32,96,.333,48,127,.378,.430,17,23,.739,18,62,80,41,9,4,32,77,209
289,Adam Morrison\morriad01,SF,24,CHA,44,5,667,76,211,.360,31,92,.337,45,119,.378,.434,16,21,.762,16,56,72,38,9,4,29,73,199
289,Adam Morrison\morriad01,SF,24,LAL,8,0,44,4,12,.333,1,4,.250,3,8,.375,.375,1,2,.500,2,6,8,3,0,0,3,4,10
290,Anthony Morrow\morroan01,SG,23,GSW,67,17,1515,255,534,.478,86,184,.467,169,350,.483,.558,80,92,.870,78,121,199,80,36,12,52,130,676
291,Troy Murphy\murphtr01,PF,28,IND,73,73,2482,364,767,.475,161,358,.450,203,409,.496,.580,152,184,.826,146,715,861,172,58,34,114,226,1041
292,Ronald Murray\murraro01,SG,29,ATL,80,2,1975,355,795,.447,87,242,.360,268,553,.485,.501,177,233,.760,22,146,168,158,88,17,128,173,974
293,Dikembe Mutombo*\mutomdi01,C,42,HOU,9,2,96,5,13,.385,0,0,,5,13,.385,.385,6,9,.667,12,21,33,0,0,11,6,11,16
294,Eduardo Nájera\najered01,PF,32,NJN,27,0,319,33,74,.446,5,25,.200,28,49,.571,.480,8,22,.364,17,50,67,19,10,4,18,50,79
295,Steve Nash*\nashst01,PG,34,PHO,74,74,2484,428,851,.503,108,246,.439,320,605,.529,.566,196,210,.933,19,204,223,717,55,10,248,108,1160
296,DeMarcus Nelson\nelsode01,PG,23,GSW,13,5,171,24,54,.444,0,3,.000,24,51,.471,.444,5,14,.357,6,18,24,13,9,2,15,24,53
297,Jameer Nelson\nelsoja01,PG,26,ORL,42,42,1309,267,531,.503,82,181,.453,185,350,.529,.580,86,97,.887,20,125,145,226,51,3,83,123,702
298,Rasho Nesterović\nestera01,C,32,IND,70,19,1214,224,437,.513,0,1,.000,224,436,.514,.513,25,32,.781,93,147,240,109,30,38,63,171,473
299,Demetris Nichols\nichode01,SF,24,TOT,4,0,14,3,9,.333,0,2,.000,3,7,.429,.333,1,2,.500,0,2,2,1,0,1,0,1,7
299,Demetris Nichols\nichode01,SF,24,CHI,2,0,5,1,4,.250,0,1,.000,1,3,.333,.250,0,0,,0,0,0,1,0,0,0,1,2
299,Demetris Nichols\nichode01,SF,24,NYK,2,0,9,2,5,.400,0,1,.000,2,4,.500,.400,1,2,.500,0,2,2,0,0,1,0,0,5
300,Joakim Noah\noahjo01,C,23,CHI,80,55,1938,207,372,.556,0,1,.000,207,371,.558,.556,123,182,.676,244,362,606,106,49,110,82,238,537
301,Andrés Nocioni\nocioan01,PF-SF,29,TOT,76,18,1991,299,701,.427,124,311,.399,175,390,.449,.515,145,183,.792,54,307,361,102,39,33,113,261,867
301,Andrés Nocioni\nocioan01,PF,29,CHI,53,2,1278,186,449,.414,79,209,.378,107,240,.446,.502,100,124,.806,34,188,222,60,26,16,73,176,551
301,Andrés Nocioni\nocioan01,SF,29,SAC,23,16,713,113,252,.448,45,102,.441,68,150,.453,.538,45,59,.763,20,119,139,42,13,17,40,85,316
302,Steve Novak\novakst01,PF,25,LAC,71,3,1161,176,396,.444,119,286,.416,57,110,.518,.595,21,23,.913,19,106,125,40,20,5,23,71,492
303,Dirk Nowitzki\nowitdi01,PF,30,DAL,81,81,3050,774,1616,.479,61,170,.359,713,1446,.493,.498,485,545,.890,88,593,681,197,61,63,157,176,2094
304,Patrick O'Bryant\obryapa01,C,22,TOT,39,3,255,45,84,.536,0,2,.000,45,82,.549,.536,11,20,.550,13,53,66,11,6,19,22,61,101
304,Patrick O'Bryant\obryapa01,C,22,BOS,26,0,108,16,31,.516,0,0,,16,31,.516,.516,8,12,.667,7,27,34,8,3,8,17,29,40
304,Patrick O'Bryant\obryapa01,C,22,TOR,13,3,147,29,53,.547,0,2,.000,29,51,.569,.547,3,8,.375,6,26,32,3,3,11,5,32,61
305,Jermaine O'Neal\onealje01,C,30,TOT,68,61,2027,365,770,.474,0,1,.000,365,769,.475,.474,175,222,.788,126,307,433,122,29,136,144,211,905
305,Jermaine O'Neal\onealje01,C,30,TOR,41,34,1216,220,465,.473,0,1,.000,220,464,.474,.473,115,142,.810,71,217,288,67,18,82,92,130,555
305,Jermaine O'Neal\onealje01,C,30,MIA,27,27,811,145,305,.475,0,0,,145,305,.475,.475,60,80,.750,55,90,145,55,11,54,52,81,350
306,Shaquille O'Neal*\onealsh01,C,36,PHO,75,75,2252,512,841,.609,0,1,.000,512,840,.610,.609,309,519,.595,187,446,633,126,49,108,168,253,1333
307,Fabricio Oberto\obertfa01,C,33,SAS,54,11,677,61,104,.587,0,1,.000,61,103,.592,.587,20,35,.571,65,77,142,59,7,11,38,95,142
308,Greg Oden\odengr01,C,21,POR,61,39,1314,198,351,.564,0,0,,198,351,.564,.564,144,226,.637,169,255,424,31,25,69,87,238,540
309,Lamar Odom\odomla01,PF,29,LAL,78,32,2316,346,703,.492,33,103,.320,313,600,.522,.516,160,257,.623,176,461,637,204,77,98,138,235,885
310,Emeka Okafor\okafoem01,C,26,CHA,82,81,2691,433,772,.561,0,0,,433,772,.561,.561,219,369,.593,275,552,827,53,48,136,144,247,1085
311,Mehmet Okur\okurme01,C,29,UTA,72,72,2409,431,888,.485,90,202,.446,341,686,.497,.536,273,334,.817,124,433,557,120,54,53,132,219,1225
312,Kevin Ollie\ollieke01,PG,36,MIN,50,21,850,61,150,.407,0,1,.000,61,149,.409,.407,80,96,.833,13,62,75,117,19,4,34,79,202
313,Travis Outlaw\outlatr01,SF,24,POR,81,6,2246,385,850,.453,89,236,.377,296,614,.482,.505,175,242,.723,70,261,331,83,47,57,94,168,1034
314,Zaza Pachulia\pachuza01,C,24,ATL,77,26,1473,159,320,.497,0,3,.000,159,317,.502,.497,163,230,.709,173,263,436,57,35,26,91,208,481
315,Anthony Parker\parkean01,SG,33,TOR,80,71,2637,321,754,.426,94,241,.390,227,513,.442,.488,121,145,.834,45,272,317,269,100,15,114,145,857
316,Tony Parker\parketo01,PG,26,SAS,72,71,2456,639,1263,.506,19,65,.292,620,1198,.518,.513,284,363,.782,27,196,223,496,67,4,186,110,1581
317,Chris Paul\paulch01,PG,23,NOH,78,78,3002,631,1255,.503,64,176,.364,567,1079,.525,.528,455,524,.868,69,363,432,861,216,10,231,212,1781
318,Sasha Pavlović\pavloal01,SF,25,CLE,66,12,1053,116,275,.422,48,117,.410,68,158,.430,.509,25,54,.463,31,96,127,72,22,16,48,122,305
319,Oleksiy Pecherov\pecheol01,C,23,WAS,32,0,277,39,101,.386,14,43,.326,25,58,.431,.455,24,29,.828,35,41,76,2,6,3,10,34,116
320,Kendrick Perkins\perkike01,C,24,BOS,76,76,2253,276,478,.577,0,2,.000,276,476,.580,.577,96,160,.600,204,415,619,96,22,150,165,253,648
321,Morris Peterson\petermo01,SG,31,NOH,43,9,515,73,183,.399,33,85,.388,40,98,.408,.489,12,19,.632,13,71,84,16,15,2,15,51,191
322,Johan Petro\petrojo01,C,23,TOT,49,22,559,73,176,.415,0,2,.000,73,174,.420,.415,16,29,.552,42,116,158,16,19,15,28,107,162
322,Johan Petro\petrojo01,C,23,OKC,22,12,342,46,113,.407,0,1,.000,46,112,.411,.407,10,15,.667,27,68,95,6,16,5,15,51,102
322,Johan Petro\petrojo01,C,23,DEN,27,10,217,27,63,.429,0,1,.000,27,62,.435,.429,6,14,.429,15,48,63,10,3,10,13,56,60
323,Paul Pierce*\piercpa01,SF,31,BOS,81,81,3035,540,1181,.457,119,304,.391,421,877,.480,.508,459,553,.830,56,401,457,294,80,27,228,215,1658
324,Mickaël Piétrus\pietrmi01,SG,26,ORL,54,25,1329,176,426,.413,80,223,.359,96,203,.473,.507,78,110,.709,44,132,176,65,31,24,56,126,510
325,James Posey\poseyja01,SG,32,NOH,75,0,2140,216,524,.412,116,314,.369,100,210,.476,.523,120,146,.822,38,324,362,82,58,21,79,216,668
326,Leon Powe\powele01,PF,25,BOS,70,7,1227,177,338,.524,0,0,,177,338,.524,.524,184,267,.689,145,200,345,46,24,38,76,192,538
327,Josh Powell\poweljo01,PF,26,LAL,60,1,703,106,239,.444,0,0,,106,239,.444,.444,38,50,.760,71,105,176,27,9,17,51,98,250
328,Ronnie Price\pricero01,PG,25,UTA,52,17,738,77,203,.379,19,61,.311,58,142,.408,.426,34,45,.756,12,57,69,108,39,5,61,74,207
329,Tayshaun Prince\princta01,SF,28,DET,82,82,3057,459,1020,.450,56,141,.397,403,879,.458,.477,189,243,.778,128,348,476,253,44,51,101,104,1163
330,Gabe Pruitt\pruitga01,SG,22,BOS,47,0,366,31,101,.307,14,48,.292,17,53,.321,.376,17,21,.810,9,34,43,39,15,3,19,34,93
331,Joel Przybilla\przybjo01,C,29,POR,82,43,1952,168,269,.625,0,1,.000,168,268,.627,.625,112,169,.663,204,513,717,27,34,97,78,215,448
332,Chris Quinn\quinnch01,PG,25,MIA,66,0,962,118,289,.408,56,137,.409,62,152,.408,.505,47,58,.810,8,67,75,132,24,2,33,79,339
333,Vladimir Radmanović\radmavl01,SF,28,TOT,78,31,1445,196,466,.421,105,262,.401,91,204,.446,.533,43,58,.741,45,177,222,81,46,15,98,111,540
333,Vladimir Radmanović\radmavl01,SF,28,LAL,46,28,771,95,214,.444,60,136,.441,35,78,.449,.584,23,27,.852,18,99,117,38,28,7,47,51,273
333,Vladimir Radmanović\radmavl01,SF,28,CHA,32,3,674,101,252,.401,45,126,.357,56,126,.444,.490,20,31,.645,27,78,105,43,18,8,51,60,267
334,Anthony Randolph\randoan01,PF,19,GSW,63,22,1129,199,431,.462,0,4,.000,199,427,.466,.462,101,141,.716,128,235,363,49,42,74,80,141,499
335,Shavlik Randolph\randosh01,PF,25,POR,10,0,37,8,13,.615,1,1,1.000,7,12,.583,.654,1,4,.250,10,8,18,0,0,1,6,4,18
336,Zach Randolph\randoza01,PF-C,27,TOT,50,45,1757,415,873,.475,32,97,.330,383,776,.494,.494,179,244,.734,157,347,504,103,43,16,114,133,1041
336,Zach Randolph\randoza01,C,27,NYK,11,11,388,82,189,.434,7,24,.292,75,165,.455,.452,55,67,.821,40,97,137,15,13,3,23,28,226
336,Zach Randolph\randoza01,PF,27,LAC,39,34,1369,333,684,.487,25,73,.342,308,611,.504,.505,124,177,.701,117,250,367,88,30,13,91,105,815
337,Theo Ratliff\ratlith01,C,35,PHI,46,0,579,34,64,.531,0,0,,34,64,.531,.531,21,35,.600,46,82,128,9,17,47,14,77,89
338,Michael Redd\reddmi01,SG,29,MIL,33,32,1203,249,547,.455,70,191,.366,179,356,.503,.519,131,161,.814,24,83,107,88,35,2,53,45,699
339,J.J. Redick\redicjj01,SG,24,ORL,64,5,1111,117,299,.391,67,179,.374,50,120,.417,.503,81,93,.871,8,101,109,73,21,1,54,72,382
340,Jason Richardson\richaja01,SG,28,TOT,72,71,2410,465,974,.477,129,325,.397,336,649,.518,.544,153,199,.769,77,242,319,146,76,28,95,146,1212
340,Jason Richardson\richaja01,SG,28,CHA,14,14,491,97,220,.441,27,59,.458,70,161,.435,.502,41,55,.745,13,45,58,36,14,3,24,43,262
340,Jason Richardson\richaja01,SG,28,PHO,58,57,1919,368,754,.488,102,266,.383,266,488,.545,.556,112,144,.778,64,197,261,110,62,25,71,103,950
341,Jeremy Richardson\richaje01,SF,24,ORL,12,0,93,14,49,.286,6,17,.353,8,32,.250,.347,3,6,.500,1,13,14,3,0,0,3,6,37
342,Quentin Richardson\richaqu01,SG,28,NYK,72,51,1894,262,667,.393,120,329,.365,142,338,.420,.483,89,117,.761,71,248,319,117,47,7,74,132,733
343,Luke Ridnour\ridnolu01,PG,27,MIL,72,50,2033,250,621,.403,55,157,.350,195,464,.420,.447,133,153,.869,33,185,218,365,92,16,128,200,688
344,Anthony Roberson\roberan02,PG,25,TOT,29,0,276,44,120,.367,26,81,.321,18,39,.462,.475,5,5,1.000,6,16,22,20,10,1,8,18,119
344,Anthony Roberson\roberan02,PG,25,NYK,23,0,253,39,103,.379,24,71,.338,15,32,.469,.495,5,5,1.000,4,11,15,19,10,1,7,18,107
344,Anthony Roberson\roberan02,PG,25,CHI,6,0,23,5,17,.294,2,10,.200,3,7,.429,.353,0,0,,2,5,7,1,0,0,1,0,12
345,Nate Robinson\robinna01,PG,24,NYK,74,11,2209,449,1028,.437,125,385,.325,324,643,.504,.498,249,296,.841,98,192,290,301,95,6,139,206,1272
346,Sergio Rodríguez\rodrise01,PG,22,POR,80,13,1225,129,329,.392,37,114,.325,92,215,.428,.448,61,77,.792,43,87,130,286,54,2,119,133,356
347,Rajon Rondo\rondora01,PG,22,BOS,80,80,2642,383,759,.505,15,48,.313,368,711,.518,.514,172,268,.642,100,316,416,659,149,11,209,193,953
348,Derrick Rose\rosede01,PG,20,CHI,81,80,3000,574,1208,.475,16,72,.222,558,1136,.491,.482,197,250,.788,96,221,317,512,66,18,202,125,1361
349,Malik Rose\rosema01,PF,34,TOT,38,0,470,45,131,.344,0,7,.000,45,124,.363,.344,40,51,.784,17,79,96,36,10,3,36,72,130
349,Malik Rose\rosema01,PF,34,NYK,18,0,160,11,41,.268,0,4,.000,11,37,.297,.268,8,11,.727,4,27,31,10,1,1,17,24,30
349,Malik Rose\rosema01,PF,34,OKC,20,0,310,34,90,.378,0,3,.000,34,87,.391,.378,32,40,.800,13,52,65,26,9,2,19,48,100
350,Quinton Ross\rossqu01,SF,27,MEM,68,7,1164,99,259,.382,33,88,.375,66,171,.386,.446,34,42,.810,29,97,126,47,32,14,36,114,265
351,Brandon Roy\roybr01,SG,24,POR,78,78,2903,633,1318,.480,83,220,.377,550,1098,.501,.512,416,505,.824,104,266,370,400,88,22,152,127,1765
352,Michael Ruffin\ruffimi01,PF,32,POR,11,0,35,2,7,.286,0,0,,2,7,.286,.286,2,2,1.000,6,5,11,0,3,1,2,7,6
353,Brandon Rush\rushbr01,SG,23,IND,75,19,1803,243,575,.423,78,209,.373,165,366,.451,.490,46,66,.697,34,199,233,66,38,37,75,128,610
354,Kareem Rush\rushka01,SG,28,PHI,25,1,199,20,58,.345,10,33,.303,10,25,.400,.431,4,4,1.000,0,15,15,15,5,1,10,10,54
355,John Salmons\salmojo01,SF,29,TOT,79,74,2959,516,1093,.472,126,302,.417,390,791,.493,.530,288,347,.830,59,274,333,249,83,24,165,182,1446
355,John Salmons\salmojo01,SF,29,SAC,53,53,1980,351,744,.472,77,184,.418,274,560,.489,.524,191,232,.823,43,178,221,196,58,9,122,122,970
355,John Salmons\salmojo01,SF,29,CHI,26,21,979,165,349,.473,49,118,.415,116,231,.502,.543,97,115,.843,16,96,112,53,25,15,43,60,476
356,Cheikh Samb\sambch01,C,24,TOT,18,0,83,6,32,.188,0,3,.000,6,29,.207,.188,3,7,.429,10,14,24,1,3,10,3,7,15
356,Cheikh Samb\sambch01,C,24,DEN,6,0,24,2,13,.154,0,1,.000,2,12,.167,.154,0,0,,2,7,9,1,2,5,2,4,4
356,Cheikh Samb\sambch01,C,24,LAC,10,0,51,4,16,.250,0,2,.000,4,14,.286,.250,3,5,.600,7,6,13,0,1,5,1,3,11
356,Cheikh Samb\sambch01,C,24,NYK,2,0,8,0,3,.000,0,0,,0,3,.000,.000,0,2,.000,1,1,2,0,0,0,0,0,0
357,Brian Scalabrine\scalabr01,C,30,BOS,39,8,504,48,114,.421,24,61,.393,24,53,.453,.526,16,18,.889,7,43,50,18,7,10,12,73,136
358,Luis Scola\scolalu01,PF,28,HOU,82,82,2488,424,799,.531,0,3,.000,424,796,.533,.531,196,258,.760,200,520,720,123,68,11,123,261,1044
359,Thabo Sefolosha\sefolth01,SF-SG,24,TOT,66,36,1453,152,357,.426,24,87,.276,128,270,.474,.459,61,73,.836,54,188,242,111,75,45,64,104,389
359,Thabo Sefolosha\sefolth01,SF,24,CHI,43,14,735,79,182,.434,15,50,.300,64,132,.485,.475,21,25,.840,26,97,123,65,35,19,37,50,194
359,Thabo Sefolosha\sefolth01,SG,24,OKC,23,22,718,73,175,.417,9,37,.243,64,138,.464,.443,40,48,.833,28,91,119,46,40,26,27,54,195
360,Mouhamed Sene\senesa01,C,22,TOT,6,0,29,6,9,.667,0,0,,6,9,.667,.667,8,10,.800,5,9,14,0,1,3,4,2,20
360,Mouhamed Sene\senesa01,C,22,OKC,5,0,23,5,7,.714,0,0,,5,7,.714,.714,7,9,.778,3,6,9,0,1,2,3,2,17
360,Mouhamed Sene\senesa01,C,22,NYK,1,0,6,1,2,.500,0,0,,1,2,.500,.500,1,1,1.000,2,3,5,0,0,1,1,0,3
361,Ramon Sessions\sessira01,PG,22,MIL,79,39,2173,345,775,.445,6,34,.176,339,741,.457,.449,281,354,.794,64,205,269,452,83,7,152,158,977
362,Walter Sharpe\sharpwa01,PF,22,DET,8,0,20,4,11,.364,0,2,.000,4,9,.444,.364,0,2,.000,0,3,3,0,0,2,0,3,8
363,Bobby Simmons\simmobo01,SF,28,NJN,71,44,1729,198,441,.449,117,262,.447,81,179,.453,.582,43,58,.741,72,205,277,92,50,10,62,186,556
364,Cedric Simmons\simmoce01,PF,23,TOT,18,0,84,11,25,.440,0,0,,11,25,.440,.440,7,16,.438,5,11,16,2,1,4,2,8,29
364,Cedric Simmons\simmoce01,PF,23,CHI,11,0,61,11,21,.524,0,0,,11,21,.524,.524,6,14,.429,4,8,12,2,1,4,0,6,28
364,Cedric Simmons\simmoce01,PF,23,SAC,7,0,23,0,4,.000,0,0,,0,4,.000,.000,1,2,.500,1,3,4,0,0,0,2,2,1
365,Courtney Sims\simsco01,C,25,TOT,2,0,13,3,6,.500,0,0,,3,6,.500,.500,0,0,,2,2,4,0,0,0,1,1,6
365,Courtney Sims\simsco01,C,25,PHO,1,0,2,0,0,,0,0,,0,0,,,0,0,,0,0,0,0,0,0,1,0,0
365,Courtney Sims\simsco01,C,25,NYK,1,0,11,3,6,.500,0,0,,3,6,.500,.500,0,0,,2,2,4,0,0,0,0,1,6
366,Sean Singletary\singlse01,PG,23,TOT,37,2,303,31,85,.365,10,25,.400,21,60,.350,.424,18,21,.857,10,25,35,29,11,0,23,45,90
366,Sean Singletary\singlse01,PG,23,PHO,13,1,122,12,37,.324,4,10,.400,8,27,.296,.378,6,6,1.000,5,11,16,12,6,0,5,14,34
366,Sean Singletary\singlse01,PG,23,CHA,24,1,181,19,48,.396,6,15,.400,13,33,.394,.458,12,15,.800,5,14,19,17,5,0,18,31,56
367,James Singleton\singlja01,PF,27,DAL,62,6,884,117,221,.529,13,40,.325,104,181,.575,.559,67,78,.859,89,161,250,17,26,28,36,110,314
368,Brian Skinner\skinnbr01,PF,32,LAC,51,21,843,92,205,.449,0,2,.000,92,203,.453,.449,30,47,.638,72,131,203,27,17,52,43,94,214
369,Craig Smith\smithcr01,PF,25,MIN,74,31,1460,289,514,.562,0,1,.000,289,513,.563,.562,168,248,.677,98,186,284,79,31,19,105,184,746
370,J.R. Smith\smithjr01,SG,23,DEN,81,18,2245,424,950,.446,180,453,.397,244,497,.491,.541,205,272,.754,43,254,297,227,78,14,150,190,1233
371,Joe Smith\smithjo02,C,33,TOT,57,3,1102,156,333,.468,3,7,.429,153,326,.469,.473,59,82,.720,89,174,263,41,17,40,25,122,374
371,Joe Smith\smithjo02,C,33,OKC,36,3,691,99,218,.454,2,4,.500,97,214,.453,.459,38,54,.704,53,110,163,25,10,26,15,72,238
371,Joe Smith\smithjo02,C,33,CLE,21,0,411,57,115,.496,1,3,.333,56,112,.500,.500,21,28,.750,36,64,100,16,7,14,10,50,136
372,Josh Smith\smithjo03,PF,23,ATL,69,69,2421,418,849,.492,26,87,.299,392,762,.514,.508,211,359,.588,134,364,498,169,94,111,161,184,1073
373,Will Solomon\solomwi01,PG,30,TOT,53,9,712,105,245,.429,28,86,.326,77,159,.484,.486,25,34,.735,12,52,64,133,27,4,54,71,263
373,Will Solomon\solomwi01,PG,30,TOR,39,9,544,79,181,.436,15,57,.263,64,124,.516,.478,20,24,.833,9,34,43,123,20,4,49,60,193
373,Will Solomon\solomwi01,PG,30,SAC,14,0,168,26,64,.406,13,29,.448,13,35,.371,.508,5,10,.500,3,18,21,10,7,0,5,11,70
374,Darius Songaila\songada01,C,30,WAS,77,29,1521,243,457,.532,0,1,.000,243,456,.533,.532,80,90,.889,75,152,227,94,64,20,74,200,566
375,Marreese Speights\speigma01,C,21,PHI,79,2,1263,252,502,.502,2,8,.250,250,494,.506,.504,102,132,.773,123,170,293,30,27,56,46,181,608
376,Jerry Stackhouse\stackje01,SG,34,DAL,10,1,162,16,60,.267,3,19,.158,13,41,.317,.292,7,7,1.000,5,12,17,12,4,1,9,6,42
377,DeShawn Stevenson\stevede01,SG,27,WAS,32,25,886,72,231,.312,35,129,.271,37,102,.363,.387,32,60,.533,11,65,76,98,21,2,32,43,211
378,Peja Stojaković\stojape01,SF,31,NOH,61,59,2089,287,719,.399,145,384,.378,142,335,.424,.500,93,104,.894,44,220,264,75,52,3,51,101,812
379,Amar'e Stoudemire\stoudam01,PF,26,PHO,53,53,1948,404,749,.539,3,7,.429,401,742,.540,.541,323,387,.835,116,314,430,104,49,57,150,163,1134
380,Rodney Stuckey\stuckro01,PG,22,DET,79,65,2517,401,913,.439,23,78,.295,378,835,.453,.452,233,290,.803,69,206,275,387,78,11,173,217,1058
381,Robert Swift\swiftro01,C,23,OKC,26,10,343,37,71,.521,0,0,,37,71,.521,.521,12,16,.750,21,68,89,9,5,17,8,50,86
382,Stromile Swift\swiftst01,PF,29,TOT,19,0,185,24,56,.429,1,1,1.000,23,55,.418,.438,13,26,.500,16,30,46,3,4,8,16,40,62
382,Stromile Swift\swiftst01,PF,29,NJN,6,0,64,9,15,.600,0,0,,9,15,.600,.600,5,11,.455,5,8,13,1,0,2,7,15,23
382,Stromile Swift\swiftst01,PF,29,PHO,13,0,121,15,41,.366,1,1,1.000,14,40,.350,.378,8,15,.533,11,22,33,2,4,6,9,25,39
383,Wally Szczerbiak\szczewa02,SF,31,CLE,74,5,1527,179,398,.450,69,168,.411,110,230,.478,.536,90,106,.849,43,189,232,82,28,10,55,130,517
384,Mike Taylor\taylomi01,PG,23,LAC,51,5,771,110,267,.412,13,40,.325,97,227,.427,.436,56,81,.691,22,65,87,106,36,0,73,84,289
385,Sebastian Telfair\telfase01,PG,23,MIN,75,43,2095,267,697,.383,73,211,.346,194,486,.399,.435,131,160,.819,32,95,127,343,73,12,146,184,738
386,Jason Terry\terryja01,SG,31,DAL,74,11,2491,541,1168,.463,167,456,.366,374,712,.525,.535,198,225,.880,39,138,177,251,97,20,119,141,1447
387,Etan Thomas\thomaet01,C,30,WAS,26,7,306,32,66,.485,0,0,,32,66,.485,.485,16,23,.696,25,41,66,6,3,18,18,35,80
388,Kenny Thomas\thomake01,PF,31,SAC,8,0,62,3,8,.375,0,0,,3,8,.375,.375,0,0,,4,11,15,1,6,1,1,9,6
389,Kurt Thomas\thomaku01,PF,36,SAS,79,10,1404,153,304,.503,0,2,.000,153,302,.507,.503,37,45,.822,134,271,405,66,34,58,42,170,343
390,Tim Thomas\thomati01,PF,31,TOT,64,6,1247,189,438,.432,78,189,.413,111,249,.446,.521,89,121,.736,42,159,201,68,31,11,70,144,545
390,Tim Thomas\thomati01,PF,31,LAC,10,5,220,34,90,.378,6,20,.300,28,70,.400,.411,21,34,.618,14,32,46,10,3,1,14,26,95
390,Tim Thomas\thomati01,PF,31,NYK,36,1,773,119,258,.461,53,126,.421,66,132,.500,.564,54,67,.806,20,93,113,46,22,10,46,91,345
390,Tim Thomas\thomati01,PF,31,CHI,18,0,254,36,90,.400,19,43,.442,17,47,.362,.506,14,20,.700,8,34,42,12,6,0,10,27,105
391,Tyrus Thomas\thomaty01,PF,22,CHI,79,61,2175,308,683,.451,3,9,.333,305,674,.453,.453,238,304,.783,148,360,508,77,91,151,129,220,857
392,Jason Thompson\thompja02,PF,22,SAC,82,56,2303,356,717,.497,0,8,.000,356,709,.502,.497,198,286,.692,234,372,606,93,46,59,146,314,910
393,Al Thornton\thornal01,SF,25,LAC,71,67,2654,469,1051,.446,20,79,.253,449,972,.462,.456,236,313,.754,122,246,368,103,59,62,130,227,1194
394,Anthony Tolliver\tollian01,PF,23,SAS,19,0,208,19,65,.292,9,41,.220,10,24,.417,.362,5,10,.500,12,29,41,17,5,1,7,16,52
395,Alando Tucker\tuckeal02,SG,24,PHO,30,1,282,52,121,.430,8,23,.348,44,98,.449,.463,26,33,.788,19,12,31,12,5,1,14,14,138
396,Ronny Turiaf\turiaro01,C,26,GSW,79,26,1696,186,366,.508,0,3,.000,186,363,.512,.508,98,124,.790,88,272,360,166,34,168,70,243,470
397,Hedo Türkoğlu\turkohe01,SF,29,ORL,77,77,2815,423,1025,.413,134,376,.356,289,649,.445,.478,314,389,.807,45,365,410,375,64,19,204,218,1294
398,Ime Udoka\udokaim01,SF,31,SAS,67,3,1035,110,287,.383,41,125,.328,69,162,.426,.455,28,46,.609,28,159,187,54,36,12,38,86,289
399,Beno Udrih\udrihbe01,PG,26,SAC,73,72,2270,321,696,.461,35,113,.310,286,583,.491,.486,123,150,.820,46,174,220,342,81,12,158,192,800
400,Roko Ukić\ukicro01,PG,24,TOR,72,0,890,123,324,.380,11,62,.177,112,262,.427,.397,44,60,.733,27,48,75,153,30,2,60,77,301
401,Anderson Varejão\varejan01,PF,26,CLE,81,42,2306,270,504,.536,0,2,.000,270,502,.538,.536,154,250,.616,166,415,581,81,75,66,80,239,694
402,Jacque Vaughn\vaughja01,PG,33,SAS,30,0,292,24,75,.320,1,1,1.000,23,74,.311,.327,16,18,.889,4,18,22,55,6,0,15,26,65
403,Charlie Villanueva\villach01,PF,24,MIL,78,47,2095,487,1089,.447,89,258,.345,398,831,.479,.488,201,240,.838,154,366,520,137,50,56,138,254,1264
404,Jake Voskuhl\voskuja01,C,31,TOR,38,1,240,12,45,.267,0,0,,12,45,.267,.267,11,14,.786,21,38,59,8,3,4,17,60,35
405,Sasha Vujačić\vujacsa01,SG,24,LAL,80,0,1293,155,401,.387,81,223,.363,74,178,.416,.488,70,76,.921,19,116,135,113,77,7,35,154,461
406,Dwyane Wade\wadedw01,SG,27,MIA,79,79,3048,854,1739,.491,88,278,.317,766,1461,.524,.516,590,771,.765,89,309,398,589,173,106,272,178,2386
407,Von Wafer\wafervo01,SG,23,HOU,63,11,1225,229,512,.447,64,164,.390,165,348,.474,.510,88,117,.752,19,94,113,71,40,8,59,71,610
408,Henry Walker\walkebi01,SF,21,BOS,29,0,216,36,58,.621,0,1,.000,36,57,.632,.621,16,23,.696,8,21,29,13,6,2,18,51,88
409,Ben Wallace*\wallabe01,PF,34,CLE,56,53,1314,69,155,.445,0,0,,69,155,.445,.445,27,64,.422,136,226,362,44,48,75,34,82,165
410,Gerald Wallace\wallage01,SF,26,CHA,71,71,2669,389,811,.480,39,131,.298,350,680,.515,.504,365,454,.804,112,441,553,189,121,67,148,210,1182
411,Rasheed Wallace\wallara01,C,34,DET,66,63,2123,302,720,.419,113,319,.354,189,401,.471,.498,78,101,.772,56,434,490,91,62,86,59,197,795
412,Luke Walton\waltolu01,SF,28,LAL,65,34,1166,134,307,.436,17,57,.298,117,250,.468,.464,41,57,.719,55,125,180,177,32,10,69,105,326
413,Hakim Warrick\warriha01,PF,26,MEM,82,7,2029,340,693,.491,5,23,.217,335,670,.500,.494,266,374,.711,129,277,406,66,48,39,98,170,951
414,C.J. Watson\watsocj01,PG,24,GSW,77,18,1883,257,562,.457,48,120,.400,209,442,.473,.500,168,193,.870,39,153,192,206,96,4,92,137,730
415,Earl Watson\watsoea01,PG,29,OKC,68,18,1776,174,453,.384,20,85,.235,154,368,.418,.406,80,106,.755,36,147,183,391,50,11,156,137,448
416,Kyle Weaver\weaveky01,SG,22,OKC,56,19,1166,113,246,.459,32,93,.344,81,153,.529,.524,41,58,.707,31,99,130,101,47,25,69,81,299
417,Martell Webster\webstma02,SF,22,POR,1,0,5,0,1,.000,0,1,.000,0,0,,.000,0,0,,0,0,0,0,0,0,0,0,0
418,Sonny Weems\weemsso01,SG,22,DEN,12,0,55,8,25,.320,0,3,.000,8,22,.364,.320,3,8,.375,0,4,4,3,1,0,6,8,19
419,David West\westda01,PF,28,NOH,76,76,2982,610,1292,.472,6,25,.240,604,1267,.477,.474,367,415,.884,160,486,646,173,49,68,163,207,1593
420,Delonte West\westde01,SG,25,CLE,64,64,2152,285,624,.457,91,228,.399,194,396,.490,.530,90,108,.833,31,172,203,226,94,13,92,125,751
421,Mario West\westma02,SG,24,ATL,53,3,269,14,34,.412,1,1,1.000,13,33,.394,.426,14,30,.467,24,32,56,19,18,4,13,35,43
422,Russell Westbrook\westbru01,PG,20,OKC,82,65,2668,436,1095,.398,35,129,.271,401,966,.415,.414,349,428,.815,178,221,399,435,110,16,274,191,1256
423,D.J. White\whitedj01,PF,22,OKC,7,0,130,26,50,.520,0,0,,26,50,.520,.520,10,13,.769,10,22,32,6,3,5,3,10,62
424,James White\whiteja02,SF,26,HOU,4,0,11,3,5,.600,1,2,.500,2,3,.667,.700,0,0,,0,0,0,1,1,1,3,2,7
425,Chris Wilcox\wilcoch01,C,26,TOT,62,6,1049,184,370,.497,0,4,.000,184,366,.503,.497,79,140,.564,96,181,277,47,26,16,75,137,447
425,Chris Wilcox\wilcoch01,C,26,OKC,37,6,719,130,268,.485,0,3,.000,130,265,.491,.485,52,87,.598,65,130,195,33,18,11,55,89,312
425,Chris Wilcox\wilcoch01,C,26,NYK,25,0,330,54,102,.529,0,1,.000,54,101,.535,.529,27,53,.509,31,51,82,14,8,5,20,48,135
426,Damien Wilkins\wilkida02,SG,29,OKC,41,14,636,77,213,.362,27,72,.375,50,141,.355,.425,37,46,.804,20,50,70,37,22,7,37,55,218
427,Deron Williams\willide01,PG,24,UTA,68,68,2505,463,984,.471,70,226,.310,393,758,.518,.506,326,384,.849,24,171,195,725,73,20,228,134,1322
428,Jawad Williams\willija04,SF,25,CLE,10,0,20,5,12,.417,2,6,.333,3,6,.500,.500,0,0,,1,1,2,0,1,0,1,2,12
429,Lou Williams\willilo02,SG,22,PHI,81,0,1919,336,844,.398,63,220,.286,273,624,.438,.435,304,385,.790,36,129,165,242,85,14,151,128,1039
430,Marcus Williams\willima03,PG,23,GSW,9,0,54,4,17,.235,2,6,.333,2,11,.182,.294,2,6,.333,0,4,4,13,1,1,4,6,12
431,Marcus Williams\willima04,PF,22,SAS,2,0,3,2,2,1.000,0,0,,2,2,1.000,1.000,0,0,,0,0,0,0,0,0,0,1,4
432,Marvin Williams\willima02,SF,22,ATL,61,59,2093,285,622,.458,55,155,.355,230,467,.493,.502,220,273,.806,110,272,382,81,57,39,70,127,845
433,Mo Williams\willima01,PG,26,CLE,81,81,2834,526,1126,.467,183,420,.436,343,706,.486,.548,208,228,.912,47,232,279,329,69,9,179,215,1443
434,Sean Williams\willise01,PF,22,NJN,33,0,366,30,72,.417,0,0,,30,72,.417,.417,20,32,.625,34,45,79,13,7,29,20,72,80
435,Shawne Williams\willish03,SF,22,DAL,15,0,170,16,56,.286,1,17,.059,15,39,.385,.295,9,11,.818,19,27,46,2,2,9,5,19,42
436,Shelden Williams\willish02,PF,25,TOT,45,0,512,70,157,.446,0,2,.000,70,155,.452,.446,46,63,.730,49,104,153,12,22,18,34,64,186
436,Shelden Williams\willish02,PF,25,SAC,30,0,305,40,89,.449,0,2,.000,40,87,.460,.449,32,42,.762,25,53,78,8,12,10,26,36,112
436,Shelden Williams\willish02,PF,25,MIN,15,0,207,30,68,.441,0,0,,30,68,.441,.441,14,21,.667,24,51,75,4,10,8,8,28,74
437,Metta World Peace\artesro01,SF,29,HOU,69,55,2452,416,1037,.401,153,383,.399,263,654,.402,.475,196,262,.748,65,294,359,229,105,24,140,155,1181
438,Antoine Wright\wrighan01,SF,24,DAL,65,53,1552,179,431,.415,45,149,.302,134,282,.475,.468,71,95,.747,31,105,136,77,46,27,54,172,474
439,Brandan Wright\wrighbr03,PF,21,GSW,39,23,688,130,246,.528,0,4,.000,130,242,.537,.528,63,85,.741,62,95,157,21,22,37,23,74,323
440,Dorell Wright\wrighdo01,SF,23,MIA,6,0,73,8,20,.400,0,0,,8,20,.400,.400,2,6,.333,2,18,20,2,2,0,6,8,18
441,Julian Wright\wrighju01,SF,21,NOH,54,19,772,109,234,.466,2,21,.095,107,213,.502,.470,17,30,.567,46,106,152,43,35,19,43,49,237
442,Lorenzen Wright\wrighlo02,C,33,CLE,17,2,125,10,27,.370,0,0,,10,27,.370,.370,3,8,.375,7,18,25,3,4,5,9,17,23
443,Nick Young\youngni01,SG,23,WAS,82,5,1837,336,756,.444,56,164,.341,280,592,.473,.481,164,193,.850,31,119,150,95,39,20,92,140,892
444,Thaddeus Young\youngth01,PF,20,PHI,75,71,2580,475,960,.495,56,164,.341,419,796,.526,.524,139,189,.735,139,238,377,86,100,23,118,165,1145
445,Sun Yue\yuesu01,SG,23,LAL,10,0,28,3,11,.273,0,6,.000,3,5,.600,.273,0,0,,0,0,0,2,1,1,3,10,6