Rk,Player,Pos,Age,Tm,G,GS,MP,FG,FGA,FG%,3P,3PA,3P%,2P,2PA,2P%,eFG%,FT,FTA,FT%,ORB,DRB,TRB,AST,STL,BLK,TOV,PF,PTS
1,Jeff Adrien\adrieje01,PF,24,GSW,23,0,196,23,54,.426,0,0,,23,54,.426,.426,11,19,.579,23,35,58,10,4,5,9,28,57
2,Arron Afflalo\afflaar01,SG,25,DEN,69,69,2324,312,627,.498,105,248,.423,207,379,.546,.581,138,163,.847,45,206,251,168,34,31,71,153,867
3,Maurice Ager\agerma01,SG,26,MIN,4,0,29,6,11,.545,3,4,.750,3,7,.429,.682,0,0,,0,2,2,1,1,0,4,4,15
4,Alexis Ajinça\ajincal01,C,22,TOT,34,2,340,59,133,.444,12,34,.353,47,99,.475,.489,13,18,.722,17,61,78,10,11,19,18,73,143
4,Alexis Ajinça\ajincal01,C,22,DAL,10,2,75,12,32,.375,3,7,.429,9,25,.360,.422,2,3,.667,5,12,17,2,3,5,1,13,29
4,Alexis Ajinça\ajincal01,C,22,TOR,24,0,265,47,101,.465,9,27,.333,38,74,.514,.510,11,15,.733,12,49,61,8,8,14,17,60,114
5,Solomon Alabi\alabiso01,C,22,TOR,12,0,59,3,15,.200,0,0,,3,15,.200,.200,0,2,.000,7,7,14,2,2,2,3,5,6
6,Cole Aldrich\aldrico01,C,22,OKC,18,0,142,8,15,.533,0,0,,8,15,.533,.533,2,4,.500,13,22,35,4,5,7,8,30,18
7,LaMarcus Aldridge\aldrila01,PF,25,POR,81,81,3211,707,1415,.500,4,23,.174,703,1392,.505,.501,351,444,.791,278,431,709,170,82,94,153,220,1769
8,Malik Allen\allenma01,PF,32,ORL,18,0,178,11,31,.355,0,0,,11,31,.355,.355,1,2,.500,12,20,32,4,1,4,3,30,23
9,Ray Allen*\allenra02,SG,35,BOS,80,80,2890,480,978,.491,168,378,.444,312,600,.520,.577,193,219,.881,51,223,274,219,77,16,117,147,1321
10,Tony Allen\allento01,SG,29,MEM,72,31,1494,251,492,.510,4,23,.174,247,469,.527,.514,137,182,.753,70,123,193,104,129,44,86,161,643
11,Al-Farouq Aminu\aminual01,SF,20,LAC,81,14,1452,160,406,.394,45,143,.315,115,263,.437,.450,92,119,.773,75,192,267,60,59,25,103,121,457
12,Lou Amundson\amundlo01,PF,28,GSW,46,7,691,83,183,.454,0,0,,83,183,.454,.454,34,87,.391,81,104,185,17,14,33,24,87,200
13,Chris Andersen\anderch01,C,32,DEN,45,0,732,82,137,.599,0,1,.000,82,136,.603,.599,86,135,.637,75,144,219,20,23,58,25,79,250
14,David Andersen\anderda03,PF,30,TOT,40,0,373,56,121,.463,8,23,.348,48,98,.490,.496,14,22,.636,20,64,84,13,5,9,22,40,134
14,David Andersen\anderda03,PF,30,TOR,11,0,150,23,47,.489,3,10,.300,20,37,.541,.521,7,7,1.000,8,26,34,7,3,3,8,11,56
14,David Andersen\anderda03,PF,30,NOH,29,0,223,33,74,.446,5,13,.385,28,61,.459,.480,7,15,.467,12,38,50,6,2,6,14,29,78
15,James Anderson\anderja01,SF,21,SAS,26,2,286,31,81,.383,18,46,.391,13,35,.371,.494,14,18,.778,2,21,23,18,3,6,13,24,94
16,Ryan Anderson\anderry01,PF,22,ORL,64,14,1424,226,525,.430,134,341,.393,92,184,.500,.558,95,117,.812,129,226,355,52,30,38,49,137,681
17,Carmelo Anthony\anthoca01,SF,26,TOT,77,77,2751,684,1503,.455,95,251,.378,589,1252,.470,.487,507,605,.838,118,445,563,221,68,46,206,224,1970
17,Carmelo Anthony\anthoca01,SF,26,DEN,50,50,1774,437,967,.452,42,126,.333,395,841,.470,.474,343,417,.823,77,305,382,140,43,31,142,134,1259
17,Carmelo Anthony\anthoca01,SF,26,NYK,27,27,977,247,536,.461,53,125,.424,194,411,.472,.510,164,188,.872,41,140,181,81,25,15,64,90,711
18,Joel Anthony\anthojo01,C,28,MIA,75,11,1463,53,99,.535,0,0,,53,99,.535,.535,47,73,.644,104,162,266,24,10,93,36,194,153
19,Gilbert Arenas\arenagi01,PG,29,TOT,70,16,1796,269,734,.366,97,327,.297,172,407,.423,.433,120,153,.784,22,167,189,274,74,21,177,188,755
19,Gilbert Arenas\arenagi01,PG,29,WAS,21,14,726,130,330,.394,47,145,.324,83,185,.449,.465,56,67,.836,6,64,70,117,30,12,71,76,363
19,Gilbert Arenas\arenagi01,PG,29,ORL,49,2,1070,139,404,.344,50,182,.275,89,222,.401,.406,64,86,.744,16,103,119,157,44,9,106,112,392
20,Trevor Ariza\arizatr01,SF,25,NOH,75,75,2600,303,762,.398,82,271,.303,221,491,.450,.451,138,197,.701,61,347,408,162,120,31,118,180,826
21,Hilton Armstrong\armsthi01,C,26,TOT,53,2,488,37,76,.487,2,4,.500,35,72,.486,.500,16,33,.485,42,89,131,14,18,21,28,84,92
21,Hilton Armstrong\armsthi01,C,26,WAS,41,2,412,31,64,.484,1,3,.333,30,61,.492,.492,14,23,.609,39,75,114,10,15,16,25,75,77
21,Hilton Armstrong\armsthi01,C,26,ATL,12,0,76,6,12,.500,1,1,1.000,5,11,.455,.542,2,10,.200,3,14,17,4,3,5,3,9,15
22,Carlos Arroyo\arroyca01,PG,31,TOT,64,43,1185,120,273,.440,31,69,.449,89,204,.436,.496,39,47,.830,20,83,103,125,21,1,60,71,310
22,Carlos Arroyo\arroyca01,PG,31,MIA,49,42,995,109,238,.458,28,64,.438,81,174,.466,.517,28,35,.800,13,67,80,100,14,1,43,60,274
22,Carlos Arroyo\arroyca01,PG,31,BOS,15,1,190,11,35,.314,3,5,.600,8,30,.267,.357,11,12,.917,7,16,23,25,7,0,17,11,36
23,Darrell Arthur\arthuda01,PF,22,MEM,80,9,1609,310,624,.497,0,6,.000,310,618,.502,.497,109,134,.813,115,227,342,53,52,63,88,228,729
24,Ömer Aşık\asikom01,C,24,CHI,82,0,989,78,141,.553,0,0,,78,141,.553,.553,73,145,.503,112,194,306,32,20,56,64,153,229
25,D.J. Augustin\augusdj01,PG,23,CHA,82,82,2757,399,958,.416,111,333,.333,288,625,.461,.474,269,297,.906,38,187,225,498,54,3,155,152,1178
26,Luke Babbitt\babbilu01,SF,21,POR,24,0,137,15,55,.273,3,16,.188,12,39,.308,.300,3,9,.333,6,24,30,6,2,2,8,15,36
27,Renaldo Balkman\balkmre01,SF,26,TOT,8,0,62,6,13,.462,1,2,.500,5,11,.455,.500,3,4,.750,2,5,7,2,4,2,1,15,16
27,Renaldo Balkman\balkmre01,SF,26,DEN,5,0,44,5,9,.556,0,0,,5,9,.556,.556,3,4,.750,1,3,4,2,3,2,0,11,13
27,Renaldo Balkman\balkmre01,SF,26,NYK,3,0,18,1,4,.250,1,2,.500,0,2,.000,.375,0,0,,1,2,3,0,1,0,1,4,3
28,Marcus Banks\banksma01,PG,29,TOR,3,0,22,0,2,.000,0,0,,0,2,.000,.000,6,8,.750,0,1,1,3,1,0,2,4,6
29,Leandro Barbosa\barbole01,SG,28,TOR,58,0,1395,294,653,.450,72,213,.338,222,440,.505,.505,109,137,.796,14,85,99,119,50,6,84,112,769
30,J.J. Barea\bareajo01,PG,26,DAL,81,2,1669,285,649,.439,66,189,.349,219,460,.476,.490,133,157,.847,29,130,159,317,30,1,136,136,769
31,Andrea Bargnani\bargnan01,C,25,TOR,66,66,2353,525,1173,.448,77,223,.345,448,950,.472,.480,287,350,.820,74,269,343,119,34,46,152,160,1414
32,Matt Barnes\barnema02,SF,30,LAL,53,0,1020,131,279,.470,34,107,.318,97,172,.564,.530,60,77,.779,73,155,228,71,39,22,58,127,356
33,Earl Barron\barroea01,C,29,TOT,21,7,305,32,99,.323,0,0,,32,99,.323,.323,15,24,.625,32,44,76,11,8,6,16,46,79
33,Earl Barron\barroea01,C,29,PHO,12,6,183,12,51,.235,0,0,,12,51,.235,.235,12,20,.600,16,24,40,4,6,4,11,32,36
33,Earl Barron\barroea01,C,29,MIL,7,0,85,17,37,.459,0,0,,17,37,.459,.459,2,2,1.000,12,10,22,4,2,2,2,10,36
33,Earl Barron\barroea01,C,29,POR,2,1,37,3,11,.273,0,0,,3,11,.273,.273,1,2,.500,4,10,14,3,0,0,3,4,7
34,Brandon Bass\bassbr01,PF,25,ORL,76,51,1980,332,645,.515,0,2,.000,332,643,.516,.515,190,233,.815,134,290,424,57,27,52,97,159,854
35,Tony Battie\battito01,C,34,PHI,38,0,377,45,96,.469,2,3,.667,43,93,.462,.479,8,14,.571,17,82,99,12,5,15,12,59,100
36,Shane Battier\battish01,SF,32,TOT,82,59,2375,229,509,.450,102,267,.382,127,242,.525,.550,64,93,.688,90,283,373,185,69,81,79,158,624
36,Shane Battier\battish01,SF,32,HOU,59,59,1818,186,408,.456,88,225,.391,98,183,.536,.564,49,76,.645,58,223,281,153,53,71,63,127,509
36,Shane Battier\battish01,SF,32,MEM,23,0,557,43,101,.426,14,42,.333,29,59,.492,.495,15,17,.882,32,60,92,32,16,10,16,31,115
37,Nicolas Batum\batumni01,SF,22,POR,80,67,2522,367,807,.455,118,342,.345,249,465,.535,.528,138,164,.841,109,252,361,123,68,49,83,194,990
38,Jerryd Bayless\bayleje01,PG,22,TOT,71,14,1496,218,517,.422,49,146,.336,169,371,.456,.469,166,206,.806,26,139,165,266,38,5,127,149,651
38,Jerryd Bayless\bayleje01,PG,22,NOH,11,0,149,17,49,.347,3,14,.214,14,35,.400,.378,13,17,.765,2,13,15,28,2,1,17,16,50
38,Jerryd Bayless\bayleje01,PG,22,TOR,60,14,1347,201,468,.429,46,132,.348,155,336,.461,.479,153,189,.810,24,126,150,238,36,4,110,133,601
39,Michael Beasley\beaslmi01,SF,22,MIN,73,73,2361,561,1246,.450,60,164,.366,501,1082,.463,.474,219,291,.753,118,291,409,158,54,52,195,222,1401
40,Rodrigue Beaubois\beaubro01,PG,22,DAL,28,26,496,94,223,.422,25,83,.301,69,140,.493,.478,23,30,.767,7,45,52,64,20,8,47,76,236
41,Marco Belinelli\belinma01,SG,24,NOH,80,69,1957,302,691,.437,134,324,.414,168,367,.458,.534,98,125,.784,17,134,151,92,38,6,77,146,836
42,Charlie Bell\bellch01,SG,31,GSW,19,0,171,12,43,.279,6,21,.286,6,22,.273,.349,2,4,.500,6,12,18,13,6,1,6,13,32
43,Raja Bell\bellra01,SG,34,UTA,68,63,2097,191,467,.409,68,193,.352,123,274,.449,.482,91,102,.892,31,145,176,118,56,14,63,169,541
44,Mike Bibby\bibbymi01,PG,32,TOT,80,68,2285,248,576,.431,153,348,.440,95,228,.417,.563,39,62,.629,17,178,195,265,50,9,101,175,688
44,Mike Bibby\bibbymi01,PG,32,ATL,56,56,1674,192,441,.435,113,256,.441,79,185,.427,.563,29,46,.630,15,128,143,202,38,6,68,125,526
44,Mike Bibby\bibbymi01,PG,32,WAS,2,0,29,1,9,.111,0,4,.000,1,5,.200,.111,0,0,,0,3,3,8,1,0,1,3,2
44,Mike Bibby\bibbymi01,PG,32,MIA,22,12,582,55,126,.437,40,88,.455,15,38,.395,.595,10,16,.625,2,47,49,55,11,3,32,47,160
45,Andris Biedriņš\biedran01,C,24,GSW,59,55,1397,142,266,.534,0,0,,142,266,.534,.534,10,31,.323,145,281,426,60,52,52,57,198,294
46,Chauncey Billups\billuch01,PG,34,TOT,72,72,2310,339,794,.427,146,363,.402,193,431,.448,.519,384,419,.916,25,165,190,387,71,14,177,146,1208
46,Chauncey Billups\billuch01,PG,34,DEN,51,51,1646,235,536,.438,105,238,.441,130,298,.436,.536,265,287,.923,12,113,125,271,52,12,129,94,840
46,Chauncey Billups\billuch01,PG,34,NYK,21,21,664,104,258,.403,41,125,.328,63,133,.474,.483,119,132,.902,13,52,65,116,19,2,48,52,368
47,DeJuan Blair\blairde01,PF,21,SAS,81,65,1734,292,583,.501,0,2,.000,292,581,.503,.501,90,137,.657,215,350,565,77,95,42,113,213,674
48,Steve Blake\blakest01,PG,30,LAL,79,0,1581,110,306,.359,73,193,.378,37,113,.327,.479,26,30,.867,19,137,156,170,40,3,73,99,319
49,Andray Blatche\blatcan01,PF,24,WAS,64,63,2172,426,957,.445,4,18,.222,422,939,.449,.447,220,283,.777,183,343,526,144,98,51,172,182,1076
50,Eric Bledsoe\bledser01,PG,21,LAC,81,25,1841,206,486,.424,32,116,.276,174,370,.470,.457,99,133,.744,68,155,223,289,92,26,194,130,543
51,Keith Bogans\boganke01,SG,30,CHI,82,82,1461,124,307,.404,90,237,.380,34,70,.486,.550,21,32,.656,19,129,148,101,38,9,41,113,359
52,Andrew Bogut\bogutan01,C,26,MIL,65,65,2297,367,742,.495,0,4,.000,367,738,.497,.495,96,217,.442,199,521,720,131,47,168,125,217,830
53,Matt Bonner\bonnema01,PF,30,SAS,66,1,1432,172,371,.464,105,230,.457,67,141,.475,.605,32,43,.744,60,179,239,60,26,21,27,110,481
54,Trevor Booker\booketr01,PF,23,WAS,65,14,1063,139,253,.549,0,1,.000,139,252,.552,.549,68,101,.673,98,153,251,35,29,42,38,115,346
55,Carlos Boozer\boozeca01,C,29,CHI,59,59,1882,431,845,.510,0,0,,431,845,.510,.510,171,244,.701,130,435,565,145,45,18,149,186,1033
56,Chris Bosh*\boshch01,PF,26,MIA,77,77,2795,524,1056,.496,6,25,.240,518,1031,.502,.499,384,471,.815,141,500,641,144,59,49,138,172,1438
57,Earl Boykins\boykiea01,PG,34,MIL,57,0,862,156,352,.443,27,71,.380,129,281,.459,.482,69,82,.841,15,40,55,141,38,3,52,43,408
58,Craig Brackins\brackcr01,PF,23,PHI,3,0,33,4,16,.250,0,5,.000,4,11,.364,.250,0,0,,2,2,4,1,1,0,0,3,8
59,Avery Bradley\bradlav01,PG,20,BOS,31,0,162,23,67,.343,0,5,.000,23,62,.371,.343,6,12,.500,4,13,17,12,9,0,16,20,52
60,Elton Brand\brandel01,PF,31,PHI,81,81,2809,502,981,.512,0,1,.000,502,980,.512,.512,213,273,.780,237,439,676,120,92,106,101,244,1217
61,Corey Brewer\breweco01,SF-SG,24,TOT,69,24,1510,193,488,.395,30,112,.268,163,376,.434,.426,136,192,.708,57,118,175,89,100,16,87,159,552
61,Corey Brewer\breweco01,SF,24,MIN,56,22,1362,168,437,.384,26,99,.263,142,338,.420,.414,121,171,.708,45,107,152,77,89,14,77,134,483
61,Corey Brewer\breweco01,SG,24,DAL,13,2,148,25,51,.490,4,13,.308,21,38,.553,.529,15,21,.714,12,11,23,12,11,2,10,25,69
62,Ronnie Brewer\brewero02,SG,25,CHI,81,1,1781,205,427,.480,6,27,.222,199,400,.498,.487,87,133,.654,55,207,262,140,106,22,55,82,503
63,Jon Brockman\brockjo01,C,23,MIL,63,6,677,48,94,.511,0,0,,48,94,.511,.511,40,59,.678,74,110,184,18,14,3,24,119,136
64,Aaron Brooks\brookaa01,PG,26,TOT,59,12,1284,220,587,.375,70,236,.297,150,351,.427,.434,124,140,.886,20,58,78,233,34,3,99,115,634
64,Aaron Brooks\brookaa01,PG,26,HOU,34,7,811,134,387,.346,48,169,.284,86,218,.394,.408,78,83,.940,11,40,51,129,21,2,55,69,394
64,Aaron Brooks\brookaa01,PG,26,PHO,25,5,473,86,200,.430,22,67,.328,64,133,.481,.485,46,57,.807,9,18,27,104,13,1,44,46,240
65,Derrick Brown\brownde04,SF,23,TOT,49,1,576,74,131,.565,5,10,.500,69,121,.570,.584,32,60,.533,41,58,99,33,20,10,35,59,185
65,Derrick Brown\brownde04,SF,23,CHA,41,1,488,62,113,.549,2,6,.333,60,107,.561,.558,25,47,.532,32,52,84,29,16,8,28,48,151
65,Derrick Brown\brownde04,SF,23,NYK,8,0,88,12,18,.667,3,4,.750,9,14,.643,.750,7,13,.538,9,6,15,4,4,2,7,11,34
66,Kwame Brown\brownkw01,C,28,CHA,66,50,1714,194,375,.517,0,0,,194,375,.517,.517,136,231,.589,147,303,450,43,26,39,69,174,524
67,Shannon Brown\brownsh01,SG,25,LAL,82,0,1568,273,643,.425,74,212,.349,199,431,.462,.482,92,101,.911,35,122,157,96,67,16,75,124,712
68,Kobe Bryant*\bryanko01,SG,32,LAL,82,82,2779,740,1639,.451,115,356,.323,625,1283,.487,.487,483,583,.828,83,336,419,388,99,12,243,172,2078
69,Chase Budinger\budinch01,SF,22,HOU,78,22,1738,279,656,.425,89,274,.325,190,382,.497,.493,118,138,.855,52,229,281,127,41,18,67,114,765
70,Caron Butler\butleca01,SF,30,DAL,29,29,867,170,378,.450,28,65,.431,142,313,.454,.487,68,88,.773,22,96,118,46,28,8,49,59,436
71,Rasual Butler\butlera01,SG,31,TOT,47,2,770,79,237,.333,46,136,.338,33,101,.327,.430,18,27,.667,10,67,77,27,8,15,24,37,222
71,Rasual Butler\butlera01,SG,31,LAC,41,2,744,73,226,.323,42,129,.326,31,97,.320,.416,18,27,.667,10,66,76,27,8,15,22,34,206
71,Rasual Butler\butlera01,SG,31,CHI,6,0,26,6,11,.545,4,7,.571,2,4,.500,.727,0,0,,0,1,1,0,0,0,2,3,16
72,Andrew Bynum\bynuman01,C,23,LAL,54,47,1500,237,413,.574,0,0,,237,413,.574,.574,138,209,.660,170,338,508,73,19,106,74,140,612
73,Will Bynum\bynumwi01,PG,28,DET,61,5,1125,182,406,.448,16,50,.320,166,356,.466,.468,102,122,.836,15,59,74,195,52,4,83,113,482
74,José Calderón\caldejo01,PG,29,TOR,68,55,2102,262,596,.440,57,156,.365,205,440,.466,.487,88,103,.854,30,172,202,605,81,7,148,143,669
75,Marcus Camby\cambyma01,C,36,POR,59,51,1540,117,294,.398,0,1,.000,117,293,.399,.398,43,70,.614,182,424,606,121,40,92,62,140,277
76,Derrick Caracter\caracde01,C,22,LAL,41,0,215,32,66,.485,0,0,,32,66,.485,.485,17,23,.739,19,24,43,7,4,10,19,47,81
77,Brian Cardinal\cardibr01,SF,33,DAL,56,4,618,43,100,.430,42,87,.483,1,13,.077,.640,17,18,.944,10,49,59,40,24,7,17,82,145
78,Rodney Carney\carnero01,SF,26,TOT,27,1,336,46,110,.418,17,38,.447,29,72,.403,.495,18,27,.667,13,35,48,11,12,5,16,33,127
78,Rodney Carney\carnero01,SF,26,GSW,25,1,331,45,107,.421,17,37,.459,28,70,.400,.500,18,27,.667,12,35,47,11,11,5,16,33,125
78,Rodney Carney\carnero01,SF,26,MEM,2,0,5,1,3,.333,0,1,.000,1,2,.500,.333,0,0,,1,0,1,0,1,0,0,0,2
79,DeMarre Carroll\carrode01,PF,24,TOT,12,0,50,4,12,.333,0,0,,4,12,.333,.333,2,2,1.000,2,6,8,4,1,1,0,5,10
79,DeMarre Carroll\carrode01,PF,24,MEM,7,0,39,4,9,.444,0,0,,4,9,.444,.444,2,2,1.000,2,6,8,2,1,1,0,5,10
79,DeMarre Carroll\carrode01,PF,24,HOU,5,0,11,0,3,.000,0,0,,0,3,.000,.000,0,0,,0,0,0,2,0,0,0,0,0
80,Matt Carroll\carroma01,SG,30,CHA,54,1,582,89,199,.447,17,46,.370,72,153,.471,.490,40,52,.769,12,56,68,23,17,6,23,43,235
81,Anthony Carter\cartean01,PG,35,TOT,33,0,463,45,106,.425,12,40,.300,33,66,.500,.481,8,8,1.000,7,44,51,69,27,6,39,49,110
81,Anthony Carter\cartean01,PG,35,DEN,14,0,153,10,30,.333,4,12,.333,6,18,.333,.400,2,2,1.000,0,12,12,26,9,1,14,19,26
81,Anthony Carter\cartean01,PG,35,NYK,19,0,310,35,76,.461,8,28,.286,27,48,.563,.513,6,6,1.000,7,32,39,43,18,5,25,30,84
82,Vince Carter\cartevi01,SG,34,TOT,73,63,2051,389,891,.437,116,321,.361,273,570,.479,.502,128,173,.740,54,221,275,146,67,20,90,193,1022
82,Vince Carter\cartevi01,SG,34,ORL,22,22,664,125,266,.470,27,78,.346,98,188,.521,.521,56,75,.747,11,79,90,64,20,3,36,70,333
82,Vince Carter\cartevi01,SG,34,PHO,51,41,1387,264,625,.422,89,243,.366,175,382,.458,.494,72,98,.735,43,142,185,82,47,17,54,123,689
83,Omri Casspi\casspom01,SF,22,SAC,71,27,1702,225,546,.412,92,247,.372,133,299,.445,.496,68,101,.673,74,233,307,74,54,13,68,115,610
84,Mario Chalmers\chalmma01,PG,24,MIA,70,28,1579,155,388,.399,83,231,.359,72,157,.459,.506,54,62,.871,12,134,146,177,76,7,91,158,447
85,Tyson Chandler\chandty01,C,28,DAL,74,74,2059,266,407,.654,0,0,,266,407,.654,.654,216,295,.732,206,486,692,32,36,80,88,240,748
86,Wilson Chandler\chandwi01,SF,23,TOT,72,49,2401,429,953,.450,112,320,.350,317,633,.501,.509,130,161,.807,75,333,408,120,48,94,104,199,1100
86,Wilson Chandler\chandwi01,SF,23,NYK,51,30,1759,328,712,.461,86,245,.351,242,467,.518,.521,96,119,.807,62,241,303,86,34,70,67,152,838
86,Wilson Chandler\chandwi01,SF,23,DEN,21,19,642,101,241,.419,26,75,.347,75,166,.452,.473,34,42,.810,13,92,105,34,14,24,37,47,262
87,Josh Childress\childjo01,SG,27,PHO,54,3,894,121,214,.565,1,16,.063,120,198,.606,.568,29,59,.492,69,86,155,42,33,23,44,68,272
88,Earl Clark\clarkea01,SF,23,TOT,42,0,464,68,158,.430,0,5,.000,68,153,.444,.430,27,47,.574,37,64,101,9,8,18,28,45,163
88,Earl Clark\clarkea01,SF,23,PHO,9,0,72,12,31,.387,0,0,,12,31,.387,.387,5,10,.500,4,13,17,4,1,3,2,6,29
88,Earl Clark\clarkea01,SF,23,ORL,33,0,392,56,127,.441,0,5,.000,56,122,.459,.441,22,37,.595,33,51,84,5,7,15,26,39,134
89,Jarron Collins\collija03,C,32,TOT,28,0,181,6,21,.286,0,0,,6,21,.286,.286,7,10,.700,14,10,24,2,4,1,7,29,19
89,Jarron Collins\collija03,C,32,LAC,23,0,157,5,15,.333,0,0,,5,15,.333,.333,7,10,.700,7,10,17,1,4,1,5,24,17
89,Jarron Collins\collija03,C,32,POR,5,0,24,1,6,.167,0,0,,1,6,.167,.167,0,0,,7,0,7,1,0,0,2,5,2
90,Jason Collins\collija04,C,32,ATL,49,28,593,34,71,.479,1,1,1.000,33,70,.471,.486,27,41,.659,30,72,102,22,9,9,26,97,96
91,Sherron Collins\collish01,PG,23,CHA,20,0,66,7,25,.280,2,10,.200,5,15,.333,.320,1,1,1.000,0,5,5,8,2,0,4,2,17
92,Darren Collison\collida01,PG,23,IND,79,79,2360,398,870,.457,41,124,.331,357,746,.479,.481,202,232,.871,40,185,225,403,87,14,194,109,1039
93,Nick Collison\collini01,C,30,OKC,71,2,1524,137,242,.566,0,0,,137,242,.566,.566,55,73,.753,119,197,316,69,42,31,55,210,329
94,Mike Conley\conlemi01,PG,23,MEM,81,81,2872,423,953,.444,80,217,.369,343,736,.466,.486,181,247,.733,32,215,247,528,144,18,176,182,1107
95,Brian Cook\cookbr01,PF,30,LAC,40,0,447,72,170,.424,34,79,.430,38,91,.418,.524,15,24,.625,19,77,96,15,12,11,25,75,193
96,Daequan Cook\cookda02,SG,23,OKC,43,0,598,79,181,.436,65,154,.422,14,27,.519,.616,16,20,.800,8,64,72,20,14,1,17,51,239
97,Marcus Cousin\cousima01,C,24,UTA,4,0,18,2,3,.667,0,0,,2,3,.667,.667,0,0,,0,3,3,0,0,1,1,1,4
98,DeMarcus Cousins\couside01,C,20,SAC,81,62,2309,432,1004,.430,3,18,.167,429,986,.435,.432,276,402,.687,217,482,699,204,85,68,268,332,1143
99,Jamal Crawford\crawfja01,SG,30,ATL,76,0,2297,368,874,.421,119,349,.341,249,525,.474,.489,222,260,.854,22,108,130,241,57,14,145,97,1077
100,Jordan Crawford\crawfjo02,SG,22,TOT,42,18,1027,192,500,.384,33,128,.258,159,372,.427,.417,73,84,.869,31,74,105,117,39,3,83,63,490
100,Jordan Crawford\crawfjo02,SG,22,ATL,16,0,160,27,77,.351,9,27,.333,18,50,.360,.409,4,6,.667,9,19,28,15,3,0,15,13,67
100,Jordan Crawford\crawfjo02,SG,22,WAS,26,18,867,165,423,.390,24,101,.238,141,322,.438,.418,69,78,.885,22,55,77,102,36,3,68,50,423
101,Dante Cunningham\cunnida01,PF,23,TOT,78,18,1637,218,472,.462,1,13,.077,217,459,.473,.463,45,62,.726,96,181,277,43,54,43,51,177,482
101,Dante Cunningham\cunnida01,PF,23,POR,56,9,1108,126,291,.433,0,4,.000,126,287,.439,.433,32,45,.711,73,116,189,30,39,32,33,139,284
101,Dante Cunningham\cunnida01,PF,23,CHA,22,9,529,92,181,.508,1,9,.111,91,172,.529,.511,13,17,.765,23,65,88,13,15,11,18,38,198
102,Stephen Curry\curryst01,PG,22,GSW,74,74,2489,505,1053,.480,151,342,.442,354,711,.498,.551,212,227,.934,52,234,286,432,109,20,226,233,1373
103,Samuel Dalembert\dalemsa01,C,29,SAC,80,46,1938,268,567,.473,0,2,.000,268,565,.474,.473,108,148,.730,212,445,657,67,36,116,132,225,644
104,Erick Dampier\dampier01,C,35,MIA,51,22,815,52,89,.584,0,1,.000,52,88,.591,.584,24,44,.545,53,124,177,22,14,47,32,82,128
105,Antonio Daniels\daniean01,PG,35,PHI,4,0,35,2,5,.400,0,2,.000,2,3,.667,.400,2,2,1.000,0,5,5,2,0,0,1,0,6
106,Marquis Daniels\daniema01,SF,30,BOS,49,0,938,114,232,.491,4,21,.190,110,211,.521,.500,39,57,.684,24,89,113,64,39,22,38,63,271
107,Baron Davis\davisba01,PG,31,TOT,58,44,1649,289,693,.417,81,239,.339,208,454,.458,.475,101,131,.771,35,121,156,391,78,28,146,143,760
107,Baron Davis\davisba01,PG,31,LAC,43,35,1269,214,515,.416,45,152,.296,169,363,.466,.459,79,104,.760,29,91,120,299,62,22,107,114,552
107,Baron Davis\davisba01,PG,31,CLE,15,9,380,75,178,.421,36,87,.414,39,91,.429,.522,22,27,.815,6,30,36,92,16,6,39,29,208
108,Ed Davis\davised01,PF,21,TOR,65,17,1602,215,373,.576,0,0,,215,373,.576,.576,71,128,.555,168,294,462,40,39,67,48,183,501
109,Glen Davis\davisgl01,C,25,BOS,78,13,2298,359,801,.448,2,15,.133,357,786,.454,.449,195,265,.736,101,324,425,92,78,30,85,231,915
110,Austin Daye\dayeau01,SF,22,DET,72,16,1446,193,471,.410,69,172,.401,124,299,.415,.483,82,108,.759,64,210,274,78,39,39,59,165,537
111,Carlos Delfino\delfica01,SF,28,MIL,49,40,1590,200,513,.390,105,284,.370,95,229,.415,.492,60,75,.800,24,176,200,112,76,8,57,72,565
112,Luol Deng\denglu01,SF,25,CHI,82,82,3208,531,1155,.460,115,333,.345,416,822,.506,.510,253,336,.753,116,360,476,230,78,48,156,162,1430
113,DeMar DeRozan\derozde01,SG,21,TOR,82,82,2851,539,1154,.467,5,52,.096,534,1102,.485,.469,327,402,.813,75,240,315,148,85,31,144,217,1410
114,Boris Diaw\diawbo01,PF,28,CHA,82,82,2778,381,774,.492,78,226,.345,303,548,.553,.543,84,123,.683,105,309,414,337,74,46,166,190,924
115,Ike Diogu\dioguik01,PF,27,LAC,36,0,470,83,148,.561,0,0,,83,148,.561,.561,41,62,.661,41,74,115,2,3,3,22,72,207
116,DeSagana Diop\diopde01,C,29,CHA,16,0,181,8,24,.333,0,0,,8,24,.333,.333,4,11,.364,12,28,40,7,4,15,11,26,20
117,Keyon Dooling\doolike01,PG,30,MIL,80,22,1757,206,519,.397,81,234,.346,125,285,.439,.475,78,94,.830,12,105,117,243,54,4,91,119,571
118,Joey Dorsey\dorsejo01,C,27,TOR,43,9,522,52,99,.525,0,0,,52,99,.525,.525,31,65,.477,79,111,190,27,24,17,39,78,135
119,Toney Douglas\douglto01,SG,24,NYK,81,9,1971,314,755,.416,143,383,.373,171,372,.460,.511,85,107,.794,65,179,244,244,89,4,89,177,856
120,Chris Douglas-Roberts\douglch01,SF,24,MIL,44,12,884,117,273,.429,15,46,.326,102,227,.449,.456,74,89,.831,7,81,88,50,29,13,35,73,323
121,Zabian Dowdell\dowdeza01,PG,26,PHO,24,0,292,51,125,.408,3,10,.300,48,115,.417,.420,16,17,.941,5,15,20,51,20,2,29,30,121
122,Goran Dragić\dragigo01,PG,24,TOT,70,5,1234,192,441,.435,56,155,.361,136,286,.476,.499,83,133,.624,36,106,142,204,50,10,117,125,523
122,Goran Dragić\dragigo01,PG,24,PHO,48,2,856,133,316,.421,28,101,.277,105,215,.488,.465,59,97,.608,24,62,86,149,36,6,96,90,353
122,Goran Dragić\dragigo01,PG,24,HOU,22,3,378,59,125,.472,28,54,.519,31,71,.437,.584,24,36,.667,12,44,56,55,14,4,21,35,170
123,Jared Dudley\dudleja01,SF,25,PHO,82,15,2140,300,629,.477,105,253,.415,195,376,.519,.560,162,218,.743,111,207,318,108,87,20,77,139,867
124,Chris Duhon\duhonch01,PG,28,ORL,51,5,774,49,129,.380,13,52,.250,36,77,.468,.430,14,25,.560,9,43,52,118,16,2,61,30,125
125,Tim Duncan*\duncati01,C,34,SAS,76,76,2156,419,838,.500,0,4,.000,419,834,.502,.500,184,257,.716,169,509,678,203,50,146,122,119,1022
126,Mike Dunleavy\dunlemi02,SG,30,IND,61,44,1683,240,520,.462,102,254,.402,138,266,.519,.560,100,125,.800,28,248,276,105,40,30,69,107,682
127,Ronald Dupree\duprero01,SF,30,TOR,3,0,13,1,4,.250,0,1,.000,1,3,.333,.250,0,0,,0,3,3,1,0,0,0,2,2
128,Kevin Durant\duranke01,SF,22,OKC,78,78,3038,711,1538,.462,145,414,.350,566,1124,.504,.509,594,675,.880,57,476,533,214,88,76,218,159,2161
129,Devin Ebanks\ebankde01,SG,21,LAL,20,0,118,21,51,.412,2,5,.400,19,46,.413,.431,18,23,.783,15,12,27,2,4,5,6,7,62
130,Wayne Ellington\ellinwa01,SG,23,MIN,62,8,1181,160,397,.403,48,121,.397,112,276,.406,.463,42,53,.792,26,82,108,72,28,3,53,85,410
131,Monta Ellis\ellismo01,SG,25,GSW,80,80,3227,726,1611,.451,137,379,.361,589,1232,.478,.493,340,431,.789,44,237,281,450,168,23,252,203,1929
132,Francisco Elson\elsonfr01,C,34,UTA,62,1,610,54,113,.478,0,0,,54,113,.478,.478,26,31,.839,35,80,115,33,21,14,32,84,134
133,Melvin Ely\elyme01,C,32,DEN,30,2,366,28,51,.549,0,0,,28,51,.549,.549,13,21,.619,27,47,74,14,4,11,14,50,69
134,Semih Erden\erdense01,C,24,TOT,41,8,595,62,111,.559,0,0,,62,111,.559,.559,39,60,.650,37,81,118,20,15,24,34,104,163
134,Semih Erden\erdense01,C,24,BOS,37,7,531,58,97,.598,0,0,,58,97,.598,.598,34,54,.630,31,76,107,19,13,21,32,92,150
134,Semih Erden\erdense01,C,24,CLE,4,1,64,4,14,.286,0,0,,4,14,.286,.286,5,6,.833,6,5,11,1,2,3,2,12,13
135,Jeremy Evans\evansje01,SF,23,UTA,49,3,463,76,115,.661,0,1,.000,76,114,.667,.661,26,37,.703,36,61,97,24,17,17,19,50,178
136,Maurice Evans\evansma01,SF,32,TOT,73,24,1549,177,424,.417,55,167,.329,122,257,.475,.482,52,58,.897,52,104,156,45,34,14,33,129,461
136,Maurice Evans\evansma01,SF,32,ATL,47,12,837,79,201,.393,28,89,.315,51,112,.455,.463,24,28,.857,23,61,84,30,16,5,15,74,210
136,Maurice Evans\evansma01,SF,32,WAS,26,12,712,98,223,.439,27,78,.346,71,145,.490,.500,28,30,.933,29,43,72,15,18,9,18,55,251
137,Reggie Evans\evansre01,PF,30,TOR,30,18,798,42,103,.408,0,1,.000,42,102,.412,.408,48,88,.545,119,226,345,38,29,6,39,89,132
138,Tyreke Evans\evansty01,SG,21,SAC,57,53,2107,382,933,.409,43,148,.291,339,785,.432,.432,205,266,.771,46,229,275,319,85,30,184,143,1012
139,Patrick Ewing\ewingpa02,SF,26,NOH,7,0,19,0,5,.000,0,2,.000,0,3,.000,.000,3,4,.750,1,1,2,2,0,1,1,1,3
140,Christian Eyenga\eyengch01,SF,21,CLE,44,18,947,130,306,.425,25,91,.275,105,215,.488,.466,18,28,.643,27,96,123,35,34,28,47,78,303
141,Jordan Farmar\farmajo01,PG,24,NJN,73,18,1796,255,651,.392,109,304,.359,146,347,.421,.475,82,100,.820,24,149,173,368,62,6,139,128,701
142,Derrick Favors\favorde01,PF,19,TOT,78,27,1535,215,416,.517,0,0,,215,416,.517,.517,103,173,.595,171,241,412,39,29,68,77,246,533
142,Derrick Favors\favorde01,PF,19,NJN,56,23,1091,141,276,.511,0,0,,141,276,.511,.511,71,116,.612,126,171,297,21,18,41,56,183,353
142,Derrick Favors\favorde01,PF,19,UTA,22,4,444,74,140,.529,0,0,,74,140,.529,.529,32,57,.561,45,70,115,18,11,27,21,63,180
143,Raymond Felton\feltora01,PG-SG,26,TOT,75,54,2737,427,1005,.425,116,329,.353,311,676,.460,.483,194,241,.805,48,221,269,625,125,11,221,150,1164
143,Raymond Felton\feltora01,PG,26,NYK,54,54,2074,339,801,.423,88,268,.328,251,533,.471,.478,157,181,.867,40,154,194,488,97,11,176,113,923
143,Raymond Felton\feltora01,SG,26,DEN,21,0,663,88,204,.431,28,61,.459,60,143,.420,.500,37,60,.617,8,67,75,137,28,0,45,37,241
144,Rudy Fernández\fernaru01,SG,25,POR,78,3,1821,213,575,.370,116,361,.321,97,214,.453,.471,126,146,.863,37,135,172,193,87,14,88,134,668
145,Kyrylo Fesenko\fesenky01,C,24,UTA,53,1,456,44,100,.440,0,1,.000,44,99,.444,.440,18,46,.391,34,74,108,18,4,16,25,90,106
146,Landry Fields\fieldla01,SG,22,NYK,82,81,2541,299,602,.497,86,219,.393,213,383,.556,.568,113,147,.769,105,416,521,155,80,17,107,114,797
147,Derek Fisher\fishede01,PG,36,LAL,82,82,2297,206,529,.389,63,159,.396,143,370,.386,.449,83,103,.806,14,138,152,224,99,8,70,192,558
148,Jonny Flynn\flynnjo01,PG,21,MIN,53,8,983,108,296,.365,31,100,.310,77,196,.393,.417,32,42,.762,12,65,77,182,34,3,113,58,279
149,Gary Forbes\forbega01,SF,25,DEN,63,11,791,124,273,.454,19,58,.328,105,215,.488,.489,59,87,.678,28,88,116,49,23,6,46,77,326
150,T.J. Ford\fordtj01,PG,27,IND,41,3,773,91,236,.386,6,32,.188,85,204,.417,.398,35,48,.729,17,64,81,141,35,8,63,69,223
151,Jeff Foster\fosteje01,C,34,IND,56,3,940,80,167,.479,0,3,.000,80,164,.488,.479,27,48,.563,160,190,350,46,24,31,26,127,187
152,Randy Foye\foyera01,SG,27,LAC,63,24,1551,206,531,.388,71,217,.327,135,314,.430,.455,133,149,.893,13,90,103,170,47,21,95,122,616
153,Channing Frye\fryech01,PF,27,PHO,77,64,2541,358,829,.432,171,439,.390,187,390,.479,.535,89,107,.832,65,448,513,96,46,79,73,272,976
154,Dan Gadzuric\gadzuda01,C-PF,32,TOT,42,9,463,54,129,.419,0,1,.000,54,128,.422,.419,10,27,.370,71,64,135,14,13,29,29,91,118
154,Dan Gadzuric\gadzuda01,C,32,GSW,28,4,297,37,88,.420,0,1,.000,37,87,.425,.420,5,14,.357,53,33,86,11,10,18,21,63,79
154,Dan Gadzuric\gadzuda01,PF,32,NJN,14,5,166,17,41,.415,0,0,,17,41,.415,.415,5,13,.385,18,31,49,3,3,11,8,28,39
155,Sundiata Gaines\gainesu01,PG,24,TOT,24,0,301,42,105,.400,9,38,.237,33,67,.493,.443,18,36,.500,13,25,38,42,16,1,27,25,111
155,Sundiata Gaines\gainesu01,PG,24,MIN,8,0,65,7,22,.318,2,6,.333,5,16,.313,.364,5,10,.500,1,5,6,6,3,0,6,4,21
155,Sundiata Gaines\gainesu01,PG,24,TOR,6,0,90,15,35,.429,3,15,.200,12,20,.600,.471,2,6,.333,2,6,8,11,4,1,8,10,35
155,Sundiata Gaines\gainesu01,PG,24,NJN,10,0,146,20,48,.417,4,17,.235,16,31,.516,.458,11,20,.550,10,14,24,25,9,0,13,11,55
156,Danilo Gallinari\gallida01,PF-SF,22,TOT,62,60,2104,265,640,.414,103,293,.352,162,347,.467,.495,337,391,.862,59,246,305,104,51,27,83,144,970
156,Danilo Gallinari\gallida01,PF,22,NYK,48,48,1671,211,509,.415,83,239,.347,128,270,.474,.496,259,290,.893,48,181,229,82,38,18,58,117,764
156,Danilo Gallinari\gallida01,SF,22,DEN,14,12,433,54,131,.412,20,54,.370,34,77,.442,.489,78,101,.772,11,65,76,22,13,9,25,27,206
157,Francisco García\garcifr01,SF,29,SAC,58,34,1386,207,475,.436,81,224,.362,126,251,.502,.521,65,76,.855,24,109,133,71,51,49,45,126,560
158,Kevin Garnett*\garneke01,PF,34,BOS,71,71,2220,434,822,.528,1,5,.200,433,817,.530,.529,187,217,.862,83,548,631,171,95,57,115,148,1056
159,Marc Gasol\gasolma01,C,26,MEM,81,81,2586,364,691,.527,3,7,.429,361,684,.528,.529,220,294,.748,154,415,569,200,74,136,146,265,951
160,Pau Gasol\gasolpa01,C,30,LAL,82,82,3037,593,1120,.529,1,3,.333,592,1117,.530,.530,354,430,.823,268,568,836,273,48,130,142,203,1541
161,Rudy Gay\gayru01,SF,24,MEM,54,54,2152,409,869,.471,57,144,.396,352,725,.486,.503,194,241,.805,82,254,336,153,91,58,135,131,1069
162,Alonzo Gee\geeal01,SG,23,TOT,56,34,1118,121,264,.458,17,51,.333,104,213,.488,.491,72,92,.783,62,120,182,38,40,18,55,94,331
162,Alonzo Gee\geeal01,SG,23,SAS,5,0,18,1,3,.333,0,0,,1,3,.333,.333,0,0,,2,1,3,0,0,2,3,3,2
162,Alonzo Gee\geeal01,SG,23,WAS,11,5,127,12,27,.444,0,2,.000,12,25,.480,.444,8,12,.667,11,11,22,5,7,0,8,10,32
162,Alonzo Gee\geeal01,SG,23,CLE,40,29,973,108,234,.462,17,49,.347,91,185,.492,.498,64,80,.800,49,108,157,33,33,16,44,81,297
163,Paul George\georgpa01,SG,20,IND,61,19,1265,179,395,.453,41,138,.297,138,257,.537,.505,77,101,.762,37,187,224,65,62,26,70,127,476
164,Daniel Gibson\gibsoda01,SG,24,CLE,67,15,1865,264,660,.400,118,293,.403,146,367,.398,.489,134,163,.822,24,153,177,201,48,21,80,154,780
165,Taj Gibson\gibsota01,PF,25,CHI,80,19,1742,234,502,.466,1,8,.125,233,494,.472,.467,100,148,.676,162,296,458,58,39,106,71,203,569
166,Manu Ginóbili*\ginobma01,SG,33,SAS,80,79,2426,441,1018,.433,154,441,.349,287,577,.497,.509,357,410,.871,42,253,295,393,123,28,174,163,1393
167,Ryan Gomes\gomesry01,SF,28,LAC,76,62,2095,207,505,.410,72,211,.341,135,294,.459,.481,61,85,.718,61,193,254,118,62,12,55,159,547
168,Drew Gooden\goodedr01,PF,29,MIL,35,18,860,156,362,.431,3,20,.150,153,342,.447,.435,81,102,.794,73,165,238,47,21,18,46,98,396
169,Ben Gordon\gordobe01,SG,27,DET,82,27,2131,339,770,.440,107,266,.402,232,504,.460,.510,136,160,.850,41,154,195,171,48,16,141,178,921
170,Eric Gordon\gordoer01,SG,22,LAC,56,56,2112,427,949,.450,106,291,.364,321,658,.488,.506,287,348,.825,45,119,164,244,71,18,151,115,1247
171,Marcin Gortat\gortama01,C,26,TOT,80,14,2032,338,603,.561,1,4,.250,337,599,.563,.561,140,193,.725,148,483,631,70,36,91,81,188,817
171,Marcin Gortat\gortama01,C,26,ORL,25,2,396,44,81,.543,0,0,,44,81,.543,.543,12,18,.667,38,80,118,17,7,21,17,52,100
171,Marcin Gortat\gortama01,C,26,PHO,55,12,1636,294,522,.563,1,4,.250,293,518,.566,.564,128,175,.731,110,403,513,53,29,70,64,136,717
172,Joey Graham\grahajo01,SF,28,CLE,39,8,586,82,179,.458,9,30,.300,73,149,.490,.483,29,36,.806,8,76,84,18,6,7,28,73,202
173,Stephen Graham\grahast01,SG,28,NJN,59,28,959,81,200,.405,5,21,.238,76,179,.425,.418,31,38,.816,17,106,123,40,14,1,38,106,198
174,Danny Granger\grangda01,SF,27,IND,79,79,2763,535,1260,.425,157,407,.386,378,853,.443,.487,395,466,.848,87,338,425,203,89,62,206,213,1622
175,Aaron Gray\grayaa01,C,26,NOH,41,6,531,56,99,.566,0,0,,56,99,.566,.566,17,34,.500,59,112,171,16,11,12,32,96,129
176,Danny Green\greenda02,SG,23,SAS,8,0,92,17,35,.486,7,19,.368,10,16,.625,.586,0,0,,3,12,15,2,2,1,5,7,41
177,Jeff Green\greenje02,PF-SF,24,TOT,75,51,2427,368,820,.449,64,211,.303,304,609,.499,.488,198,244,.811,73,287,360,108,53,37,99,210,998
177,Jeff Green\greenje02,PF,24,OKC,49,49,1815,270,618,.437,56,184,.304,214,434,.493,.482,148,181,.818,57,217,274,89,40,21,76,142,744
177,Jeff Green\greenje02,SF,24,BOS,26,2,612,98,202,.485,8,27,.296,90,175,.514,.505,50,63,.794,16,70,86,19,13,16,23,68,254
178,Willie Green\greenwi01,SG,29,NOH,77,13,1674,270,609,.443,54,155,.348,216,454,.476,.488,78,100,.780,22,139,161,74,36,13,67,143,672
179,Donté Greene\greendo01,SF,22,SAC,69,21,1127,156,386,.404,45,154,.292,111,232,.478,.462,43,65,.662,49,98,147,48,36,20,60,88,400
180,Orien Greene\greenor01,SG,28,NJN,3,0,5,1,2,.500,0,0,,1,2,.500,.500,1,2,.500,0,0,0,1,1,0,0,0,3
181,Blake Griffin\griffbl01,PF,21,LAC,82,82,3112,696,1376,.506,7,24,.292,689,1352,.510,.508,446,695,.642,270,719,989,312,63,45,223,252,1845
182,Hamed Haddadi\haddaha01,C,25,MEM,31,0,168,30,58,.517,0,1,.000,30,57,.526,.517,15,23,.652,24,44,68,5,2,13,11,29,75
183,Richard Hamilton\hamilri01,SG,32,DET,55,39,1498,288,671,.429,55,144,.382,233,527,.442,.470,146,172,.849,24,102,126,171,39,4,88,95,777
184,Tyler Hansbrough\hansbty01,PF,25,IND,70,29,1535,285,613,.465,0,2,.000,285,611,.466,.465,197,253,.779,145,221,366,41,37,15,76,160,767
185,Luke Harangody\haranlu01,PF,23,TOT,49,0,640,79,206,.383,16,66,.242,63,140,.450,.422,19,26,.731,40,103,143,30,15,17,16,80,193
185,Luke Harangody\haranlu01,PF,23,BOS,28,0,241,28,71,.394,2,10,.200,26,61,.426,.408,5,8,.625,17,38,55,10,4,7,5,36,63
185,Luke Harangody\haranlu01,PF,23,CLE,21,0,399,51,135,.378,14,56,.250,37,79,.468,.430,14,18,.778,23,65,88,20,11,10,11,44,130
186,James Harden\hardeja01,SG,21,OKC,82,5,2189,298,684,.436,113,324,.349,185,360,.514,.518,289,343,.843,42,213,255,176,92,24,106,207,998
187,Al Harrington\harrial01,PF,30,DEN,73,3,1665,281,675,.416,117,328,.357,164,347,.473,.503,86,117,.735,76,256,332,101,39,10,106,202,765
188,Devin Harris\harride01,PG,27,TOT,71,70,2254,343,813,.422,58,180,.322,285,633,.450,.458,335,402,.833,17,152,169,503,70,7,207,163,1079
188,Devin Harris\harride01,PG,27,NJN,54,54,1724,260,612,.425,33,110,.300,227,502,.452,.452,258,307,.840,11,118,129,411,57,5,158,130,811
188,Devin Harris\harride01,PG,27,UTA,17,16,530,83,201,.413,25,70,.357,58,131,.443,.475,77,95,.811,6,34,40,92,13,2,49,33,268
189,Manny Harris\harrima01,SG,21,CLE,54,15,933,108,289,.374,34,92,.370,74,197,.376,.433,71,93,.763,36,104,140,85,31,7,63,65,321
190,Mike Harris\harrimi01,PF,27,HOU,4,0,16,3,6,.500,0,0,,3,6,.500,.500,2,4,.500,2,3,5,1,0,1,1,2,8
191,Udonis Haslem\hasleud01,PF,30,MIA,13,0,345,44,86,.512,0,0,,44,86,.512,.512,16,20,.800,29,77,106,6,7,3,14,39,104
192,Spencer Hawes\hawessp01,C,22,PHI,81,81,1718,264,568,.465,9,37,.243,255,531,.480,.473,47,88,.534,129,336,465,121,29,71,97,201,584
193,Chuck Hayes\hayesch01,C,27,HOU,74,63,2079,244,463,.527,0,2,.000,244,461,.529,.527,94,142,.662,219,380,599,202,79,49,86,200,582
194,Gordon Hayward\haywago01,SF,20,UTA,72,17,1218,142,293,.485,35,74,.473,107,219,.489,.544,69,97,.711,41,98,139,81,30,19,70,106,388
195,Lazar Hayward\haywala01,SF,24,MIN,42,0,419,55,154,.357,17,60,.283,38,94,.404,.412,33,42,.786,23,47,70,28,12,7,19,44,160
196,Brendan Haywood\haywobr01,C,31,DAL,72,8,1331,128,223,.574,0,1,.000,128,222,.577,.574,64,177,.362,129,247,376,19,16,74,51,146,320
197,Luther Head\headlu01,PG,28,SAC,36,14,586,68,164,.415,25,64,.391,43,100,.430,.491,39,50,.780,16,44,60,70,10,9,32,43,200
198,Gerald Henderson\hendege02,SG,23,CHA,68,30,1661,259,570,.454,7,36,.194,252,534,.472,.461,128,163,.785,49,158,207,101,50,32,64,118,653
199,Xavier Henry\henryxa01,SG,19,MEM,38,16,527,65,160,.406,2,17,.118,63,143,.441,.413,33,52,.635,9,28,37,18,11,3,13,48,165
200,Roy Hibbert\hibbero01,C,24,IND,81,80,2244,410,890,.461,0,4,.000,410,886,.463,.461,205,275,.745,182,428,610,166,33,142,185,256,1025
201,J.J. Hickson\hicksjj01,C,22,CLE,80,66,2256,429,936,.458,0,5,.000,429,931,.461,.458,247,367,.673,217,478,695,91,48,54,173,215,1105
202,Nenê\hilarne01,C,28,DEN,75,75,2291,402,654,.615,1,5,.200,401,649,.618,.615,286,402,.711,145,426,571,149,84,73,134,238,1091
203,George Hill\hillge01,PG,24,SAS,76,5,2148,287,633,.453,77,204,.377,210,429,.490,.514,233,270,.863,24,175,199,193,66,21,99,153,884
204,Grant Hill*\hillgr01,SF,38,PHO,80,80,2409,399,825,.484,45,114,.395,354,711,.498,.511,213,257,.829,77,261,338,200,64,35,134,184,1056
205,Jordan Hill\hilljo01,C,23,HOU,72,11,1125,173,352,.491,0,2,.000,173,350,.494,.491,60,85,.706,128,178,306,29,14,52,62,157,406
206,Kirk Hinrich\hinriki01,SG-PG,30,TOT,72,51,2157,278,623,.446,75,188,.399,203,435,.467,.506,106,126,.841,21,161,182,288,75,17,121,185,737
206,Kirk Hinrich\hinriki01,SG,30,WAS,48,29,1471,198,438,.452,43,112,.384,155,326,.475,.501,92,105,.876,14,115,129,210,56,10,84,119,531
206,Kirk Hinrich\hinriki01,PG,30,ATL,24,22,686,80,185,.432,32,76,.421,48,109,.440,.519,14,21,.667,7,46,53,78,19,7,37,66,206
207,Jrue Holiday\holidjr01,PG,20,PHI,82,82,2901,446,999,.446,81,222,.365,365,777,.470,.487,172,209,.823,68,264,332,531,120,29,218,203,1145
208,Ryan Hollins\holliry01,C,26,CLE,70,16,1182,131,219,.598,0,0,,131,219,.598,.598,111,163,.681,70,116,186,26,22,42,67,199,373
209,Al Horford\horfoal01,C,24,ATL,77,77,2704,513,921,.557,2,4,.500,511,917,.557,.558,150,188,.798,182,536,718,266,59,80,119,193,1178
210,Eddie House\houseed01,SG,32,MIA,56,1,978,128,321,.399,68,175,.389,60,146,.411,.505,38,40,.950,9,83,92,62,32,3,29,68,362
211,Dwight Howard\howardw01,C,25,ORL,78,78,2935,619,1044,.593,0,7,.000,619,1037,.597,.593,546,916,.596,309,789,1098,107,107,186,279,258,1784
212,Josh Howard\howarjo01,SF,30,WAS,18,10,409,58,162,.358,7,29,.241,51,133,.383,.380,29,47,.617,18,56,74,24,13,5,20,34,152
213,Juwan Howard\howarju01,PF,37,MIA,57,0,592,55,125,.440,0,0,,55,125,.440,.440,29,35,.829,36,86,122,23,10,4,25,61,139
214,Lester Hudson\hudsole01,PG,26,WAS,11,0,73,6,24,.250,4,15,.267,2,9,.222,.333,2,4,.500,1,4,5,17,4,1,7,10,18
215,Kris Humphries\humphkr01,PF,25,NJN,74,44,2061,307,583,.527,0,1,.000,307,582,.527,.527,127,191,.665,225,546,771,84,33,80,103,168,741
216,Serge Ibaka\ibakase01,PF,21,OKC,82,44,2216,335,617,.543,0,1,.000,335,616,.544,.543,138,184,.750,214,408,622,22,31,198,71,267,808
217,Andre Iguodala\iguodan01,SF,27,PHI,67,67,2469,338,759,.445,61,181,.337,277,578,.479,.486,208,300,.693,61,326,387,422,101,38,138,109,945
218,Zydrunas Ilgauskas\ilgauzy01,C,35,MIA,72,51,1145,162,319,.508,0,1,.000,162,318,.509,.508,36,46,.783,108,179,287,26,23,58,52,185,360
219,D.J. Mbenga\mbengdj01,C,30,NOH,41,0,330,23,49,.469,0,0,,23,49,.469,.469,13,18,.722,35,51,86,6,6,27,21,52,59
220,Ersan İlyasova\ilyaser01,PF,23,MIL,60,34,1505,221,507,.436,36,121,.298,185,386,.479,.471,93,104,.894,105,260,365,56,51,24,63,159,571
221,Royal Ivey\iveyro01,SG,29,OKC,25,0,155,16,38,.421,7,16,.438,9,22,.409,.513,2,2,1.000,2,14,16,7,6,1,5,17,41
222,Jarrett Jack\jackja01,SG-PG,27,TOT,83,15,1722,260,637,.408,33,108,.306,227,529,.429,.434,182,214,.850,20,153,173,242,54,6,110,102,735
222,Jarrett Jack\jackja01,PG,27,TOR,13,13,347,48,122,.393,4,24,.167,44,98,.449,.410,40,46,.870,6,36,42,59,14,0,34,25,140
222,Jarrett Jack\jackja01,SG,27,NOH,70,2,1375,212,515,.412,29,84,.345,183,431,.425,.440,142,168,.845,14,117,131,183,40,6,76,77,595
223,Darnell Jackson\jacksda01,PF,25,SAC,59,2,486,77,158,.487,3,11,.273,74,147,.503,.497,30,49,.612,49,45,94,14,12,3,23,61,187
224,Stephen Jackson\jacksst02,SG,32,CHA,67,67,2405,435,1059,.411,121,359,.337,314,700,.449,.468,249,305,.816,53,251,304,241,80,28,209,161,1240
225,Damion James\jamesda01,SF,23,NJN,25,9,403,46,103,.447,0,3,.000,46,100,.460,.447,18,28,.643,17,68,85,20,16,12,25,36,110
226,LeBron James\jamesle01,SF,26,MIA,79,79,3063,758,1485,.510,92,279,.330,666,1206,.552,.541,503,663,.759,80,510,590,554,124,50,284,163,2111
227,Antawn Jamison\jamisan01,PF,34,CLE,56,38,1842,374,876,.427,91,263,.346,283,613,.462,.479,171,234,.731,86,289,375,93,50,30,77,137,1010
228,Othyus Jeffers\jeffeot01,SG,25,TOT,17,1,322,31,65,.477,1,4,.250,30,61,.492,.485,30,46,.652,25,42,67,20,17,0,14,32,93
228,Othyus Jeffers\jeffeot01,SG,25,SAS,1,0,8,1,3,.333,0,0,,1,3,.333,.333,0,0,,0,2,2,1,0,0,1,1,2
228,Othyus Jeffers\jeffeot01,SG,25,WAS,16,1,314,30,62,.484,1,4,.250,29,58,.500,.492,30,46,.652,25,40,65,19,17,0,13,31,91
229,Al Jefferson\jeffeal01,C,26,UTA,82,82,2940,654,1319,.496,0,0,,654,1319,.496,.496,220,289,.761,235,559,794,149,46,153,105,238,1528
230,Richard Jefferson\jefferi01,SF,30,SAS,81,81,2459,304,642,.474,135,307,.440,169,335,.504,.579,148,195,.759,54,256,310,107,38,34,93,164,891
231,Jared Jeffries\jeffrja01,PF,29,TOT,42,9,601,30,86,.349,2,9,.222,28,77,.364,.360,12,29,.414,62,54,116,36,31,17,21,75,74
231,Jared Jeffries\jeffrja01,PF,29,HOU,18,0,138,11,36,.306,1,6,.167,10,30,.333,.319,4,10,.400,20,15,35,11,7,3,4,21,27
231,Jared Jeffries\jeffrja01,PF,29,NYK,24,9,463,19,50,.380,1,3,.333,18,47,.383,.390,8,19,.421,42,39,81,25,24,14,17,54,47
232,Brandon Jennings\jennibr01,PG,21,MIL,63,61,2169,361,926,.390,98,303,.323,263,623,.422,.443,199,246,.809,42,192,234,305,95,21,146,131,1019
233,Eugene Jeter\jetereu01,PG,27,SAC,62,1,858,106,259,.409,6,30,.200,100,229,.437,.421,37,41,.902,9,61,70,162,29,2,51,54,255
234,Yi Jianlian\jianlyi01,PF,23,WAS,63,11,1112,145,347,.418,3,13,.231,142,334,.425,.422,62,91,.681,79,169,248,25,27,32,51,115,355
235,Amir Johnson\johnsam01,PF,23,TOR,72,54,1853,281,495,.568,0,1,.000,281,494,.569,.568,126,160,.788,189,272,461,81,53,88,69,263,688
236,Armon Johnson\johnsar02,PG,21,POR,38,0,277,46,101,.455,5,12,.417,41,89,.461,.480,13,22,.591,11,25,36,45,5,1,38,31,110
237,Chris Johnson\johnsch03,C,25,TOT,14,1,138,9,21,.429,0,0,,9,21,.429,.429,15,20,.750,12,20,32,3,3,9,10,21,33
237,Chris Johnson\johnsch03,C,25,POR,10,1,106,7,18,.389,0,0,,7,18,.389,.389,13,18,.722,11,16,27,2,3,6,8,18,27
237,Chris Johnson\johnsch03,C,25,BOS,4,0,32,2,3,.667,0,0,,2,3,.667,.667,2,2,1.000,1,4,5,1,0,3,2,3,6
238,James Johnson\johnsja01,SF,23,TOT,38,25,822,108,237,.456,8,34,.235,100,203,.493,.473,47,71,.662,37,105,142,89,33,37,64,95,271
238,James Johnson\johnsja01,SF,23,CHI,13,0,123,17,41,.415,2,9,.222,15,32,.469,.439,6,13,.462,6,18,24,14,8,9,18,25,42
238,James Johnson\johnsja01,SF,23,TOR,25,25,699,91,196,.464,6,25,.240,85,171,.497,.480,41,58,.707,31,87,118,75,25,28,46,70,229
239,Joe Johnson\johnsjo02,SG,29,ATL,72,72,2554,514,1161,.443,89,300,.297,425,861,.494,.481,195,243,.802,59,232,291,338,47,7,146,131,1312
240,Trey Johnson\johnstr01,SG,26,TOT,8,0,94,12,33,.364,1,3,.333,11,30,.367,.379,9,10,.900,2,5,7,11,1,1,5,12,34
240,Trey Johnson\johnstr01,SG,26,TOR,7,0,81,10,30,.333,1,3,.333,9,27,.333,.350,7,8,.875,2,5,7,11,1,1,5,11,28
240,Trey Johnson\johnstr01,SG,26,LAL,1,0,13,2,3,.667,0,0,,2,3,.667,.667,2,2,1.000,0,0,0,0,0,0,0,1,6
241,Wesley Johnson\johnswe01,SG,23,MIN,79,63,2069,271,682,.397,103,289,.356,168,393,.427,.473,64,92,.696,51,189,240,148,58,54,95,163,709
242,Dahntay Jones\jonesda02,SG,30,IND,45,2,589,100,214,.467,14,39,.359,86,175,.491,.500,69,90,.767,4,61,65,33,20,7,31,70,283
243,Dominique Jones\jonesdo02,SG,22,DAL,18,0,135,14,45,.311,0,4,.000,14,41,.341,.311,14,17,.824,6,19,25,19,5,3,10,7,42
244,James Jones\jonesja02,SF,30,MIA,81,8,1549,146,346,.422,123,287,.429,23,59,.390,.600,60,72,.833,23,137,160,43,29,19,21,129,475
245,Solomon Jones\jonesso01,C,26,IND,39,0,528,49,121,.405,0,1,.000,49,120,.408,.405,41,62,.661,45,68,113,30,12,22,35,94,139
246,DeAndre Jordan\jordade01,C,22,LAC,80,66,2047,234,341,.686,0,1,.000,234,340,.688,.686,98,217,.452,207,368,575,42,41,142,101,255,566
247,Chris Kaman\kamanch01,C,28,LAC,32,15,838,177,376,.471,0,0,,177,376,.471,.471,43,57,.754,51,174,225,46,16,48,58,75,397
248,Jason Kapono\kaponja01,SF,29,PHI,24,2,112,7,28,.250,1,8,.125,6,20,.300,.268,1,2,.500,3,8,11,4,2,1,2,4,16
249,Jason Kidd*\kiddja01,PG,37,DAL,80,80,2653,215,596,.361,133,391,.340,82,205,.400,.472,67,77,.870,35,316,351,655,134,29,179,119,630
250,Andrei Kirilenko\kirilan01,SF,29,UTA,64,62,1999,253,542,.467,36,98,.367,217,444,.489,.500,208,270,.770,100,227,327,192,81,74,117,113,750
251,Linas Kleiza\kleizli01,SF,26,TOR,39,23,1032,178,406,.438,39,131,.298,139,275,.505,.486,41,65,.631,37,140,177,40,19,7,65,99,436
252,Kyle Korver\korveky01,SG,29,CHI,82,0,1649,242,557,.434,120,289,.415,122,268,.455,.542,77,87,.885,12,138,150,124,35,20,60,156,681
253,Kosta Koufos\koufoko01,C,21,TOT,50,2,434,68,150,.453,0,2,.000,68,148,.459,.453,24,43,.558,57,73,130,7,10,25,31,59,160
253,Kosta Koufos\koufoko01,C,21,MIN,39,1,336,47,108,.435,0,2,.000,47,106,.443,.435,12,24,.500,42,55,97,7,8,20,25,50,106
253,Kosta Koufos\koufoko01,C,21,DEN,11,1,98,21,42,.500,0,0,,21,42,.500,.500,12,19,.632,15,18,33,0,2,5,6,9,54
254,Nenad Krstić\krstine01,C,27,TOT,71,67,1571,231,452,.511,0,0,,231,452,.511,.511,113,146,.774,124,211,335,27,26,25,56,184,575
254,Nenad Krstić\krstine01,C,27,OKC,47,47,1018,152,305,.498,0,0,,152,305,.498,.498,53,66,.803,77,130,207,19,18,17,33,107,357
254,Nenad Krstić\krstine01,C,27,BOS,24,20,553,79,147,.537,0,0,,79,147,.537,.537,60,80,.750,47,81,128,8,8,8,23,77,218
255,Carl Landry\landrca01,PF,27,TOT,76,26,2008,345,687,.502,0,4,.000,345,683,.505,.502,213,288,.740,165,182,347,63,40,32,109,196,903
255,Carl Landry\landrca01,PF,27,SAC,53,16,1406,238,484,.492,0,3,.000,238,481,.495,.492,155,215,.721,127,126,253,50,30,20,82,125,631
255,Carl Landry\landrca01,PF,27,NOH,23,10,602,107,203,.527,0,1,.000,107,202,.530,.527,58,73,.795,38,56,94,13,10,12,27,71,272
256,Acie Law\lawac01,PG,26,TOT,51,0,726,81,186,.435,6,36,.167,75,150,.500,.452,47,64,.734,12,51,63,84,32,0,43,61,215
256,Acie Law\lawac01,PG,26,MEM,11,0,94,3,19,.158,0,6,.000,3,13,.231,.158,6,10,.600,3,8,11,14,4,0,10,10,12
256,Acie Law\lawac01,PG,26,GSW,40,0,632,78,167,.467,6,30,.200,72,137,.526,.485,41,54,.759,9,43,52,70,28,0,33,51,203
257,Gani Lawal\lawalga01,PF,22,PHO,1,0,2,0,0,,0,0,,0,0,,,0,0,,0,0,0,0,0,0,0,1,0
258,Ty Lawson\lawsoty01,PG,23,DEN,80,31,2103,346,688,.503,69,171,.404,277,517,.536,.553,172,225,.764,67,142,209,377,80,4,137,133,933
259,Courtney Lee\leeco01,SG,25,HOU,81,1,1723,253,576,.439,71,174,.408,182,402,.453,.501,95,120,.792,51,158,209,100,58,18,68,102,672
260,David Lee\leeda02,PF,27,GSW,73,73,2634,496,978,.507,1,3,.333,495,975,.508,.508,210,267,.787,217,497,714,233,74,31,170,211,1203
261,Rashard Lewis\lewisra02,SF-PF,31,TOT,57,52,1824,252,582,.433,87,244,.357,165,338,.488,.508,77,96,.802,71,219,290,92,52,30,87,159,668
261,Rashard Lewis\lewisra02,PF,31,ORL,25,25,810,113,270,.419,44,120,.367,69,150,.460,.500,34,45,.756,23,83,106,29,22,10,35,63,304
261,Rashard Lewis\lewisra02,SF,31,WAS,32,27,1014,139,312,.446,43,124,.347,96,188,.511,.514,43,51,.843,48,136,184,63,30,20,52,96,364
262,Jeremy Lin\linje01,PG,22,GSW,29,0,285,28,72,.389,1,5,.200,27,67,.403,.396,19,25,.760,12,22,34,42,33,9,18,31,76
263,Shaun Livingston\livinsh01,PG,25,CHA,73,0,1261,185,397,.466,1,4,.250,184,393,.468,.467,108,125,.864,29,120,149,164,47,29,88,109,479
264,Brook Lopez\lopezbr01,C,22,NJN,82,82,2889,644,1309,.492,0,1,.000,644,1308,.492,.492,385,489,.787,197,291,488,129,47,120,176,240,1673
265,Robin Lopez\lopezro01,C,22,PHO,67,56,991,179,357,.501,0,0,,179,357,.501,.501,74,100,.740,82,134,216,8,18,45,48,143,432
266,Kevin Love\loveke01,PF,22,MIN,73,73,2611,482,1026,.470,88,211,.417,394,815,.483,.513,424,499,.850,330,782,1112,184,45,28,155,148,1476
267,Kyle Lowry\lowryky01,PG,24,HOU,75,71,2563,345,809,.426,129,343,.376,216,466,.464,.506,192,251,.765,89,220,309,500,102,23,158,207,1011
268,John Lucas III\lucasjo02,PG,28,CHI,2,0,10,1,3,.333,0,1,.000,1,2,.500,.333,0,2,.000,0,0,0,1,0,0,0,0,2
269,Corey Maggette\maggeco01,SF,31,MIL,67,18,1401,253,559,.453,28,78,.359,225,481,.468,.478,271,325,.834,44,197,241,84,21,5,127,175,805
270,Jamaal Magloire\magloja01,C,32,MIA,18,0,158,13,22,.591,0,0,,13,22,.591,.591,9,18,.500,17,44,61,3,4,2,5,26,35
271,Ian Mahinmi\mahinia01,C,24,DAL,56,0,488,55,98,.561,0,2,.000,55,96,.573,.561,63,82,.768,43,77,120,8,14,15,25,105,173
272,Shawn Marion\mariosh01,SF,32,DAL,80,27,2253,434,834,.520,5,33,.152,429,801,.536,.523,126,164,.768,168,383,551,110,68,50,130,144,999
273,Sean Marks\marksse01,C,35,POR,29,0,208,19,44,.432,2,2,1.000,17,42,.405,.455,5,8,.625,16,24,40,4,3,5,11,44,45
274,Cartier Martin\martica01,SF,26,WAS,52,1,542,71,182,.390,39,99,.394,32,83,.386,.497,28,40,.700,20,54,74,18,18,6,16,52,209
275,Kenyon Martin\martike01,PF,33,DEN,48,48,1233,185,362,.511,2,9,.222,183,353,.518,.514,42,72,.583,67,230,297,109,43,35,59,136,414
276,Kevin Martin\martike02,SG,27,HOU,80,80,2603,553,1267,.436,176,459,.383,377,808,.467,.506,594,669,.888,28,230,258,198,80,15,184,155,1876
277,Roger Mason\masonro01,SG,30,NYK,26,0,319,26,77,.338,16,44,.364,10,33,.303,.442,7,10,.700,5,38,43,20,6,2,6,25,75
278,Wesley Matthews\matthwe02,SG,24,POR,82,69,2758,440,979,.449,154,378,.407,286,601,.476,.528,266,315,.844,48,210,258,164,102,9,138,195,1300
279,Jason Maxiell\maxieja01,PF,27,DET,57,14,930,93,189,.492,0,0,,93,189,.492,.492,51,99,.515,66,107,173,17,24,21,44,92,237
280,Eric Maynor\maynoer01,PG,23,OKC,82,0,1200,134,333,.402,37,96,.385,97,237,.409,.458,43,59,.729,25,96,121,238,35,6,77,96,348
281,O.J. Mayo\mayooj01,SG,23,MEM,71,17,1869,304,747,.407,96,264,.364,208,483,.431,.471,99,131,.756,35,135,170,145,73,26,99,127,803
282,Luc Mbah a Moute\mbahalu01,PF,24,MIL,79,52,2093,198,428,.463,0,7,.000,198,421,.470,.463,133,188,.707,169,251,420,68,72,28,77,180,529
283,Antonio McDyess\mcdyean01,PF,36,SAS,73,16,1387,169,344,.491,0,1,.000,169,343,.493,.491,52,77,.675,122,273,395,84,36,39,72,163,390
284,JaVale McGee\mcgeeja01,C,23,WAS,79,75,2193,332,604,.550,0,3,.000,332,601,.552,.550,134,230,.583,223,411,634,38,41,193,102,232,798
285,Tracy McGrady*\mcgratr01,SG,31,DET,72,39,1686,227,514,.442,30,88,.341,197,426,.462,.471,90,129,.698,49,202,251,252,66,34,102,101,574
286,Dominic McGuire\mcguido01,SF,25,CHA,52,8,760,72,182,.396,0,2,.000,72,180,.400,.396,30,39,.769,63,136,199,43,10,33,25,94,174
287,Josh McRoberts\mcrobjo01,PF,23,IND,72,51,1597,211,386,.547,23,60,.383,188,326,.577,.576,88,119,.739,109,273,382,150,47,57,93,165,533
288,Jodie Meeks\meeksjo01,SG,23,PHI,74,64,2062,242,570,.425,138,348,.397,104,222,.468,.546,152,170,.894,21,150,171,78,63,4,60,97,774
289,Pops Mensah-Bonsu\mensapo01,PF,27,NOH,7,0,35,1,3,.333,0,0,,1,3,.333,.333,0,0,,3,8,11,2,0,0,2,11,2
290,C.J. Miles\milescj01,SF,23,UTA,78,19,1969,366,899,.407,109,339,.322,257,560,.459,.468,159,196,.811,54,201,255,135,74,38,93,221,1000
291,Darko Miličić\milicda01,C,25,MIN,69,69,1686,271,578,.469,0,0,,271,578,.469,.469,64,115,.557,133,227,360,104,54,140,151,229,606
292,Andre Miller\millean02,PG,34,POR,81,81,2650,388,844,.460,4,37,.108,384,807,.476,.462,249,292,.853,97,205,302,566,114,12,197,171,1029
293,Brad Miller\millebr01,C,34,HOU,60,5,1015,132,296,.446,40,107,.374,92,189,.487,.514,78,94,.830,44,178,222,145,28,21,54,98,382
294,Mike Miller\millemi01,SG,30,MIA,41,2,838,81,202,.401,43,118,.364,38,84,.452,.507,23,34,.676,38,146,184,51,20,2,41,88,228
295,Patty Mills\millspa02,PG,22,POR,64,0,783,135,328,.412,47,133,.353,88,195,.451,.483,36,47,.766,19,32,51,109,27,1,62,63,353
296,Paul Millsap\millspa01,PF,25,UTA,76,76,2605,525,988,.531,9,23,.391,516,965,.535,.536,256,338,.757,164,415,579,187,103,69,145,272,1315
297,Yao Ming*\mingya01,C,30,HOU,5,5,91,18,37,.486,0,0,,18,37,.486,.486,15,16,.938,7,20,27,4,0,8,7,13,51
298,Nazr Mohammed\mohamna01,C,33,TOT,75,37,1280,234,448,.522,0,1,.000,234,447,.523,.522,67,112,.598,140,228,368,23,30,56,70,184,535
298,Nazr Mohammed\mohamna01,C,33,CHA,51,30,851,159,317,.502,0,1,.000,159,316,.503,.502,52,88,.591,94,158,252,17,14,46,51,121,370
298,Nazr Mohammed\mohamna01,C,33,OKC,24,7,429,75,131,.573,0,0,,75,131,.573,.573,15,24,.625,46,70,116,6,16,10,19,63,165
299,Greg Monroe\monrogr01,C,20,DET,80,48,2222,303,550,.551,0,1,.000,303,549,.552,.551,145,233,.622,248,353,601,105,93,45,81,196,751
300,Jamario Moon\moonja01,SF,30,TOT,59,20,1042,101,248,.407,38,123,.309,63,125,.504,.484,15,17,.882,23,142,165,52,28,33,22,65,255
300,Jamario Moon\moonja01,SF,30,CLE,40,13,764,76,189,.402,27,95,.284,49,94,.521,.474,10,11,.909,14,104,118,45,25,27,17,39,189
300,Jamario Moon\moonja01,SF,30,LAC,19,7,278,25,59,.424,11,28,.393,14,31,.452,.517,5,6,.833,9,38,47,7,3,6,5,26,66
301,Anthony Morrow\morroan01,SG,25,NJN,58,47,1856,279,620,.450,110,260,.423,169,360,.469,.539,96,107,.897,37,135,172,68,19,7,54,135,764
302,Timofey Mozgov\mozgoti01,C,24,TOT,45,14,524,63,133,.474,0,0,,63,133,.474,.474,37,52,.712,46,75,121,15,15,25,35,84,163
302,Timofey Mozgov\mozgoti01,C,24,NYK,34,14,458,52,112,.464,0,0,,52,112,.464,.464,31,44,.705,41,63,104,15,14,23,32,76,135
302,Timofey Mozgov\mozgoti01,C,24,DEN,11,0,66,11,21,.524,0,0,,11,21,.524,.524,6,8,.750,5,12,17,0,1,2,3,8,28
303,Byron Mullens\mulleby01,PF,21,OKC,13,0,85,9,28,.321,0,0,,9,28,.321,.321,7,14,.500,6,18,24,0,2,3,8,11,25
304,Troy Murphy\murphtr01,PF,30,TOT,35,4,466,42,114,.368,5,33,.152,37,81,.457,.390,20,30,.667,22,91,113,23,15,3,20,47,109
304,Troy Murphy\murphtr01,PF,30,NJN,18,4,288,26,76,.342,4,23,.174,22,53,.415,.368,9,17,.529,11,64,75,17,7,2,13,28,65
304,Troy Murphy\murphtr01,PF,30,BOS,17,0,178,16,38,.421,1,10,.100,15,28,.536,.434,11,13,.846,11,27,38,6,8,1,7,19,44
305,Hamady N'Diaye\ndiayha01,C,24,WAS,16,0,80,4,5,.800,0,0,,4,5,.800,.800,6,12,.500,2,5,7,0,2,5,3,18,14
306,Eduardo Nájera\najered01,PF,34,CHA,31,0,372,26,72,.361,11,34,.324,15,38,.395,.438,6,11,.545,14,30,44,20,11,6,13,52,69
307,Steve Nash*\nashst01,PG,36,PHO,75,75,2497,399,811,.492,81,205,.395,318,606,.525,.542,227,249,.912,40,220,260,855,48,4,265,87,1106
308,Gary Neal\nealga01,SG,26,SAS,80,1,1685,285,632,.451,129,308,.419,156,324,.481,.553,84,104,.808,21,175,196,96,27,4,78,148,783
309,Jameer Nelson\nelsoja01,PG,28,ORL,76,76,2319,374,838,.446,119,297,.401,255,541,.471,.517,130,162,.802,37,189,226,456,75,3,194,209,997
310,Joakim Noah\noahjo01,C,25,CHI,48,48,1576,211,402,.525,0,1,.000,211,401,.526,.525,139,188,.739,182,316,498,107,48,72,90,156,561
311,Andrés Nocioni\nocioan01,SF,31,PHI,54,17,931,118,277,.426,42,118,.356,76,159,.478,.502,49,61,.803,19,150,169,45,14,15,47,100,327
312,Steve Novak\novakst01,SF,27,TOT,30,0,215,35,67,.522,26,46,.565,9,21,.429,.716,8,8,1.000,4,24,28,3,1,5,4,14,104
312,Steve Novak\novakst01,SF,27,DAL,7,0,18,4,8,.500,3,4,.750,1,4,.250,.688,0,0,,0,5,5,0,0,0,0,3,11
312,Steve Novak\novakst01,SF,27,SAS,23,0,197,31,59,.525,23,42,.548,8,17,.471,.720,8,8,1.000,4,19,23,3,1,5,4,11,93
313,Dirk Nowitzki\nowitdi01,PF,32,DAL,73,73,2504,610,1179,.517,66,168,.393,544,1011,.538,.545,395,443,.892,50,463,513,190,38,47,137,172,1681
314,Jermaine O'Neal\onealje01,C,32,BOS,24,10,431,50,109,.459,0,1,.000,50,108,.463,.459,29,43,.674,25,63,88,12,2,30,27,65,129
315,Shaquille O'Neal*\onealsh01,C,38,BOS,37,36,752,134,201,.667,0,0,,134,201,.667,.667,73,131,.557,48,130,178,26,16,42,56,120,341
316,Fabricio Oberto\obertfa01,C,35,POR,5,0,45,3,5,.600,0,0,,3,5,.600,.600,1,2,.500,3,4,7,0,0,0,3,10,7
317,Lamar Odom\odomla01,PF,31,LAL,82,35,2639,473,893,.530,68,178,.382,405,715,.566,.568,166,246,.675,175,535,710,249,47,61,139,200,1180
318,Emeka Okafor\okafoem01,C,28,NOH,72,72,2287,300,524,.573,0,1,.000,300,523,.574,.573,145,258,.562,230,454,684,42,40,127,119,230,745
319,Mehmet Okur\okurme01,C,31,UTA,13,0,168,22,62,.355,5,16,.313,17,46,.370,.395,15,20,.750,9,21,30,19,4,4,7,18,64
320,Travis Outlaw\outlatr01,SF,26,NJN,82,55,2358,274,731,.375,76,252,.302,198,479,.413,.427,132,171,.772,54,271,325,84,34,36,71,148,756
321,Larry Owens\owensla01,SF,28,TOT,12,0,143,15,32,.469,6,13,.462,9,19,.474,.563,4,9,.444,1,14,15,8,9,5,5,18,40
321,Larry Owens\owensla01,SF,28,SAS,7,0,31,3,6,.500,1,3,.333,2,3,.667,.583,2,4,.500,0,4,4,1,2,0,0,4,9
321,Larry Owens\owensla01,SF,28,WAS,5,0,112,12,26,.462,5,10,.500,7,16,.438,.558,2,5,.400,1,10,11,7,7,5,5,14,31
322,Zaza Pachulia\pachuza01,C,26,ATL,79,7,1244,107,232,.461,0,0,,107,232,.461,.461,135,179,.754,119,214,333,58,34,22,69,184,349
323,Anthony Parker\parkean01,SF,35,CLE,72,65,2091,220,552,.399,86,227,.379,134,325,.412,.476,74,95,.779,33,185,218,218,67,10,80,109,600
324,Tony Parker\parketo01,PG,28,SAS,78,78,2528,555,1069,.519,25,70,.357,530,999,.531,.531,233,303,.769,30,208,238,513,90,3,200,135,1368
325,Patrick Patterson\pattepa01,PF,21,HOU,52,6,868,149,267,.558,0,2,.000,149,265,.562,.558,30,42,.714,86,114,200,41,17,37,31,77,328
326,Chris Paul\paulch01,PG,25,NOH,80,80,2880,430,928,.463,71,183,.388,359,745,.482,.502,337,384,.878,38,289,327,782,188,5,177,196,1268
327,Sasha Pavlović\pavloal01,SG-SF,27,TOT,31,7,362,29,72,.403,12,31,.387,17,41,.415,.486,6,10,.600,1,31,32,16,10,7,12,34,76
327,Sasha Pavlović\pavloal01,SF,27,DAL,10,6,163,15,35,.429,7,16,.438,8,19,.421,.529,4,5,.800,0,12,12,7,5,3,5,15,41
327,Sasha Pavlović\pavloal01,SG,27,NOH,4,1,50,2,11,.182,0,5,.000,2,6,.333,.182,0,0,,0,6,6,6,0,4,1,4,4
327,Sasha Pavlović\pavloal01,SG,27,BOS,17,0,149,12,26,.462,5,10,.500,7,16,.438,.558,2,5,.400,1,13,14,3,5,0,6,15,31
328,Nikola Peković\pekovni01,C,25,MIN,65,11,887,136,263,.517,0,0,,136,263,.517,.517,87,114,.763,90,103,193,27,18,35,91,181,359
329,Kendrick Perkins\perkike01,C,26,TOT,29,24,742,67,130,.515,0,0,,67,130,.515,.515,40,72,.556,62,170,232,26,9,26,56,91,174
329,Kendrick Perkins\perkike01,C,26,BOS,12,7,313,32,59,.542,0,0,,32,59,.542,.542,23,40,.575,23,74,97,10,2,10,25,37,87
329,Kendrick Perkins\perkike01,C,26,OKC,17,17,429,35,71,.493,0,0,,35,71,.493,.493,17,32,.531,39,96,135,16,7,16,31,54,87
330,Morris Peterson\petermo01,SG,33,OKC,4,0,23,2,5,.400,0,1,.000,2,4,.500,.400,0,0,,0,3,3,1,0,0,0,5,4
331,Johan Petro\petrojo01,C,25,NJN,77,1,893,129,290,.445,0,4,.000,129,286,.451,.445,15,28,.536,62,150,212,44,34,34,46,178,273
332,Paul Pierce*\piercpa01,SF,33,BOS,80,80,2774,507,1021,.497,111,297,.374,396,724,.547,.551,386,449,.860,34,396,430,260,80,51,171,231,1511
333,Mickaël Piétrus\pietrmi01,SG-SF,28,TOT,57,4,1107,143,365,.392,85,236,.360,58,129,.450,.508,39,57,.684,15,111,126,33,29,21,39,101,410
333,Mickaël Piétrus\pietrmi01,SF,28,ORL,19,0,418,45,115,.391,34,87,.391,11,28,.393,.539,3,6,.500,6,44,50,10,10,3,14,35,127
333,Mickaël Piétrus\pietrmi01,SG,28,PHO,38,4,689,98,250,.392,51,149,.342,47,101,.465,.494,36,51,.706,9,67,76,23,19,18,25,66,283
334,Dexter Pittman\pittmde01,C,22,MIA,2,0,11,1,3,.333,0,0,,1,3,.333,.333,0,0,,1,2,3,0,0,0,2,2,2
335,Quincy Pondexter\pondequ01,SF,22,NOH,66,6,734,73,180,.406,18,50,.360,55,130,.423,.456,24,34,.706,23,65,88,28,17,10,16,63,188
336,James Posey\poseyja01,SF,34,IND,49,0,839,81,241,.336,67,212,.316,14,29,.483,.475,11,15,.733,10,137,147,34,24,6,24,103,240
337,Leon Powe\powele01,C-PF,27,TOT,30,3,328,59,119,.496,0,2,.000,59,117,.504,.496,40,72,.556,24,39,63,7,10,4,12,44,158
337,Leon Powe\powele01,PF,27,CLE,14,3,187,29,59,.492,0,0,,29,59,.492,.492,12,26,.462,16,22,38,2,7,3,5,20,70
337,Leon Powe\powele01,C,27,MEM,16,0,141,30,60,.500,0,2,.000,30,58,.517,.500,28,46,.609,8,17,25,5,3,1,7,24,88
338,Josh Powell\poweljo01,PF,28,ATL,54,0,653,94,208,.452,0,1,.000,94,207,.454,.452,36,45,.800,49,86,135,22,5,5,53,78,224
339,A.J. Price\priceaj01,PG,24,IND,50,0,795,114,320,.356,41,149,.275,73,171,.427,.420,54,81,.667,16,56,72,111,29,1,53,61,323
340,Ronnie Price\pricero01,SG,27,UTA,59,0,717,74,210,.352,20,69,.290,54,141,.383,.400,29,39,.744,22,39,61,56,42,5,55,106,197
341,Tayshaun Prince\princta01,SF,30,DET,78,78,2562,473,1001,.473,34,98,.347,439,903,.486,.490,118,168,.702,78,251,329,215,30,41,82,90,1098
342,Joel Przybilla\przybjo01,C,31,TOT,36,9,519,25,44,.568,0,0,,25,44,.568,.568,14,27,.519,37,108,145,13,5,15,29,79,64
342,Joel Przybilla\przybjo01,C,31,POR,31,9,445,21,34,.618,0,0,,21,34,.618,.618,13,23,.565,28,93,121,13,5,14,22,63,55
342,Joel Przybilla\przybjo01,C,31,CHA,5,0,74,4,10,.400,0,0,,4,10,.400,.400,1,4,.250,9,15,24,0,0,1,7,16,9
343,Chris Quinn\quinnch01,PG,27,SAS,41,0,292,33,91,.363,11,37,.297,22,54,.407,.423,4,8,.500,3,22,25,42,5,1,12,29,81
344,Vladimir Radmanović\radmavl01,PF,30,GSW,74,6,1169,137,318,.431,70,173,.405,67,145,.462,.541,30,34,.882,64,148,212,79,44,44,57,157,374
345,Anthony Randolph\randoan01,C-PF,21,TOT,40,3,590,123,264,.466,1,4,.250,122,260,.469,.468,58,86,.674,43,117,160,33,22,24,53,62,305
345,Anthony Randolph\randoan01,PF,21,NYK,17,0,127,14,45,.311,1,4,.250,13,41,.317,.322,6,12,.500,11,29,40,7,4,8,10,15,35
345,Anthony Randolph\randoan01,C,21,MIN,23,3,463,109,219,.498,0,0,,109,219,.498,.498,52,74,.703,32,88,120,26,18,16,43,47,270
346,Zach Randolph\randoza01,PF,29,MEM,75,74,2724,598,1188,.503,8,43,.186,590,1145,.515,.507,300,396,.758,326,588,914,163,63,25,151,175,1504
347,Theo Ratliff\ratlith01,C,37,LAL,10,0,71,1,6,.167,0,0,,1,6,.167,.167,0,2,.000,6,7,13,3,2,5,3,7,2
348,Andy Rautins\rautian01,SG,24,NYK,5,0,24,3,7,.429,1,4,.250,2,3,.667,.500,1,2,.500,0,1,1,3,1,0,7,0,8
349,Michael Redd\reddmi01,SG,31,MIL,10,0,134,18,45,.400,4,17,.235,14,28,.500,.444,4,4,1.000,0,8,8,12,2,1,4,4,44
350,J.J. Redick\redicjj01,SG,26,ORL,59,5,1513,197,447,.441,87,219,.397,110,228,.482,.538,112,128,.875,6,107,113,102,29,3,53,80,593
351,Jason Richardson\richaja01,SG,30,TOT,80,80,2715,472,1056,.447,189,479,.395,283,577,.490,.536,116,159,.730,67,264,331,147,93,13,95,162,1249
351,Jason Richardson\richaja01,SG,30,PHO,25,25,796,183,389,.470,62,148,.419,121,241,.502,.550,55,72,.764,33,78,111,36,27,3,30,46,483
351,Jason Richardson\richaja01,SG,30,ORL,55,55,1919,289,667,.433,127,331,.384,162,336,.482,.528,61,87,.701,34,186,220,111,66,10,65,116,766
352,Quentin Richardson\richaqu01,SF,30,ORL,57,19,955,87,255,.341,42,146,.288,45,109,.413,.424,33,44,.750,39,139,178,38,25,5,33,74,249
353,Luke Ridnour\ridnolu01,PG,29,MIN,71,66,2159,319,681,.468,81,184,.440,238,497,.479,.528,121,137,.883,37,162,199,384,89,10,158,146,840
354,Nate Robinson\robinna01,PG,26,TOT,59,11,1013,150,376,.399,65,200,.325,85,176,.483,.485,36,44,.818,15,75,90,111,29,4,68,115,401
354,Nate Robinson\robinna01,PG,26,BOS,55,11,983,146,361,.404,63,192,.328,83,169,.491,.492,33,40,.825,15,74,89,105,29,4,66,107,388
354,Nate Robinson\robinna01,PG,26,OKC,4,0,30,4,15,.267,2,8,.250,2,7,.286,.333,3,4,.750,0,1,1,6,0,0,2,8,13
355,Rajon Rondo\rondora01,PG,24,BOS,68,68,2527,318,670,.475,10,43,.233,308,627,.491,.482,75,132,.568,87,210,297,760,153,11,234,120,721
356,Derrick Rose\rosede01,PG,22,CHI,81,81,3026,711,1597,.445,128,385,.332,583,1212,.481,.485,476,555,.858,81,249,330,623,85,51,278,136,2026
357,Quinton Ross\rossqu01,SF,29,NJN,36,4,353,26,59,.441,0,3,.000,26,56,.464,.441,5,14,.357,10,20,30,10,3,6,7,40,57
358,Brandon Roy\roybr01,SG,26,POR,47,23,1310,209,523,.400,38,114,.333,171,409,.418,.436,117,138,.848,28,93,121,129,37,12,55,76,573
359,Brandon Rush\rushbr01,SG,25,IND,67,21,1754,217,515,.421,93,223,.417,124,292,.425,.512,80,106,.755,33,184,217,62,41,35,69,107,607
360,John Salmons\salmojo01,SG,31,MIL,73,70,2554,373,898,.415,83,219,.379,290,679,.427,.462,195,240,.813,27,239,266,252,72,28,137,157,1024
361,Samardo Samuels\samuesa01,PF,22,CLE,37,10,701,110,241,.456,0,3,.000,110,238,.462,.456,68,110,.618,75,83,158,17,15,18,53,88,288
362,Larry Sanders\sandela01,C,22,MIL,60,12,872,116,268,.433,0,0,,116,268,.433,.433,28,50,.560,59,119,178,16,22,72,38,117,260
363,Brian Scalabrine\scalabr01,PF,32,CHI,18,0,88,10,19,.526,0,5,.000,10,14,.714,.526,0,0,,1,7,8,6,3,4,5,18,20
364,Luis Scola\scolalu01,PF,30,HOU,74,74,2412,569,1129,.504,0,3,.000,569,1126,.505,.504,214,290,.738,147,459,606,185,48,44,147,227,1352
365,Thabo Sefolosha\sefolth01,SG,26,OKC,79,79,2049,157,333,.471,28,102,.275,129,231,.558,.514,59,79,.747,65,281,346,111,97,38,55,171,401
366,Kevin Séraphin\serapke01,PF,21,WAS,58,1,635,66,147,.449,0,0,,66,147,.449,.449,22,31,.710,80,72,152,10,17,28,42,126,154
367,Ramon Sessions\sessira01,PG,24,CLE,81,38,2133,362,776,.466,3,15,.200,359,761,.472,.468,348,423,.823,46,209,255,419,60,8,178,93,1075
368,Mustafa Shakur\shakumu01,PG,26,WAS,22,0,159,21,59,.356,1,10,.100,20,49,.408,.364,8,15,.533,7,15,22,25,5,3,18,15,51
369,Garret Siler\silerga01,C,24,PHO,21,0,101,17,31,.548,0,0,,17,31,.548,.548,11,22,.500,16,12,28,3,1,4,10,20,45
370,Bobby Simmons\simmobo01,SF,30,SAS,2,0,16,0,3,.000,0,3,.000,0,0,,.000,0,0,,0,0,0,2,0,0,0,2,0
371,Brian Skinner\skinnbr01,C,34,MIL,2,0,6,0,0,,0,0,,0,0,,,0,0,,0,0,0,0,0,0,0,0,0
372,Craig Smith\smithcr01,PF,27,LAC,48,0,586,104,188,.553,0,5,.000,104,183,.568,.553,50,68,.735,43,74,117,31,16,7,33,84,258
373,Ish Smith\smithis01,PG,22,TOT,43,3,442,43,115,.374,3,10,.300,40,105,.381,.387,12,21,.571,7,40,47,79,18,2,34,37,101
373,Ish Smith\smithis01,PG,22,HOU,28,3,329,32,83,.386,3,8,.375,29,75,.387,.404,7,10,.700,6,36,42,64,13,2,26,26,74
373,Ish Smith\smithis01,PG,22,MEM,15,0,113,11,32,.344,0,2,.000,11,30,.367,.344,5,11,.455,1,4,5,15,5,0,8,11,27
374,J.R. Smith\smithjr01,SF,25,DEN,79,6,1968,341,784,.435,124,318,.390,217,466,.466,.514,163,221,.738,45,277,322,175,92,16,100,173,969
375,Jason Smith\smithja02,C,24,NOH,77,6,1102,136,307,.443,0,2,.000,136,305,.446,.443,59,70,.843,89,152,241,36,26,32,53,150,331
376,Joe Smith\smithjo02,PF,35,TOT,16,3,69,3,16,.188,0,0,,3,16,.188,.188,2,2,1.000,3,18,21,4,0,4,5,13,8
376,Joe Smith\smithjo02,PF,35,NJN,4,3,25,1,4,.250,0,0,,1,4,.250,.250,0,0,,1,2,3,1,0,0,2,3,2
376,Joe Smith\smithjo02,PF,35,LAL,12,0,44,2,12,.167,0,0,,2,12,.167,.167,2,2,1.000,2,16,18,3,0,4,3,10,6
377,Josh Smith\smithjo03,PF,25,ATL,77,77,2645,497,1041,.477,51,154,.331,446,887,.503,.502,229,316,.725,134,523,657,255,99,120,197,217,1274
378,Darius Songaila\songada01,C,32,PHI,10,0,71,7,15,.467,0,0,,7,15,.467,.467,2,4,.500,2,8,10,2,0,0,4,16,16
379,Marreese Speights\speigma01,C,23,PHI,64,1,734,144,291,.495,1,4,.250,143,287,.498,.497,55,73,.753,64,146,210,30,8,19,40,120,344
380,Tiago Splitter\splitti01,C,26,SAS,60,6,738,101,191,.529,0,1,.000,101,190,.532,.529,76,140,.543,72,129,201,26,29,17,32,91,278
381,Jerry Stackhouse\stackje01,SG,36,MIA,7,1,50,3,12,.250,1,4,.250,2,8,.250,.292,5,7,.714,1,6,7,3,0,2,2,3,12
382,Lance Stephenson\stephla01,SG,20,IND,12,0,115,13,39,.333,0,5,.000,13,34,.382,.333,11,14,.786,1,17,18,21,4,0,16,14,37
383,DeShawn Stevenson\stevede01,SG,29,DAL,72,54,1158,128,330,.388,94,249,.378,34,81,.420,.530,33,43,.767,20,86,106,77,21,5,44,71,383
384,Peja Stojaković\stojape01,SF,33,TOT,33,13,617,100,227,.441,57,136,.419,43,91,.473,.566,23,25,.920,14,61,75,29,13,2,17,24,280
384,Peja Stojaković\stojape01,SF,33,NOH,6,0,89,14,33,.424,11,25,.440,3,8,.375,.591,6,7,.857,0,6,6,6,2,0,4,2,45
384,Peja Stojaković\stojape01,SF,33,TOR,2,0,22,7,10,.700,4,6,.667,3,4,.750,.900,2,2,1.000,0,3,3,1,0,0,2,0,20
384,Peja Stojaković\stojape01,SF,33,DAL,25,13,506,79,184,.429,42,105,.400,37,79,.468,.543,15,16,.938,14,52,66,22,11,2,11,22,215
385,Amar'e Stoudemire\stoudam01,C,28,NYK,78,78,2870,744,1482,.502,10,23,.435,734,1459,.503,.505,473,597,.792,198,438,636,202,71,150,250,274,1971
386,Rodney Stuckey\stuckro01,PG,24,DET,70,54,2183,363,827,.439,26,90,.289,337,737,.457,.455,330,381,.866,70,146,216,361,76,10,155,177,1082
387,DaJuan Summers\summeda01,SF,23,DET,22,1,199,28,69,.406,9,21,.429,19,48,.396,.471,9,20,.450,2,10,12,2,3,1,13,21,74
388,Pape Sy\sypa01,SF,22,ATL,3,0,21,2,6,.333,0,1,.000,2,5,.400,.333,3,3,1.000,2,1,3,2,1,0,3,1,7
389,Jermaine Taylor\tayloje02,SG,24,TOT,34,8,483,94,196,.480,14,45,.311,80,151,.530,.515,21,28,.750,26,36,62,32,14,5,46,39,223
389,Jermaine Taylor\tayloje02,SG,24,HOU,8,0,77,16,32,.500,2,5,.400,14,27,.519,.531,5,6,.833,1,8,9,2,2,2,6,4,39
389,Jermaine Taylor\tayloje02,SG,24,SAC,26,8,406,78,164,.476,12,40,.300,66,124,.532,.512,16,22,.727,25,28,53,30,12,3,40,35,184
390,Jeff Teague\teaguje01,PG,22,ATL,70,7,963,133,304,.438,18,48,.375,115,256,.449,.467,77,97,.794,11,91,102,138,45,25,64,82,361
391,Sebastian Telfair\telfase01,PG,25,MIN,37,8,711,97,241,.402,28,78,.359,69,163,.423,.461,44,60,.733,17,37,54,111,25,3,64,64,266
392,Garrett Temple\templga01,PG-SG,24,TOT,24,0,230,20,68,.294,10,37,.270,10,31,.323,.368,7,17,.412,1,22,23,32,11,6,23,24,57
392,Garrett Temple\templga01,SG,24,SAS,3,0,21,1,5,.200,0,1,.000,1,4,.250,.200,0,2,.000,1,1,2,2,1,1,1,2,2
392,Garrett Temple\templga01,SG,24,MIL,9,0,83,7,21,.333,3,10,.300,4,11,.364,.405,0,4,.000,0,6,6,6,1,1,2,8,17
392,Garrett Temple\templga01,PG,24,CHA,12,0,126,12,42,.286,7,26,.269,5,16,.313,.369,7,11,.636,0,15,15,24,9,4,20,14,38
393,Jason Terry\terryja01,SG,33,DAL,82,10,2564,492,1091,.451,127,351,.362,365,740,.493,.509,182,214,.850,24,129,153,334,93,13,167,140,1293
394,Hasheem Thabeet\thabeha01,C,23,TOT,47,0,373,17,40,.425,0,0,,17,40,.425,.425,19,35,.543,24,51,75,4,9,16,17,76,53
394,Hasheem Thabeet\thabeha01,C,23,MEM,45,0,369,17,39,.436,0,0,,17,39,.436,.436,19,35,.543,24,51,75,4,9,15,17,73,53
394,Hasheem Thabeet\thabeha01,C,23,HOU,2,0,4,0,1,.000,0,0,,0,1,.000,.000,0,0,,0,0,0,0,0,1,0,3,0
395,Etan Thomas\thomaet01,C,32,ATL,13,0,82,10,21,.476,0,0,,10,21,.476,.476,12,15,.800,6,17,23,2,1,4,5,11,32
396,Kurt Thomas\thomaku01,PF,38,CHI,52,37,1178,95,186,.511,1,1,1.000,94,185,.508,.513,20,32,.625,75,226,301,60,32,42,42,164,211
397,Tyrus Thomas\thomaty01,C,24,CHA,41,2,861,156,331,.471,0,3,.000,156,328,.476,.471,107,136,.787,65,159,224,29,30,66,65,113,419
398,Jason Thompson\thompja02,PF,24,SAC,75,39,1748,271,534,.507,0,3,.000,271,531,.510,.507,121,200,.605,144,310,454,88,28,44,99,212,663
399,Al Thornton\thornal01,SF-PF,27,TOT,71,23,1383,205,431,.476,4,26,.154,201,405,.496,.480,110,142,.775,56,157,213,62,35,12,64,143,524
399,Al Thornton\thornal01,SF,27,WAS,49,23,1069,154,327,.471,4,25,.160,150,302,.497,.477,81,107,.757,46,110,156,51,28,9,44,103,393
399,Al Thornton\thornal01,PF,27,GSW,22,0,314,51,104,.490,0,1,.000,51,103,.495,.490,29,35,.829,10,47,57,11,7,3,20,40,131
400,Marcus Thornton\thornma01,SG,23,TOT,73,23,1775,350,807,.434,88,240,.367,262,567,.462,.488,145,184,.788,61,197,258,135,64,9,93,110,933
400,Marcus Thornton\thornma01,SG,23,NOH,46,0,745,137,334,.410,35,93,.376,102,241,.423,.463,50,66,.758,25,106,131,43,19,4,37,50,359
400,Marcus Thornton\thornma01,SG,23,SAC,27,23,1030,213,473,.450,53,147,.361,160,326,.491,.506,95,118,.805,36,91,127,92,45,5,56,60,574
401,Anthony Tolliver\tollian01,SF,25,MIN,65,4,1362,141,313,.450,47,115,.409,94,198,.475,.526,105,131,.802,92,203,295,82,28,28,49,145,434
402,Ronny Turiaf\turiaro01,C,28,NYK,64,21,1141,103,163,.632,0,0,,103,163,.632,.632,61,98,.622,64,143,207,92,35,73,41,160,267
403,Hedo Türkoğlu\turkohe01,SF-PF,31,TOT,81,72,2540,322,722,.446,127,310,.410,195,412,.473,.534,106,156,.679,45,311,356,343,72,34,132,247,877
403,Hedo Türkoğlu\turkohe01,PF,31,PHO,25,16,630,85,193,.440,41,97,.423,44,96,.458,.547,26,36,.722,20,80,100,58,18,14,31,77,237
403,Hedo Türkoğlu\turkohe01,SF,31,ORL,56,56,1910,237,529,.448,86,213,.404,151,316,.478,.529,80,120,.667,25,231,256,285,54,20,101,170,640
404,Evan Turner\turneev01,SG,22,PHI,78,14,1797,225,529,.425,14,44,.318,211,485,.435,.439,101,125,.808,42,264,306,159,49,14,80,138,565
405,Ekpe Udoh\udohek01,C,23,GSW,58,18,1030,97,222,.437,0,0,,97,222,.437,.437,42,64,.656,80,101,181,40,22,86,48,144,236
406,Ime Udoka\udokaim01,SF,33,SAS,20,0,130,5,21,.238,0,8,.000,5,13,.385,.238,4,8,.500,5,14,19,13,8,1,5,14,14
407,Beno Udrih\udrihbe01,PG,28,SAC,79,64,2734,412,824,.500,65,182,.357,347,642,.540,.539,197,228,.864,41,224,265,386,94,9,141,181,1086
408,Ben Uzoh\uzohbe01,PG,22,NJN,42,0,438,61,144,.424,3,8,.375,58,136,.426,.434,33,56,.589,30,31,61,69,13,8,25,29,158
409,Anderson Varejão\varejan01,C,28,CLE,31,31,994,114,216,.528,0,2,.000,114,214,.533,.528,54,81,.667,98,203,301,45,27,38,40,87,282
410,Greivis Vásquez\vasqugr01,PG,24,MEM,70,1,860,95,233,.408,25,86,.291,70,147,.476,.461,34,44,.773,12,61,73,151,22,4,70,83,249
411,Charlie Villanueva\villach01,PF,26,DET,76,11,1666,313,708,.442,125,323,.387,188,385,.488,.530,89,116,.767,50,245,295,48,42,42,66,175,840
412,Sasha Vujačić\vujacsa01,SG,26,TOT,67,17,1648,239,595,.402,97,262,.370,142,333,.426,.483,81,96,.844,30,156,186,132,54,5,66,136,656
412,Sasha Vujačić\vujacsa01,SG,26,LAL,11,0,54,8,23,.348,3,7,.429,5,16,.313,.413,1,2,.500,1,3,4,5,1,0,5,7,20
412,Sasha Vujačić\vujacsa01,SG,26,NJN,56,17,1594,231,572,.404,94,255,.369,137,317,.432,.486,80,94,.851,29,153,182,127,53,5,61,129,636
413,Dwyane Wade\wadedw01,SG,29,MIA,76,76,2823,692,1384,.500,63,206,.306,629,1178,.534,.523,494,652,.758,123,362,485,346,111,87,237,197,1941
414,Von Wafer\wafervo01,SG,25,BOS,58,2,553,67,159,.421,18,67,.269,49,92,.533,.478,32,38,.842,7,42,49,35,18,5,20,39,184
415,Henry Walker\walkebi01,SG,23,NYK,61,1,784,104,236,.441,59,153,.386,45,83,.542,.566,31,44,.705,16,106,122,34,21,6,37,81,298
416,John Wall\walljo01,PG,20,WAS,69,64,2606,398,972,.409,34,115,.296,364,857,.425,.427,301,393,.766,35,282,317,574,121,35,261,175,1131
417,Ben Wallace*\wallabe01,C,36,DET,54,49,1238,67,149,.450,1,2,.500,66,147,.449,.453,19,57,.333,129,221,350,72,54,54,44,81,154
418,Gerald Wallace\wallage01,SF-PF,28,TOT,71,63,2693,386,851,.454,62,186,.333,324,665,.487,.490,279,374,.746,111,458,569,173,105,63,152,183,1113
418,Gerald Wallace\wallage01,SF,28,CHA,48,48,1872,252,582,.433,35,106,.330,217,476,.456,.463,210,284,.739,72,322,394,116,59,48,100,120,749
418,Gerald Wallace\wallage01,PF,28,POR,23,15,821,134,269,.498,27,80,.338,107,189,.566,.548,69,90,.767,39,136,175,57,46,15,52,63,364
419,Luke Walton\waltolu01,SF,30,LAL,54,0,484,38,116,.328,8,34,.235,30,82,.366,.362,7,10,.700,9,58,67,62,9,4,31,38,91
420,Willie Warren\warrewi01,PG,21,LAC,19,0,134,13,35,.371,5,15,.333,8,20,.400,.443,6,8,.750,1,11,12,27,6,0,8,16,37
421,Hakim Warrick\warriha01,PF,28,PHO,80,6,1416,228,446,.511,1,11,.091,227,435,.522,.512,212,294,.721,88,208,296,69,32,9,79,100,669
422,C.J. Watson\watsocj01,PG,26,CHI,82,1,1091,146,394,.371,44,112,.393,102,282,.362,.426,69,93,.742,16,78,94,186,55,11,73,82,405
423,Earl Watson\watsoea01,PG,31,UTA,80,13,1567,126,307,.410,36,107,.336,90,200,.450,.469,55,82,.671,52,130,182,278,61,17,116,146,343
424,Kyle Weaver\weaveky01,SG,24,UTA,5,0,69,9,25,.360,3,7,.429,6,18,.333,.420,7,8,.875,2,8,10,7,2,2,7,3,28
425,Martell Webster\webstma02,SF,24,MIN,46,1,1094,152,340,.447,55,132,.417,97,208,.466,.528,94,122,.770,36,111,147,53,28,9,58,101,453
426,Sonny Weems\weemsso01,SF,24,TOR,59,28,1413,228,513,.444,17,61,.279,211,452,.467,.461,72,94,.766,39,114,153,104,34,2,86,87,545
427,David West\westda01,PF,30,NOH,70,70,2451,528,1040,.508,2,9,.222,526,1031,.510,.509,264,327,.807,155,374,529,164,67,62,142,202,1322
428,Delonte West\westde01,PG,27,BOS,24,2,453,55,120,.458,12,33,.364,43,87,.494,.508,13,15,.867,6,31,37,64,20,10,30,29,135
429,Mario West\westma02,SG,26,NJN,6,3,116,9,21,.429,1,4,.250,8,17,.471,.452,3,5,.600,2,9,11,10,7,0,2,13,22
430,Russell Westbrook\westbru01,PG,22,OKC,82,82,2847,614,1390,.442,34,103,.330,580,1287,.451,.454,531,631,.842,121,258,379,670,155,30,316,207,1793
431,D.J. White\whitedj01,C-PF,24,TOT,47,0,685,111,219,.507,0,2,.000,111,217,.512,.507,46,64,.719,43,115,158,19,12,20,14,77,268
431,D.J. White\whitedj01,PF,24,OKC,23,0,219,30,65,.462,0,0,,30,65,.462,.462,5,10,.500,12,40,52,4,6,8,7,31,65
431,D.J. White\whitedj01,C,24,CHA,24,0,466,81,154,.526,0,2,.000,81,152,.533,.526,41,54,.759,31,75,106,15,6,12,7,46,203
432,Hassan Whiteside\whiteha01,C,21,SAC,1,0,2,0,0,,0,0,,0,0,,,0,0,,0,0,0,0,0,0,0,2,0
433,Chris Wilcox\wilcoch01,PF,28,DET,57,29,995,187,322,.581,0,1,.000,187,321,.583,.581,50,89,.562,95,176,271,43,29,17,43,145,424
434,Damien Wilkins\wilkida02,SF,31,ATL,52,0,676,69,137,.504,2,10,.200,67,127,.528,.511,40,56,.714,23,67,90,41,27,9,21,72,180
435,Deron Williams\willide01,PG,26,TOT,65,65,2465,428,975,.439,105,317,.331,323,658,.491,.493,348,412,.845,40,220,260,667,79,15,230,190,1309
435,Deron Williams\willide01,PG,26,UTA,53,53,2009,369,806,.458,89,258,.345,280,548,.511,.513,302,354,.853,32,173,205,514,64,12,187,152,1129
435,Deron Williams\willide01,PG,26,NJN,12,12,456,59,169,.349,16,59,.271,43,110,.391,.396,46,58,.793,8,47,55,153,15,3,43,38,180
436,Jason Williams\willija02,PG,35,TOT,27,0,295,22,67,.328,10,38,.263,12,29,.414,.403,0,0,,3,27,30,52,11,1,18,8,54
436,Jason Williams\willija02,PG,35,ORL,16,0,171,13,38,.342,7,23,.304,6,15,.400,.434,0,0,,3,19,22,24,8,0,11,6,33
436,Jason Williams\willija02,PG,35,MEM,11,0,124,9,29,.310,3,15,.200,6,14,.429,.362,0,0,,0,8,8,28,3,1,7,2,21
437,Jawad Williams\willija04,SF,27,CLE,26,1,391,41,126,.325,13,45,.289,28,81,.346,.377,9,12,.750,7,41,48,22,9,3,16,34,104
438,Lou Williams\willilo02,SG,24,PHI,75,0,1747,323,795,.406,88,253,.348,235,542,.434,.462,293,356,.823,32,117,149,252,47,17,102,128,1027
439,Marvin Williams\willima02,SF,24,ATL,65,52,1865,246,537,.458,37,110,.336,209,427,.489,.493,147,174,.845,68,245,313,88,34,23,62,104,676
440,Mo Williams\willima01,PG,28,TOT,58,56,1788,291,730,.399,79,244,.324,212,486,.436,.453,151,177,.853,21,132,153,380,53,10,171,150,812
440,Mo Williams\willima01,PG,28,CLE,36,34,1065,178,462,.385,36,136,.265,142,326,.436,.424,85,102,.833,15,82,97,257,33,10,105,91,477
440,Mo Williams\willima01,PG,28,LAC,22,22,723,113,268,.422,43,108,.398,70,160,.438,.502,66,75,.880,6,50,56,123,20,0,66,59,335
441,Reggie Williams\willire02,SF,24,GSW,80,9,1626,268,572,.469,102,241,.423,166,331,.502,.558,100,134,.746,45,171,216,121,28,3,57,124,738
442,Shawne Williams\willish03,PF,24,NYK,64,11,1323,164,385,.426,85,212,.401,79,173,.457,.536,41,49,.837,60,179,239,47,39,51,46,164,454
443,Shelden Williams\willish02,PF,27,TOT,59,38,911,103,220,.468,0,0,,103,220,.468,.468,58,75,.773,93,180,273,32,23,26,43,126,264
443,Shelden Williams\willish02,PF,27,DEN,42,32,713,82,181,.453,0,0,,82,181,.453,.453,34,46,.739,74,149,223,19,18,22,37,92,198
443,Shelden Williams\willish02,PF,27,NYK,17,6,198,21,39,.538,0,0,,21,39,.538,.538,24,29,.828,19,31,50,13,5,4,6,34,66
444,Terrence Williams\willite01,SG,23,TOT,21,0,290,43,115,.374,6,22,.273,37,93,.398,.400,14,21,.667,4,47,51,38,9,0,33,25,106
444,Terrence Williams\willite01,SG,23,NJN,10,0,206,29,73,.397,4,12,.333,25,61,.410,.425,5,10,.500,3,33,36,31,5,0,25,21,67
444,Terrence Williams\willite01,SG,23,HOU,11,0,84,14,42,.333,2,10,.200,12,32,.375,.357,9,11,.818,1,14,15,7,4,0,8,4,39
445,Metta World Peace\artesro01,SF,31,LAL,82,82,2410,261,658,.397,83,233,.356,178,425,.419,.460,92,136,.676,100,167,267,175,124,36,90,181,697
446,Antoine Wright\wrighan01,SG,26,SAC,7,0,31,1,8,.125,0,4,.000,1,4,.250,.125,0,0,,2,1,3,0,1,0,1,3,2
447,Brandan Wright\wrighbr03,PF,23,TOT,37,2,379,60,117,.513,0,0,,60,117,.513,.513,21,31,.677,31,58,89,12,11,17,14,34,141
447,Brandan Wright\wrighbr03,PF,23,GSW,21,1,195,38,63,.603,0,0,,38,63,.603,.603,7,14,.500,14,27,41,5,3,10,10,19,83
447,Brandan Wright\wrighbr03,PF,23,NJN,16,1,184,22,54,.407,0,0,,22,54,.407,.407,14,17,.824,17,31,48,7,8,7,4,15,58
448,Dorell Wright\wrighdo01,SF,25,GSW,82,82,3147,485,1146,.423,194,516,.376,291,630,.462,.508,180,228,.789,88,343,431,242,124,63,133,171,1344
449,Julian Wright\wrighju01,SF,23,TOR,52,6,766,82,160,.513,2,10,.200,80,150,.533,.519,22,43,.512,47,71,118,58,39,20,43,45,188
450,Nick Young\youngni01,SG,25,WAS,64,40,2034,412,935,.441,105,271,.387,307,664,.462,.497,186,228,.816,26,148,174,75,45,17,90,144,1115
451,Sam Young\youngsa01,SF,25,MEM,78,46,1577,233,494,.472,17,50,.340,216,444,.486,.489,89,116,.767,40,147,187,71,68,23,61,120,572
452,Thaddeus Young\youngth01,PF,22,PHI,82,1,2135,458,847,.541,6,22,.273,452,825,.548,.544,123,174,.707,153,281,434,82,90,26,99,170,1045