Rk,Player,Pos,Age,Tm,G,GS,MP,FG,FGA,FG%,3P,3PA,3P%,2P,2PA,2P%,eFG%,FT,FTA,FT%,ORB,DRB,TRB,AST,STL,BLK,TOV,PF,PTS
1,Jeff Adrien\adrieje01,PF,25,HOU,8,0,63,7,16,.438,0,0,,7,16,.438,.438,7,12,.583,5,17,22,1,0,2,2,13,21
2,Arron Afflalo\afflaar01,SG,26,DEN,62,62,2086,329,699,.471,88,221,.398,241,478,.504,.534,197,247,.798,40,157,197,149,36,13,85,134,943
3,Blake Ahearn\ahearbl01,PG,27,UTA,4,0,30,4,14,.286,2,9,.222,2,5,.400,.357,0,0,,0,2,2,1,0,0,5,4,10
4,Solomon Alabi\alabiso01,C,23,TOR,14,0,122,13,36,.361,0,0,,13,36,.361,.361,7,8,.875,15,32,47,3,2,9,5,11,33
5,Cole Aldrich\aldrico01,C,23,OKC,26,0,173,22,42,.524,0,0,,22,42,.524,.524,13,14,.929,13,35,48,3,8,16,9,22,57
6,LaMarcus Aldridge\aldrila01,PF,26,POR,55,55,1994,483,943,.512,2,11,.182,481,932,.516,.513,223,274,.814,150,292,442,134,51,45,111,153,1191
7,Lavoy Allen\allenla01,PF,22,PHI,41,15,624,79,167,.473,0,0,,79,167,.473,.473,11,14,.786,47,124,171,34,13,18,20,73,169
8,Ray Allen*\allenra02,SG,36,BOS,46,42,1565,226,493,.458,106,234,.453,120,259,.463,.566,97,106,.915,14,128,142,109,49,8,68,83,655
9,Tony Allen\allento01,SG,30,MEM,58,57,1525,210,448,.469,8,26,.308,202,422,.479,.478,140,175,.800,98,135,233,79,104,33,94,142,568
10,Morris Almond\almonmo01,SG,26,WAS,4,0,67,6,17,.353,1,3,.333,5,14,.357,.382,1,3,.333,1,7,8,2,7,0,1,6,14
11,Al-Farouq Aminu\aminual01,SF,21,NOH,66,21,1477,150,365,.411,13,47,.277,137,318,.431,.429,86,114,.754,95,213,308,66,59,34,91,136,399
12,Lou Amundson\amundlo01,PF,29,IND,60,0,753,89,207,.430,0,0,,89,207,.430,.430,35,82,.427,94,128,222,14,27,44,45,125,213
13,Chris Andersen\anderch01,C,33,DEN,32,1,486,59,108,.546,0,0,,59,108,.546,.546,50,82,.610,48,100,148,6,19,46,17,52,168
14,Alan Anderson\anderal01,SF,29,TOR,17,12,461,55,142,.387,24,61,.393,31,81,.383,.472,29,34,.853,8,26,34,26,5,3,25,35,163
15,James Anderson\anderja01,SG,22,SAS,51,2,603,66,174,.379,19,68,.279,47,106,.443,.434,39,52,.750,16,63,79,41,8,2,30,35,190
16,Ryan Anderson\anderry01,PF,23,ORL,61,61,1964,332,757,.439,166,422,.393,166,335,.496,.548,150,171,.877,224,247,471,54,50,26,57,146,980
17,Carmelo Anthony\anthoca01,SF,27,NYK,55,55,1876,441,1025,.430,68,203,.335,373,822,.454,.463,295,367,.804,88,256,344,200,62,24,144,156,1245
18,Joel Anthony\anthojo01,C,29,MIA,64,51,1349,85,152,.559,0,0,,85,152,.559,.559,49,71,.690,100,150,250,9,36,84,45,126,219
19,Gilbert Arenas\arenagi01,PG,30,MEM,17,0,211,26,64,.406,13,39,.333,13,25,.520,.508,7,10,.700,2,16,18,18,11,1,12,35,72
20,Trevor Ariza\arizatr01,SF,26,NOH,41,41,1350,168,403,.417,29,87,.333,139,316,.440,.453,79,102,.775,41,174,215,135,69,25,76,73,444
21,Ömer Aşık\asikom01,C,25,CHI,66,2,971,79,156,.506,0,0,,79,156,.506,.506,47,103,.456,127,223,350,32,30,68,68,121,205
22,D.J. Augustin\augusdj01,PG,24,CHA,48,46,1408,183,487,.376,61,179,.341,122,308,.396,.438,105,120,.875,24,85,109,307,36,1,110,65,532
23,Gustavo Ayón\ayongu01,PF,26,NOH,54,24,1088,140,261,.536,0,1,.000,140,260,.538,.536,39,63,.619,86,179,265,74,53,46,46,118,319
24,Jeff Ayres\pendeje02,C,24,IND,20,1,106,15,36,.417,0,0,,15,36,.417,.417,4,7,.571,12,21,33,4,3,2,2,16,34
25,Kelenna Azubuike\azubuke01,SG,28,DAL,3,0,18,3,8,.375,1,3,.333,2,5,.400,.438,0,0,,0,0,0,0,1,0,4,1,7
26,Luke Babbitt\babbilu01,SF,22,POR,40,4,537,71,173,.410,43,100,.430,28,73,.384,.535,17,20,.850,16,79,95,16,10,4,27,46,202
27,Renaldo Balkman\balkmre01,SF,27,NYK,14,0,115,16,32,.500,2,9,.222,14,23,.609,.531,8,11,.727,6,20,26,5,4,3,6,14,42
28,Leandro Barbosa\barbole01,SG,29,TOT,64,0,1382,271,637,.425,65,170,.382,206,467,.441,.476,101,124,.815,33,95,128,96,56,7,94,135,708
28,Leandro Barbosa\barbole01,SG,29,TOR,42,0,946,198,454,.436,40,111,.360,158,343,.461,.480,76,91,.835,21,58,79,63,36,7,68,101,512
28,Leandro Barbosa\barbole01,SG,29,IND,22,0,436,73,183,.399,25,59,.424,48,124,.387,.467,25,33,.758,12,37,49,33,20,0,26,34,196
29,J.J. Barea\bareajo01,PG,27,MIN,41,11,1032,167,418,.400,53,143,.371,114,275,.415,.463,76,98,.776,14,100,114,232,21,0,103,61,463
30,Andrea Bargnani\bargnan01,C,26,TOR,31,31,1032,209,484,.432,34,115,.296,175,369,.474,.467,151,173,.873,24,148,172,61,18,15,69,52,603
31,Matt Barnes\barnema02,SF,31,LAL,63,16,1440,175,387,.452,46,138,.333,129,249,.518,.512,95,128,.742,97,247,344,126,35,48,73,152,491
32,Earl Barron\barroea01,C,30,GSW,2,0,9,2,4,.500,0,0,,2,4,.500,.500,0,0,,1,0,1,0,0,0,0,5,4
33,Brandon Bass\bassbr01,PF,26,BOS,59,39,1868,303,632,.479,0,0,,303,632,.479,.479,132,163,.810,95,270,365,55,34,54,65,135,738
34,Tony Battie\battito01,C,35,PHI,27,11,295,19,51,.373,0,1,.000,19,50,.380,.373,4,4,1.000,8,59,67,16,4,6,4,26,42
35,Shane Battier\battish01,SF,33,MIA,65,10,1499,113,292,.387,62,183,.339,51,109,.468,.493,23,37,.622,56,100,156,82,64,33,37,105,311
36,Nicolas Batum\batumni01,SF,23,POR,59,34,1791,289,641,.451,107,274,.391,182,367,.496,.534,133,159,.836,81,190,271,84,57,60,90,105,818
37,Jerryd Bayless\bayleje01,PG,23,TOR,31,11,705,117,276,.424,44,104,.423,73,172,.424,.504,75,88,.852,8,58,66,118,24,4,53,70,353
38,Michael Beasley\beaslmi01,SF,23,MIN,47,7,1087,221,497,.445,38,101,.376,183,396,.462,.483,61,95,.642,39,168,207,45,18,19,80,83,541
39,Rodrigue Beaubois\beaubro01,PG,23,DAL,53,12,1151,188,445,.422,38,132,.288,150,313,.479,.465,58,69,.841,19,132,151,152,56,28,70,98,472
40,Marco Belinelli\belinma01,SG,25,NOH,66,55,1966,286,686,.417,107,284,.377,179,402,.445,.495,101,129,.783,19,153,172,101,48,5,69,115,780
41,Raja Bell\bellra01,SG,35,UTA,34,33,796,81,174,.466,34,87,.391,47,87,.540,.563,21,25,.840,6,43,49,38,13,2,21,78,217
42,Keith Benson\bensoke02,C,23,GSW,3,0,9,0,1,.000,0,0,,0,1,.000,.000,0,0,,2,1,3,0,0,0,0,0,0
43,Mike Bibby\bibbymi01,PG,33,NYK,39,4,557,35,124,.282,27,85,.318,8,39,.205,.391,6,8,.750,5,54,59,80,21,3,20,45,103
44,Andris Biedriņš\biedran01,C,25,GSW,47,35,739,39,64,.609,0,0,,39,64,.609,.609,1,9,.111,45,131,176,16,23,45,14,125,79
45,Chauncey Billups\billuch01,SG,35,LAC,20,20,607,83,228,.364,48,125,.384,35,103,.340,.469,85,95,.895,4,46,50,80,9,3,38,40,299
46,Bismack Biyombo\biyombi01,C,19,CHA,63,41,1455,129,278,.464,0,0,,129,278,.464,.464,69,143,.483,113,255,368,27,20,115,71,145,327
47,DeJuan Blair\blairde01,PF,22,SAS,64,62,1363,269,504,.534,0,1,.000,269,503,.535,.534,73,119,.613,154,197,351,78,59,12,92,168,611
48,Steve Blake\blakest01,PG,31,LAL,53,5,1237,101,268,.377,53,158,.335,48,110,.436,.476,21,27,.778,9,76,85,175,39,2,72,75,276
49,Andray Blatche\blatcan01,PF,25,WAS,26,13,626,93,245,.380,2,7,.286,91,238,.382,.384,33,49,.673,42,108,150,28,20,17,37,54,221
50,Eric Bledsoe\bledser01,PG,22,LAC,40,1,464,49,126,.389,6,30,.200,43,96,.448,.413,28,44,.636,22,43,65,66,31,14,47,58,132
51,Keith Bogans\boganke01,SF,31,NJN,5,1,94,8,21,.381,3,12,.250,5,9,.556,.452,2,5,.400,5,6,11,3,2,0,3,15,21
52,Andrew Bogut\bogutan01,C,27,MIL,12,12,364,61,136,.449,0,1,.000,61,135,.452,.449,14,23,.609,22,78,100,31,12,24,24,36,136
53,Matt Bonner\bonnema01,PF,31,SAS,65,2,1326,154,350,.440,105,250,.420,49,100,.490,.590,16,21,.762,29,185,214,61,15,21,14,68,429
54,Trevor Booker\booketr01,PF,24,WAS,50,32,1261,181,341,.531,1,2,.500,180,339,.531,.532,56,93,.602,119,206,325,40,48,43,58,138,419
55,Carlos Boozer\boozeca01,PF,30,CHI,66,66,1948,448,842,.532,0,1,.000,448,841,.533,.532,95,137,.693,114,450,564,125,63,24,115,168,991
56,Chris Bosh*\boshch01,PF,27,MIA,57,57,2007,393,807,.487,10,35,.286,383,772,.496,.493,229,279,.821,94,358,452,103,51,45,117,128,1025
57,Earl Boykins\boykiea01,PG,35,HOU,8,0,111,12,36,.333,2,9,.222,10,27,.370,.361,13,15,.867,0,11,11,17,1,0,7,5,39
58,Craig Brackins\brackcr01,PF,24,PHI,14,1,88,9,33,.273,3,9,.333,6,24,.250,.318,1,2,.500,5,10,15,8,0,1,4,6,22
59,Avery Bradley\bradlav01,PG,21,BOS,64,28,1368,200,402,.498,22,54,.407,178,348,.511,.525,62,78,.795,34,81,115,87,43,12,75,109,484
60,Elton Brand\brandel01,C,32,PHI,60,60,1732,287,581,.494,0,1,.000,287,580,.495,.494,85,116,.733,145,284,429,97,58,97,65,176,659
61,Corey Brewer\breweco01,SF,25,DEN,59,17,1287,201,463,.434,33,127,.260,168,336,.500,.470,90,130,.692,43,107,150,88,72,17,56,113,525
62,Ronnie Brewer\brewero02,SG,26,CHI,66,43,1635,190,445,.427,19,69,.275,171,376,.455,.448,56,100,.560,72,159,231,137,72,21,59,64,455
63,Jon Brockman\brockjo01,PF,24,MIL,35,0,239,15,45,.333,0,1,.000,15,44,.341,.333,7,15,.467,33,42,75,9,4,1,10,33,37
64,MarShon Brooks\brookma01,SG,23,NJN,56,47,1648,274,640,.428,47,150,.313,227,490,.463,.465,113,148,.764,70,130,200,131,52,15,118,116,708
65,Derrick Brown\brownde04,SF,24,CHA,65,17,1443,212,409,.518,6,24,.250,206,385,.535,.526,94,141,.667,95,141,236,67,48,12,55,96,524
66,Kwame Brown\brownkw01,C,29,GSW,9,3,187,21,40,.525,0,0,,21,40,.525,.525,15,34,.441,16,41,57,4,8,0,14,21,57
67,Shannon Brown\brownsh01,SG,26,PHO,59,19,1400,251,598,.420,68,188,.362,183,410,.446,.477,80,99,.808,38,119,157,69,44,15,64,66,650
68,Kobe Bryant*\bryanko01,SG,33,LAL,58,58,2232,574,1336,.430,87,287,.303,487,1049,.464,.462,381,451,.845,66,247,313,264,69,18,204,105,1616
69,Chase Budinger\budinch01,SF,23,HOU,58,9,1298,208,471,.442,88,219,.402,120,252,.476,.535,54,70,.771,38,179,217,74,29,7,55,65,558
70,Alec Burks\burksal01,SG,20,UTA,59,0,939,153,357,.429,15,45,.333,138,312,.442,.450,104,143,.727,57,75,132,55,27,5,51,84,425
71,Caron Butler\butleca01,SF,31,LAC,63,63,1871,287,705,.407,92,257,.358,195,448,.435,.472,87,107,.813,44,186,230,78,52,9,77,123,753
72,Jimmy Butler\butleji01,SG,22,CHI,42,0,359,32,79,.405,2,11,.182,30,68,.441,.418,43,56,.768,23,33,56,14,11,5,14,20,109
73,Rasual Butler\butlera01,SF,32,TOR,34,14,453,41,133,.308,21,77,.273,20,56,.357,.387,7,12,.583,6,60,66,19,7,5,15,39,110
74,Derrick Byars\byarsde01,PF,27,SAS,2,0,37,3,11,.273,0,6,.000,3,5,.600,.273,4,4,1.000,6,5,11,1,2,0,0,2,10
75,Andrew Bynum\bynuman01,C,24,LAL,60,60,2112,444,796,.558,1,5,.200,443,791,.560,.558,234,338,.692,192,517,709,85,27,116,152,104,1123
76,Will Bynum\bynumwi01,PG,29,DET,36,0,514,74,194,.381,7,29,.241,67,165,.406,.399,49,64,.766,10,46,56,66,23,3,54,61,204
77,José Calderón\caldejo01,PG,30,TOR,53,53,1799,218,477,.457,59,159,.371,159,318,.500,.519,60,68,.882,19,141,160,468,47,3,104,94,555
78,Marcus Camby\cambyma01,C,37,TOT,59,53,1352,128,287,.446,2,5,.400,126,282,.447,.449,29,64,.453,157,373,530,107,50,85,57,126,287
78,Marcus Camby\cambyma01,C,37,POR,40,40,894,67,161,.416,0,0,,67,161,.416,.416,18,38,.474,105,249,354,75,33,56,47,88,152
78,Marcus Camby\cambyma01,C,37,HOU,19,13,458,61,126,.484,2,5,.400,59,121,.488,.492,11,26,.423,52,124,176,32,17,29,10,38,135
79,Brian Cardinal\cardibr01,SF,34,DAL,44,0,277,14,55,.255,10,49,.204,4,6,.667,.345,5,6,.833,4,30,34,16,8,2,8,38,43
80,DeMarre Carroll\carrode01,SF-PF,25,TOT,24,9,348,43,105,.410,7,19,.368,36,86,.419,.443,14,16,.875,28,25,53,18,12,1,11,37,107
80,DeMarre Carroll\carrode01,PF,25,DEN,4,0,21,6,6,1.000,0,0,,6,6,1.000,1.000,0,0,,0,3,3,3,0,0,2,1,12
80,DeMarre Carroll\carrode01,SF,25,UTA,20,9,327,37,99,.374,7,19,.368,30,80,.375,.409,14,16,.875,28,22,50,15,12,1,9,36,95
81,Matt Carroll\carroma01,SG,31,CHA,53,2,596,52,157,.331,8,43,.186,44,114,.386,.357,30,38,.789,8,50,58,38,16,7,24,52,142
82,Anthony Carter\cartean01,PG,36,TOR,24,0,209,17,53,.321,5,17,.294,12,36,.333,.368,8,10,.800,5,28,33,34,8,4,17,20,47
83,Vince Carter\cartevi01,SG,35,DAL,61,40,1542,223,542,.411,74,205,.361,149,337,.442,.480,95,115,.826,32,173,205,139,56,25,84,134,615
84,Omri Casspi\casspom01,SF,23,CLE,65,35,1341,166,412,.403,53,168,.315,113,244,.463,.467,74,108,.685,63,165,228,66,37,21,64,115,459
85,Mario Chalmers\chalmma01,PG,25,MIA,64,64,1825,223,498,.448,101,260,.388,122,238,.513,.549,80,101,.792,16,155,171,222,97,11,142,166,627
86,Tyson Chandler\chandty01,C,29,NYK,62,62,2061,241,355,.679,0,2,.000,241,353,.683,.679,217,315,.689,212,400,612,56,56,89,102,186,699
87,Wilson Chandler\chandwi01,SF,24,DEN,8,6,215,31,79,.392,3,12,.250,28,67,.418,.411,10,12,.833,6,35,41,17,6,6,18,18,75
88,Josh Childress\childjo01,SF,28,PHO,34,0,491,48,99,.485,4,24,.167,44,75,.587,.505,0,2,.000,31,64,95,34,14,6,9,38,100
89,Earl Clark\clarkea01,PF,24,ORL,45,1,559,51,139,.367,0,0,,51,139,.367,.367,21,29,.724,35,89,124,18,12,32,25,72,123
90,Norris Cole\coleno01,PG,23,MIA,65,2,1260,177,450,.393,21,76,.276,156,374,.417,.417,66,85,.776,21,70,91,133,44,2,105,124,441
91,Jason Collins\collija04,C,33,ATL,30,10,308,16,40,.400,0,0,,16,40,.400,.400,7,15,.467,12,36,48,10,4,3,10,34,39
92,Darren Collison\collida01,PG,24,IND,60,56,1878,230,523,.440,34,94,.362,196,429,.457,.472,127,153,.830,30,157,187,287,49,14,114,101,621
93,Nick Collison\collini01,PF,31,OKC,63,0,1307,120,201,.597,0,1,.000,120,200,.600,.597,44,62,.710,119,155,274,82,33,28,61,153,284
94,Mike Conley\conlemi01,PG,24,MEM,62,61,2174,296,684,.433,60,159,.377,236,525,.450,.477,136,158,.861,22,134,156,404,136,11,125,133,788
95,Brian Cook\cookbr01,PF,31,TOT,32,0,276,31,98,.316,10,50,.200,21,48,.438,.367,9,10,.900,10,53,63,10,6,5,11,48,81
95,Brian Cook\cookbr01,PF,31,LAC,16,0,121,11,49,.224,5,27,.185,6,22,.273,.276,4,4,1.000,4,19,23,2,2,4,4,26,31
95,Brian Cook\cookbr01,PF,31,WAS,16,0,155,20,49,.408,5,23,.217,15,26,.577,.459,5,6,.833,6,34,40,8,4,1,7,22,50
96,Daequan Cook\cookda02,SG,24,OKC,57,22,989,109,296,.368,79,228,.346,30,68,.441,.502,14,22,.636,12,110,122,15,22,11,16,69,311
97,DeMarcus Cousins\couside01,C,21,SAC,64,62,1950,448,999,.448,2,14,.143,446,985,.453,.449,262,373,.702,265,438,703,102,93,75,170,257,1160
98,Jamal Crawford\crawfja01,PG,31,POR,60,6,1613,283,737,.384,80,260,.308,203,477,.426,.438,191,206,.927,16,102,118,191,55,14,111,74,837
99,Jordan Crawford\crawfjo02,SG,23,WAS,64,32,1753,349,872,.400,79,273,.289,270,599,.451,.446,161,203,.793,44,124,168,190,59,5,141,111,938
100,Dante Cunningham\cunnida01,PF,24,MEM,64,5,1124,144,279,.516,0,2,.000,144,277,.520,.516,45,69,.652,91,155,246,37,42,34,29,98,333
101,Eddy Curry\curryed01,C,29,MIA,14,1,83,12,26,.462,0,0,,12,26,.462,.462,6,8,.750,4,8,12,1,0,2,10,17,30
102,Stephen Curry\curryst01,PG,23,GSW,26,23,732,145,296,.490,55,121,.455,90,175,.514,.583,38,47,.809,15,73,88,138,39,8,65,62,383
103,Samuel Dalembert\dalemsa01,C,30,HOU,65,45,1446,200,395,.506,0,1,.000,200,394,.508,.506,90,113,.796,158,298,456,33,37,111,82,162,490
104,Erick Dampier\dampier01,C,36,ATL,15,0,83,1,8,.125,0,0,,1,8,.125,.125,0,0,,10,15,25,4,1,4,3,9,2
105,Marquis Daniels\daniema01,SG,31,BOS,38,0,484,52,143,.364,0,10,.000,52,133,.391,.364,17,23,.739,16,50,66,47,21,9,28,36,121
106,Baron Davis\davisba01,PG,32,NYK,29,14,595,68,184,.370,26,85,.306,42,99,.424,.440,16,24,.667,13,43,56,135,34,3,76,61,178
107,Ed Davis\davised01,PF,22,TOR,66,9,1534,172,335,.513,0,1,.000,172,334,.515,.513,71,106,.670,134,304,438,60,40,63,67,156,415
108,Glen Davis\davisgl01,PF,26,ORL,61,13,1427,225,534,.421,2,14,.143,223,520,.429,.423,114,167,.683,107,224,331,47,43,19,75,106,566
109,Josh Davis\davisjo02,PF,31,MEM,15,0,130,10,27,.370,4,13,.308,6,14,.429,.444,4,8,.500,16,11,27,6,7,1,3,19,28
110,Eric Dawson\dawsoer01,C,27,SAS,4,0,39,7,12,.583,0,0,,7,12,.583,.583,1,2,.500,5,5,10,0,1,2,3,6,15
111,Austin Daye\dayeau01,SF,23,DET,41,4,603,73,227,.322,13,62,.210,60,165,.364,.350,35,43,.814,14,77,91,33,22,21,40,62,194
112,Carlos Delfino\delfica01,SF,29,MIL,54,53,1537,182,453,.402,86,239,.360,96,214,.449,.497,38,48,.792,20,188,208,123,79,10,66,99,488
113,Luol Deng\denglu01,SF,26,CHI,54,54,2129,311,755,.412,79,215,.367,232,540,.430,.464,127,165,.770,77,273,350,157,56,36,96,81,828
114,Justin Dentmon\dentmju01,PG,26,TOT,6,0,91,10,28,.357,2,14,.143,8,14,.571,.393,4,6,.667,0,8,8,10,2,0,7,10,26
114,Justin Dentmon\dentmju01,PG,26,SAS,2,0,19,2,6,.333,0,4,.000,2,2,1.000,.333,0,0,,0,1,1,1,1,0,1,2,4
114,Justin Dentmon\dentmju01,PG,26,TOR,4,0,72,8,22,.364,2,10,.200,6,12,.500,.409,4,6,.667,0,7,7,9,1,0,6,8,22
115,DeMar DeRozan\derozde01,SG,22,TOR,63,63,2206,381,903,.422,24,92,.261,357,811,.440,.435,268,331,.810,40,171,211,128,48,17,123,162,1054
116,Boris Diaw\diawbo01,PF,29,TOT,57,35,1424,156,351,.444,31,99,.313,125,252,.496,.489,22,35,.629,70,210,280,205,34,25,112,125,365
116,Boris Diaw\diawbo01,PF,29,CHA,37,28,1018,116,283,.410,23,86,.267,93,197,.472,.451,17,27,.630,47,148,195,158,20,19,84,71,272
116,Boris Diaw\diawbo01,PF,29,SAS,20,7,406,40,68,.588,8,13,.615,32,55,.582,.647,5,8,.625,23,62,85,47,14,6,28,54,93
117,Ike Diogu\dioguik01,PF,28,SAS,2,0,14,0,2,.000,0,0,,0,2,.000,.000,2,2,1.000,0,1,1,0,0,0,1,1,2
118,DeSagana Diop\diopde01,C,30,CHA,27,9,325,15,42,.357,0,0,,15,42,.357,.357,1,6,.167,33,52,85,23,6,13,19,36,31
119,Keyon Dooling\doolike01,SG,31,BOS,46,2,662,66,163,.405,27,81,.333,39,82,.476,.488,23,31,.742,3,36,39,51,13,2,34,57,182
120,Toney Douglas\douglto01,PG,25,NYK,38,9,656,94,290,.324,27,117,.231,67,173,.387,.371,22,26,.846,16,56,72,77,29,1,56,55,237
121,Goran Dragić\dragigo01,PG,25,HOU,66,28,1752,277,600,.462,68,202,.337,209,398,.525,.518,153,190,.805,53,115,168,351,85,10,157,166,775
122,Jared Dudley\dudleja01,SG,26,PHO,65,60,2020,312,643,.485,80,209,.383,232,434,.535,.547,119,164,.726,95,206,301,112,49,19,72,107,823
123,Chris Duhon\duhonch01,PG,29,ORL,63,9,1226,85,203,.419,50,119,.420,35,84,.417,.542,17,21,.810,14,88,102,151,35,9,81,71,237
124,Tim Duncan*\duncati01,C,35,SAS,58,58,1634,361,733,.492,0,4,.000,361,729,.495,.492,173,249,.695,110,410,520,132,38,88,97,98,895
125,Mike Dunleavy\dunlemi02,SF,31,MIL,55,3,1445,239,504,.474,83,208,.399,156,296,.527,.557,116,143,.811,29,175,204,117,28,8,58,87,677
126,Kevin Durant\duranke01,SF,23,OKC,66,66,2546,643,1297,.496,133,344,.387,510,953,.535,.547,431,501,.860,40,487,527,231,88,77,248,133,1850
127,Jerome Dyson\dysonje01,PG,24,NOH,9,1,180,19,48,.396,1,8,.125,18,40,.450,.406,28,36,.778,2,17,19,18,11,2,20,19,67
128,Devin Ebanks\ebankde01,SG,22,LAL,24,12,396,37,89,.416,0,9,.000,37,80,.463,.416,23,35,.657,26,28,54,12,11,6,18,26,97
129,Wayne Ellington\ellinwa01,SG,24,MIN,51,4,973,122,302,.404,35,108,.324,87,194,.448,.462,32,40,.800,14,85,99,33,26,10,26,56,311
130,Monta Ellis\ellismo01,SG,26,TOT,58,58,2120,450,1040,.433,62,201,.308,388,839,.462,.463,219,275,.796,20,180,200,346,85,18,177,136,1181
130,Monta Ellis\ellismo01,SG,26,GSW,37,37,1365,305,704,.433,50,156,.321,255,548,.465,.469,151,186,.812,16,111,127,223,56,12,123,84,811
130,Monta Ellis\ellismo01,SG,26,MIL,21,21,755,145,336,.432,12,45,.267,133,291,.457,.449,68,89,.764,4,69,73,123,29,6,54,52,370
131,Francisco Elson\elsonfr01,C,35,PHI,5,0,16,1,3,.333,0,0,,1,3,.333,.333,0,0,,0,1,1,1,1,1,1,0,2
132,Andre Emmett\emmetan01,SF,29,NJN,6,0,45,4,7,.571,0,1,.000,4,6,.667,.571,5,8,.625,2,4,6,1,2,1,2,2,13
133,Semih Erden\erdense01,C,25,CLE,28,9,333,39,74,.527,0,0,,39,74,.527,.527,21,41,.512,20,52,72,9,10,5,16,60,99
134,Jeremy Evans\evansje01,SF,24,UTA,29,0,217,27,42,.643,0,1,.000,27,41,.659,.643,8,16,.500,19,31,50,13,6,24,5,23,62
135,Maurice Evans\evansma01,SF,33,WAS,24,0,343,45,112,.402,17,45,.378,28,67,.418,.478,10,13,.769,8,16,24,9,14,0,10,36,117
136,Reggie Evans\evansre01,PF,31,LAC,56,0,771,34,72,.472,0,0,,34,72,.472,.472,36,71,.507,100,171,271,17,31,6,44,118,104
137,Tyreke Evans\evansty01,SG,22,SAC,63,61,2162,408,900,.453,20,99,.202,388,801,.484,.464,201,258,.779,64,225,289,283,84,29,171,136,1037
138,Christian Eyenga\eyengch01,SF,22,TOT,7,0,102,6,25,.240,1,3,.333,5,22,.227,.260,4,8,.500,4,10,14,5,3,5,3,7,17
138,Christian Eyenga\eyengch01,SF,22,CLE,6,0,83,3,19,.158,1,2,.500,2,17,.118,.184,2,6,.333,3,9,12,4,3,4,2,7,9
138,Christian Eyenga\eyengch01,SF,22,LAL,1,0,19,3,6,.500,0,1,.000,3,5,.600,.500,2,2,1.000,1,1,2,1,0,1,1,0,8
139,Kenneth Faried\farieke01,PF,22,DEN,46,39,1037,181,309,.586,0,0,,181,309,.586,.586,109,164,.665,142,210,352,36,34,47,54,116,471
140,Jordan Farmar\farmajo01,PG,25,NJN,39,5,831,147,315,.467,55,125,.440,92,190,.484,.554,57,63,.905,7,54,61,129,24,2,68,49,406
141,Derrick Favors\favorde01,PF,20,UTA,65,9,1376,222,445,.499,0,0,,222,445,.499,.499,126,194,.649,158,267,425,43,38,65,103,145,570
142,Raymond Felton\feltora01,PG,27,POR,60,56,1906,261,642,.407,62,203,.305,199,439,.453,.455,100,124,.806,27,122,149,390,78,10,170,122,684
143,Rudy Fernández\fernaru01,SG,26,DEN,31,1,710,99,225,.440,40,122,.328,59,103,.573,.529,30,43,.698,9,56,65,75,31,3,40,37,268
144,Kyrylo Fesenko\fesenky01,C,25,IND,3,0,17,2,5,.400,0,0,,2,5,.400,.400,4,6,.667,2,7,9,1,2,0,0,2,8
145,Landry Fields\fieldla01,SG,23,NYK,66,62,1894,236,513,.460,31,121,.256,205,392,.523,.490,77,137,.562,59,219,278,169,79,17,102,99,580
146,Derek Fisher\fishede01,PG,37,TOT,63,43,1508,129,348,.371,35,109,.321,94,239,.393,.421,57,67,.851,12,109,121,170,51,4,73,117,350
146,Derek Fisher\fishede01,PG,37,LAL,43,43,1101,92,240,.383,24,74,.324,68,166,.410,.433,44,53,.830,10,82,92,142,40,3,58,85,252
146,Derek Fisher\fishede01,PG,37,OKC,20,0,407,37,108,.343,11,35,.314,26,73,.356,.394,13,14,.929,2,27,29,28,11,1,15,32,98
147,Jonny Flynn\flynnjo01,PG,22,TOT,29,1,416,46,131,.351,10,34,.294,36,97,.371,.389,29,39,.744,8,31,39,96,6,2,36,23,131
147,Jonny Flynn\flynnjo01,PG,22,HOU,11,0,135,12,41,.293,2,9,.222,10,32,.313,.317,11,14,.786,1,7,8,28,3,1,9,8,37
147,Jonny Flynn\flynnjo01,PG,22,POR,18,1,281,34,90,.378,8,25,.320,26,65,.400,.422,18,25,.720,7,24,31,68,3,1,27,15,94
148,Jeff Foote\footeje01,C,24,NOH,4,0,39,2,6,.333,0,0,,2,6,.333,.333,0,0,,1,5,6,0,0,1,2,5,4
149,Gary Forbes\forbega01,SG,26,TOR,48,2,713,112,271,.413,29,83,.349,83,188,.441,.467,66,91,.725,27,75,102,54,24,4,54,56,319
150,T.J. Ford\fordtj01,PG,28,SAS,14,0,191,19,43,.442,2,8,.250,17,35,.486,.465,11,14,.786,3,15,18,45,9,2,23,23,51
151,Courtney Fortson\fortsco01,PG,23,TOT,10,0,95,11,32,.344,3,13,.231,8,19,.421,.391,10,15,.667,6,9,15,10,3,0,10,5,35
151,Courtney Fortson\fortsco01,PG,23,LAC,4,0,46,5,12,.417,1,4,.250,4,8,.500,.458,6,9,.667,4,4,8,5,0,0,5,3,17
151,Courtney Fortson\fortsco01,PG,23,HOU,6,0,49,6,20,.300,2,9,.222,4,11,.364,.350,4,6,.667,2,5,7,5,3,0,5,2,18
152,Jeff Foster\fosteje01,C,35,IND,11,0,141,9,18,.500,1,1,1.000,8,17,.471,.528,6,9,.667,18,24,42,4,8,1,7,26,25
153,Randy Foye\foyera01,SG,28,LAC,65,48,1682,256,644,.398,127,329,.386,129,315,.410,.496,73,85,.859,25,113,138,146,46,24,73,130,712
154,Jimmer Fredette\fredeji01,PG,22,SAC,61,7,1135,172,446,.386,78,216,.361,94,230,.409,.473,40,48,.833,17,56,73,108,30,3,67,73,462
155,Enes Freedom\kanteen01,C,19,UTA,66,0,874,117,236,.496,0,1,.000,117,235,.498,.496,70,105,.667,107,171,278,8,18,23,54,87,304
156,Channing Frye\fryech01,PF,28,PHO,64,59,1669,255,613,.416,91,263,.346,164,350,.469,.490,73,82,.890,71,308,379,88,42,70,63,176,674
157,Dan Gadzuric\gadzuda01,C,33,NYK,2,0,13,0,2,.000,0,0,,0,2,.000,.000,0,2,.000,1,4,5,0,1,1,1,4,0
158,Sundiata Gaines\gainesu01,SG,25,NJN,57,12,793,102,271,.376,28,82,.341,74,189,.392,.428,59,96,.615,27,81,108,126,55,2,52,58,291
159,Danilo Gallinari\gallida01,SF,23,DEN,43,40,1351,193,466,.414,60,183,.328,133,283,.470,.479,182,209,.871,28,174,202,116,42,23,68,86,628
160,Francisco García\garcifr01,SF,30,SAC,49,3,798,86,229,.376,38,131,.290,48,98,.490,.459,24,30,.800,11,88,99,31,36,37,22,73,234
161,Kevin Garnett*\garneke01,C,35,BOS,60,60,1864,391,777,.503,3,9,.333,388,768,.505,.505,162,189,.857,66,428,494,175,56,61,107,141,947
162,Marc Gasol\gasolma01,C,27,MEM,65,65,2370,357,740,.482,1,12,.083,356,728,.489,.483,237,317,.748,120,459,579,204,62,121,121,201,952
163,Pau Gasol\gasolpa01,PF,31,LAL,65,65,2430,459,917,.501,7,27,.259,452,890,.508,.504,204,261,.782,183,495,678,237,37,88,142,127,1129
164,Rudy Gay\gayru01,SF,25,MEM,65,65,2422,485,1067,.455,54,173,.312,431,894,.482,.480,208,263,.791,130,287,417,147,95,55,161,138,1232
165,Alonzo Gee\geeal01,SG,24,CLE,63,31,1827,227,551,.412,44,137,.321,183,414,.442,.452,167,212,.788,101,221,322,113,83,17,114,149,665
166,Paul George\georgpa01,SG,21,IND,66,66,1958,281,639,.440,90,234,.385,191,405,.472,.510,146,182,.802,56,314,370,158,108,38,117,191,798
167,Daniel Gibson\gibsoda01,SG,25,CLE,35,7,916,87,248,.351,55,139,.396,32,109,.294,.462,34,43,.791,11,90,101,76,26,16,45,69,263
168,Taj Gibson\gibsota01,PF,26,CHI,63,0,1284,200,404,.495,0,0,,200,404,.495,.495,84,135,.622,135,197,332,47,27,81,60,131,484
169,Manu Ginóbili*\ginobma01,SG,34,SAS,34,7,792,150,285,.526,52,126,.413,98,159,.616,.618,88,101,.871,18,98,116,151,24,12,64,56,440
170,Mickell Gladness\gladnmi01,PF,25,TOT,26,7,252,25,59,.424,0,0,,25,59,.424,.424,6,12,.500,14,44,58,5,4,20,7,32,56
170,Mickell Gladness\gladnmi01,PF,25,MIA,8,0,28,1,3,.333,0,0,,1,3,.333,.333,0,0,,1,10,11,2,1,1,3,8,2
170,Mickell Gladness\gladnmi01,PF,25,GSW,18,7,224,24,56,.429,0,0,,24,56,.429,.429,6,12,.500,13,34,47,3,3,19,4,24,54
171,Ryan Gomes\gomesry01,SF,29,LAC,32,2,425,31,95,.326,4,29,.138,27,66,.409,.347,8,11,.727,14,47,61,12,16,0,15,34,74
172,Drew Gooden\goodedr01,C,30,MIL,56,46,1469,287,657,.437,16,55,.291,271,602,.450,.449,176,208,.846,130,233,363,144,46,34,109,112,766
173,Ben Gordon\gordobe01,SG,28,DET,52,21,1398,234,530,.442,63,147,.429,171,383,.446,.501,117,136,.860,14,107,121,127,34,11,115,114,648
174,Eric Gordon\gordoer01,SG,23,NOH,9,9,310,63,140,.450,10,40,.250,53,100,.530,.486,49,65,.754,2,23,25,31,13,4,24,20,185
175,Marcin Gortat\gortama01,C,27,PHO,66,66,2114,427,769,.555,0,2,.000,427,767,.557,.555,163,251,.649,185,474,659,59,48,99,90,142,1017
176,Andrew Goudelock\goudean01,SG,23,LAL,40,0,419,68,174,.391,28,75,.373,40,99,.404,.471,11,12,.917,5,26,31,20,4,0,21,32,175
177,Danny Granger\grangda01,SF,28,IND,62,62,2062,391,941,.416,123,323,.381,268,618,.434,.481,254,291,.873,79,228,307,109,62,40,110,144,1159
178,Aaron Gray\grayaa01,C,27,TOR,49,40,813,83,161,.516,0,0,,83,161,.516,.516,25,47,.532,83,198,281,27,22,17,51,127,191
179,Danny Green\greenda02,SG,24,SAS,66,38,1522,211,477,.442,102,234,.436,109,243,.449,.549,79,100,.790,54,174,228,86,58,46,67,107,603
180,Gerald Green\greenge01,SF,26,NJN,31,2,781,154,320,.481,43,110,.391,111,210,.529,.548,49,65,.754,15,93,108,34,28,17,55,80,400
181,Willie Green\greenwi01,SG,30,ATL,53,2,922,153,325,.471,50,113,.442,103,212,.486,.548,48,56,.857,15,65,80,40,23,6,33,74,404
182,Donté Greene\greendo01,PF,23,SAC,53,7,777,108,266,.406,25,105,.238,83,161,.516,.453,44,55,.800,19,114,133,34,18,29,32,67,285
183,Blake Griffin\griffbl01,PF,22,LAC,66,66,2392,561,1022,.549,2,16,.125,559,1006,.556,.550,244,468,.521,218,499,717,210,54,48,150,216,1368
184,Hamed Haddadi\haddaha01,C,26,MEM,35,0,206,26,48,.542,0,1,.000,26,47,.553,.542,18,26,.692,28,43,71,8,1,26,21,43,70
185,Jordan Hamilton\hamiljo02,SF,21,DEN,26,2,258,48,111,.432,17,47,.362,31,64,.484,.509,2,5,.400,11,51,62,20,4,3,16,15,115
186,Richard Hamilton\hamilri01,SG,33,CHI,28,28,697,140,310,.452,17,46,.370,123,264,.466,.479,29,37,.784,20,46,66,84,12,1,49,56,326
187,Tyler Hansbrough\hansbty01,PF,26,IND,66,0,1442,194,479,.405,0,1,.000,194,478,.406,.405,226,278,.813,113,177,290,30,54,9,65,159,614
188,Luke Harangody\haranlu01,PF,24,CLE,21,1,231,23,65,.354,5,21,.238,18,44,.409,.392,9,12,.750,20,33,53,6,6,3,4,17,60
189,James Harden\hardeja01,SG,22,OKC,62,2,1946,309,629,.491,114,292,.390,195,337,.579,.582,312,369,.846,30,222,252,229,62,15,137,150,1044
190,Justin Harper\harpeju01,PF,22,ORL,14,0,84,9,31,.290,2,13,.154,7,18,.389,.323,0,1,.000,3,9,12,2,2,3,6,5,20
191,Josh Harrellson\harrejo01,PF,22,NYK,37,4,540,63,149,.423,20,59,.339,43,90,.478,.490,16,26,.615,47,97,144,11,23,20,20,48,162
192,Al Harrington\harrial01,PF,31,DEN,64,1,1761,345,773,.446,101,303,.333,244,470,.519,.512,119,176,.676,72,318,390,88,58,12,112,181,910
193,Devin Harris\harride01,PG,28,UTA,63,63,1741,241,542,.445,77,213,.362,164,329,.498,.516,156,209,.746,12,100,112,316,64,13,122,136,715
194,Manny Harris\harrima01,SG,22,CLE,26,5,456,60,150,.400,12,36,.333,48,114,.421,.440,41,59,.695,11,59,70,31,13,6,27,28,173
195,Terrel Harris\harrite01,SG,24,MIA,22,1,318,29,83,.349,8,39,.205,21,44,.477,.398,14,21,.667,18,33,51,26,9,2,25,34,80
196,Tobias Harris\harrito02,SF,19,MIL,42,9,479,79,169,.467,6,23,.261,73,146,.500,.485,44,54,.815,30,71,101,22,13,7,31,45,208
197,Udonis Haslem\hasleud01,PF,31,MIA,64,10,1589,151,357,.423,0,0,,151,357,.423,.423,83,102,.814,117,353,470,42,35,24,60,142,385
198,Spencer Hawes\hawessp01,C,23,PHI,37,29,920,156,319,.489,3,12,.250,153,307,.498,.494,40,55,.727,78,192,270,98,16,48,55,100,355
199,Chuck Hayes\hayesch01,C,28,SAC,54,9,1039,73,170,.429,0,2,.000,73,168,.435,.429,26,39,.667,72,162,234,77,36,17,50,111,172
200,Gordon Hayward\haywago01,SF,21,UTA,66,58,2015,267,586,.456,55,159,.346,212,427,.496,.503,193,232,.832,59,171,230,207,53,41,109,106,782
201,Lazar Hayward\haywala01,SF,25,OKC,26,0,141,13,38,.342,4,14,.286,9,24,.375,.395,7,12,.583,2,14,16,4,3,1,9,18,37
202,Brendan Haywood\haywobr01,C,32,DAL,54,54,1146,118,228,.518,0,0,,118,228,.518,.518,45,96,.469,139,185,324,19,24,54,46,121,281
203,Gerald Henderson\hendege02,SG,24,CHA,55,55,1831,332,723,.459,11,47,.234,321,676,.475,.467,155,204,.760,64,161,225,126,49,20,100,128,830
204,Xavier Henry\henryxa01,SG,20,NOH,45,0,759,90,228,.395,7,17,.412,83,211,.393,.410,52,85,.612,24,82,106,35,26,8,35,59,239
205,Roy Hibbert\hibbero01,C,25,IND,65,65,1937,332,668,.497,0,1,.000,332,667,.498,.497,170,239,.711,213,359,572,108,32,128,128,195,834
206,J.J. Hickson\hicksjj01,PF,23,TOT,54,19,1244,183,392,.467,0,2,.000,183,390,.469,.467,86,134,.642,133,202,335,45,30,35,70,85,452
206,J.J. Hickson\hicksjj01,PF,23,SAC,35,9,644,64,173,.370,0,1,.000,64,172,.372,.370,37,58,.638,67,110,177,22,18,17,39,44,165
206,J.J. Hickson\hicksjj01,PF,23,POR,19,10,600,119,219,.543,0,1,.000,119,218,.546,.543,49,76,.645,66,92,158,23,12,18,31,41,287
207,Cory Higgins\higgico01,PG,22,CHA,38,0,423,52,160,.325,4,20,.200,48,140,.343,.338,42,60,.700,7,28,35,36,5,6,39,40,150
208,Nenê\hilarne01,C,29,TOT,39,33,1110,211,393,.537,0,4,.000,211,389,.542,.537,113,168,.673,63,228,291,80,42,38,96,95,535
208,Nenê\hilarne01,C,29,DEN,28,27,826,143,281,.509,0,2,.000,143,279,.513,.509,90,133,.677,43,165,208,61,36,25,77,69,376
208,Nenê\hilarne01,C,29,WAS,11,6,284,68,112,.607,0,2,.000,68,110,.618,.607,23,35,.657,20,63,83,19,6,13,19,26,159
209,George Hill\hillge01,PG,25,IND,50,9,1274,168,380,.442,54,147,.367,114,233,.489,.513,91,117,.778,31,120,151,145,42,17,52,98,481
210,Grant Hill*\hillgr01,SF,39,PHO,49,46,1378,201,451,.446,14,53,.264,187,398,.470,.461,83,109,.761,29,142,171,107,41,29,65,88,499
211,Jordan Hill\hilljo01,C,24,TOT,39,8,551,82,165,.497,0,3,.000,82,162,.506,.497,30,47,.638,61,125,186,16,14,27,31,71,194
211,Jordan Hill\hilljo01,C,24,HOU,32,7,469,68,135,.504,0,3,.000,68,132,.515,.504,25,39,.641,47,108,155,14,9,21,24,60,161
211,Jordan Hill\hilljo01,C,24,LAL,7,1,82,14,30,.467,0,0,,14,30,.467,.467,5,8,.625,14,17,31,2,5,6,7,11,33
212,Kirk Hinrich\hinriki01,SG,31,ATL,48,31,1237,122,295,.414,47,136,.346,75,159,.472,.493,25,32,.781,11,90,101,132,38,11,58,100,316
213,Darington Hobson\hobsoda01,SG,24,MIL,5,0,39,2,13,.154,0,6,.000,2,7,.286,.154,0,0,,0,3,3,6,0,0,2,1,4
214,Jrue Holiday\holidjr01,PG,21,PHI,65,65,2196,360,834,.432,65,171,.380,295,663,.445,.471,94,120,.783,57,155,212,290,103,18,135,137,879
215,Ryan Hollins\holliry01,C,27,TOT,39,8,522,46,84,.548,0,0,,46,84,.548,.548,39,75,.520,34,48,82,9,5,17,35,78,131
215,Ryan Hollins\holliry01,C,27,CLE,24,7,362,28,56,.500,0,0,,28,56,.500,.500,33,55,.600,25,31,56,6,4,12,24,55,89
215,Ryan Hollins\holliry01,C,27,BOS,15,1,160,18,28,.643,0,0,,18,28,.643,.643,6,20,.300,9,17,26,3,1,5,11,23,42
216,Tyler Honeycutt\honeyty01,SF,21,SAC,15,0,88,8,24,.333,1,3,.333,7,21,.333,.354,3,5,.600,3,11,14,7,4,3,2,3,20
217,Al Horford\horfoal01,C,25,ATL,11,11,348,57,103,.553,0,1,.000,57,102,.559,.553,22,30,.733,26,51,77,24,10,14,16,21,136
218,Dennis Horner\hornede01,PF,23,NJN,8,0,22,1,4,.250,0,1,.000,1,3,.333,.250,3,4,.750,2,3,5,0,0,0,1,1,5
219,Dwight Howard\howardw01,C,26,ORL,54,54,2070,416,726,.573,0,7,.000,416,719,.579,.573,281,572,.491,200,585,785,104,81,116,175,159,1113
220,Josh Howard\howarjo01,SF,31,UTA,43,18,991,144,361,.399,9,37,.243,135,324,.417,.411,75,97,.773,39,119,158,50,32,10,53,91,372
221,Juwan Howard\howarju01,PF,38,MIA,28,0,190,17,55,.309,0,0,,17,55,.309,.309,8,10,.800,18,29,47,10,4,1,20,18,42
222,Lester Hudson\hudsole01,PG,27,TOT,16,0,334,62,162,.383,16,64,.250,46,98,.469,.432,34,41,.829,7,39,46,36,14,3,32,26,174
222,Lester Hudson\hudsole01,PG,27,CLE,13,0,314,59,151,.391,15,61,.246,44,90,.489,.440,32,38,.842,7,39,46,35,14,3,30,26,165
222,Lester Hudson\hudsole01,PG,27,MEM,3,0,20,3,11,.273,1,3,.333,2,8,.250,.318,2,3,.667,0,0,0,1,0,0,2,0,9
223,Larry Hughes\hughela01,PG,33,ORL,9,0,114,5,22,.227,1,7,.143,4,15,.267,.250,1,2,.500,1,4,5,7,2,0,12,10,12
224,Kris Humphries\humphkr01,PF,26,NJN,62,62,2162,323,671,.481,0,0,,323,671,.481,.481,209,278,.752,233,448,681,90,50,74,119,173,855
225,Serge Ibaka\ibakase01,PF,22,OKC,66,66,1792,262,490,.535,1,3,.333,261,487,.536,.536,78,118,.661,193,305,498,28,33,241,79,179,603
226,Andre Iguodala\iguodan01,SF,28,PHI,62,62,2209,287,632,.454,76,193,.394,211,439,.481,.514,121,196,.617,56,325,381,339,107,30,115,92,771
227,Ersan İlyasova\ilyaser01,PF,24,MIL,60,41,1655,294,597,.492,51,112,.455,243,485,.501,.535,143,183,.781,196,333,529,71,42,44,76,133,782
228,Kyrie Irving\irvinky01,PG,19,CLE,51,51,1558,350,747,.469,73,183,.399,277,564,.491,.517,171,196,.872,44,147,191,275,54,20,160,110,944
229,Royal Ivey\iveyro01,SG,30,OKC,34,0,354,26,73,.356,18,53,.340,8,20,.400,.479,1,8,.125,1,23,24,10,14,0,9,36,71
230,Jarrett Jack\jackja01,PG,28,NOH,45,39,1530,266,583,.456,39,112,.348,227,471,.482,.490,129,148,.872,23,153,176,285,31,9,106,93,700
231,Reggie Jackson\jacksre01,PG,21,OKC,45,0,501,51,159,.321,13,62,.210,38,97,.392,.362,25,29,.862,14,39,53,71,25,1,36,31,140
232,Stephen Jackson\jacksst02,SF,33,TOT,47,14,1212,159,425,.374,49,170,.288,110,255,.431,.432,94,114,.825,22,141,163,118,54,13,103,99,461
232,Stephen Jackson\jacksst02,SF,33,MIL,26,13,712,97,272,.357,30,108,.278,67,164,.409,.412,50,60,.833,16,66,82,77,26,6,66,61,274
232,Stephen Jackson\jacksst02,SF,33,SAS,21,1,500,62,153,.405,19,62,.306,43,91,.473,.467,44,54,.815,6,75,81,41,28,7,37,38,187
233,Damion James\jamesda01,SF,24,NJN,7,7,170,13,35,.371,0,1,.000,13,34,.382,.371,8,12,.667,7,26,33,3,7,7,12,17,34
234,LeBron James\jamesle01,SF,27,MIA,62,62,2326,621,1169,.531,54,149,.362,567,1020,.556,.554,387,502,.771,94,398,492,387,115,50,213,96,1683
235,Mike James\jamesmi01,PG,36,CHI,11,0,120,20,49,.408,6,10,.600,14,39,.359,.469,7,8,.875,2,8,10,29,4,2,14,20,53
236,Antawn Jamison\jamisan01,PF,35,CLE,65,65,2151,421,1044,.403,91,267,.341,330,777,.425,.447,185,271,.683,123,285,408,131,51,43,90,164,1118
237,Al Jefferson\jeffeal01,C,27,UTA,61,61,2075,516,1048,.492,1,4,.250,515,1044,.493,.493,137,177,.774,133,452,585,134,47,101,62,155,1170
238,Richard Jefferson\jefferi01,SF,31,TOT,63,44,1748,203,488,.416,113,269,.420,90,219,.411,.532,59,85,.694,26,193,219,88,37,19,50,121,578
238,Richard Jefferson\jefferi01,SF,31,SAS,41,41,1168,132,319,.414,80,190,.421,52,129,.403,.539,35,50,.700,18,125,143,55,25,12,32,83,379
238,Richard Jefferson\jefferi01,SF,31,GSW,22,3,580,71,169,.420,33,79,.418,38,90,.422,.518,24,35,.686,8,68,76,33,12,7,18,38,199
239,Jared Jeffries\jeffrja01,PF,30,NYK,39,4,729,59,144,.410,3,16,.188,56,128,.438,.420,49,72,.681,69,83,152,26,29,25,29,89,170
240,Charles Jenkins\jenkich01,PG,22,GSW,51,28,893,130,291,.447,3,20,.150,127,271,.469,.452,34,39,.872,8,60,68,170,33,6,60,85,297
241,Brandon Jennings\jennibr01,PG,22,MIL,66,66,2331,469,1121,.418,129,388,.332,340,733,.464,.476,193,239,.808,49,177,226,365,104,22,146,114,1260
242,Jonas Jerebko\jerebjo01,PF,24,DET,64,13,1468,212,453,.468,32,106,.302,180,347,.519,.503,100,124,.806,96,212,308,43,41,21,66,162,556
243,Yi Jianlian\jianlyi01,PF,24,DAL,30,0,203,31,82,.378,3,10,.300,28,72,.389,.396,14,21,.667,12,37,49,5,7,8,14,23,79
244,Amir Johnson\johnsam01,PF,24,TOR,64,43,1553,196,340,.576,2,5,.400,194,335,.579,.579,58,84,.690,149,259,408,79,33,69,94,209,452
245,Armon Johnson\johnsar02,PG,22,TOT,9,0,124,20,43,.465,1,3,.333,19,40,.475,.477,6,6,1.000,1,12,13,11,5,0,6,9,47
245,Armon Johnson\johnsar02,PG,22,POR,1,0,5,1,1,1.000,0,0,,1,1,1.000,1.000,0,0,,0,1,1,0,1,0,1,0,2
245,Armon Johnson\johnsar02,PG,22,NJN,8,0,119,19,42,.452,1,3,.333,18,39,.462,.464,6,6,1.000,1,11,12,11,4,0,5,9,45
246,Carldell Johnson\johnsca01,PG,29,NOH,15,0,119,11,35,.314,4,15,.267,7,20,.350,.371,1,3,.333,1,8,9,22,8,0,7,11,27
247,Chris Johnson\johnsch03,C,26,TOT,27,0,175,20,41,.488,0,0,,20,41,.488,.488,15,19,.789,15,25,40,2,6,9,15,33,55
247,Chris Johnson\johnsch03,C,26,POR,20,0,93,11,23,.478,0,0,,11,23,.478,.478,10,12,.833,8,10,18,1,1,8,7,20,32
247,Chris Johnson\johnsch03,C,26,NOH,7,0,82,9,18,.500,0,0,,9,18,.500,.500,5,7,.714,7,15,22,1,5,1,8,13,23
248,Ivan Johnson\johnsiv01,PF,27,ATL,56,0,934,141,275,.513,2,6,.333,139,269,.517,.516,72,100,.720,65,161,226,32,43,18,69,116,356
249,JaJuan Johnson\johnsja02,PF,22,BOS,36,0,298,54,121,.446,0,0,,54,121,.446,.446,6,9,.667,20,38,58,6,5,14,14,25,114
250,James Johnson\johnsja01,SF,24,TOR,62,40,1561,233,518,.450,19,60,.317,214,458,.467,.468,81,115,.704,74,218,292,122,71,84,101,177,566
251,Joe Johnson\johnsjo02,SG,30,ATL,60,60,2127,423,931,.454,125,322,.388,298,609,.489,.521,158,186,.849,53,168,221,232,48,13,116,75,1129
252,Trey Johnson\johnstr01,SG,27,NOH,11,0,61,8,14,.571,0,0,,8,14,.571,.571,5,5,1.000,3,9,12,4,1,0,5,10,21
253,Wesley Johnson\johnswe01,SF,24,MIN,65,64,1469,158,397,.398,53,169,.314,105,228,.461,.465,24,34,.706,24,153,177,59,35,48,60,115,393
254,Dahntay Jones\jonesda02,SF,31,IND,65,3,1052,115,281,.409,33,77,.429,82,204,.402,.468,83,99,.838,23,94,117,63,23,11,46,119,346
255,Dominique Jones\jonesdo02,SG,23,DAL,33,1,268,29,73,.397,1,8,.125,28,65,.431,.404,29,37,.784,9,35,44,42,10,5,28,28,88
256,James Jones\jonesja02,SG,31,MIA,51,10,666,57,150,.380,46,114,.404,11,36,.306,.533,25,30,.833,6,43,49,19,17,9,10,45,185
257,Solomon Jones\jonesso01,C-PF,27,TOT,21,1,292,24,61,.393,0,0,,24,61,.393,.393,19,23,.826,32,26,58,9,9,11,18,43,67
257,Solomon Jones\jonesso01,PF,27,LAC,10,0,96,1,8,.125,0,0,,1,8,.125,.125,4,5,.800,11,6,17,2,4,5,5,12,6
257,Solomon Jones\jonesso01,C,27,NOH,11,1,196,23,53,.434,0,0,,23,53,.434,.434,15,18,.833,21,20,41,7,5,6,13,31,61
258,DeAndre Jordan\jordade01,C,23,LAC,66,66,1798,206,326,.632,0,1,.000,206,325,.634,.632,74,141,.525,202,344,546,17,30,134,74,189,486
259,Jerome Jordan\jordaje01,C,25,NYK,21,0,108,17,33,.515,0,0,,17,33,.515,.515,8,10,.800,14,13,27,4,1,6,2,15,42
260,Cory Joseph\josepco01,PG,20,SAS,29,1,266,22,70,.314,3,15,.200,19,55,.345,.336,11,17,.647,5,20,25,34,7,3,12,16,58
261,Chris Kaman\kamanch01,C,29,NOH,47,33,1372,266,597,.446,0,0,,266,597,.446,.446,84,107,.785,89,275,364,101,25,77,129,106,616
262,Jason Kapono\kaponja01,SG,30,LAL,27,0,269,21,55,.382,8,27,.296,13,28,.464,.455,4,4,1.000,2,12,14,11,3,0,6,21,54
263,D.J. Kennedy\kennedj01,SF,22,CLE,2,0,59,5,12,.417,2,4,.500,3,8,.375,.500,0,2,.000,1,6,7,3,2,0,3,7,12
264,Jason Kidd*\kiddja01,PG,38,DAL,48,48,1379,99,273,.363,79,223,.354,20,50,.400,.507,22,28,.786,15,183,198,264,82,10,91,83,299
265,Linas Kleiza\kleizli01,SF,27,TOR,49,3,1057,165,410,.402,62,179,.346,103,231,.446,.478,81,100,.810,42,157,199,46,23,4,64,119,473
266,Brandon Knight\knighbr03,PG,20,DET,66,60,2129,319,769,.415,105,276,.380,214,493,.434,.483,104,137,.759,33,178,211,251,49,10,171,154,847
267,Kyle Korver\korveky01,SG,30,CHI,65,7,1469,178,412,.432,118,271,.435,60,141,.426,.575,55,66,.833,26,133,159,112,36,15,53,110,529
268,Kosta Koufos\koufoko01,C,22,DEN,48,24,792,115,192,.599,0,0,,115,192,.599,.599,33,55,.600,95,163,258,15,24,41,33,96,263
269,Carl Landry\landrca01,PF,28,NOH,41,8,999,182,362,.503,0,3,.000,182,359,.507,.503,147,184,.799,78,136,214,38,13,12,64,89,511
270,Ty Lawson\lawsoty01,PG,24,DEN,61,61,2124,374,767,.488,73,200,.365,301,567,.531,.535,178,216,.824,54,173,227,401,82,6,149,94,999
271,Courtney Lee\leeco01,SG,26,HOU,58,26,1757,251,580,.433,87,217,.401,164,363,.452,.508,71,86,.826,26,133,159,88,68,22,64,106,660
272,David Lee\leeda02,PF,28,GSW,57,57,2121,464,922,.503,0,5,.000,464,917,.506,.503,219,280,.782,171,374,545,162,54,22,149,179,1147
273,Malcolm Lee\leema01,SG,21,MIN,19,0,243,23,59,.390,2,10,.200,21,49,.429,.407,14,17,.824,9,17,26,31,8,4,17,22,62
274,Kawhi Leonard\leonaka01,SF,20,SAS,64,39,1534,199,404,.493,41,109,.376,158,295,.536,.543,68,88,.773,104,223,327,70,85,24,44,88,507
275,Travis Leslie\leslitr01,SG,21,LAC,10,0,45,5,14,.357,0,0,,5,14,.357,.357,4,9,.444,6,3,9,5,2,2,2,4,14
276,Jon Leuer\leuerjo01,PF,22,MIL,46,12,555,97,191,.508,3,9,.333,94,182,.516,.516,21,28,.750,45,75,120,25,14,17,18,67,218
277,Rashard Lewis\lewisra02,SF,32,WAS,28,15,729,85,221,.385,16,67,.239,69,154,.448,.421,31,37,.838,34,75,109,27,23,10,32,49,217
278,DeAndre Liggins\liggide01,SF,23,ORL,17,0,115,12,25,.480,0,4,.000,12,21,.571,.480,9,19,.474,6,9,15,5,6,0,10,6,33
279,Jeremy Lin\linje01,PG,23,NYK,35,25,940,171,383,.446,24,75,.320,147,308,.477,.478,146,183,.798,18,89,107,216,55,9,126,78,512
280,Shaun Livingston\livinsh01,SG,26,MIL,58,27,1092,127,271,.469,2,3,.667,125,268,.466,.472,62,79,.785,39,84,123,122,27,20,66,79,318
281,Brook Lopez\lopezbr01,C,23,NJN,5,5,136,38,77,.494,0,0,,38,77,.494,.494,20,32,.625,8,10,18,6,1,4,6,8,96
282,Robin Lopez\lopezro01,C,23,PHO,64,0,895,124,269,.461,0,0,,124,269,.461,.461,100,140,.714,90,119,209,20,18,60,43,128,348
283,Kevin Love\loveke01,PF,23,MIN,55,55,2145,474,1059,.448,105,282,.372,369,777,.475,.497,379,460,.824,226,508,734,111,47,28,128,152,1432
284,Kyle Lowry\lowryky01,PG,25,HOU,47,38,1510,210,513,.409,79,211,.374,131,302,.434,.486,171,198,.864,37,176,213,310,73,14,130,133,670
285,John Lucas III\lucasjo02,PG,29,CHI,49,2,726,143,358,.399,55,140,.393,88,218,.404,.476,28,32,.875,22,54,76,108,19,1,42,42,369
286,Shelvin Mack\macksh01,PG,21,WAS,64,0,779,88,220,.400,12,42,.286,76,178,.427,.427,42,59,.712,12,80,92,131,28,2,48,50,230
287,Vernon Macklin\macklve01,C,25,DET,23,0,135,19,35,.543,0,0,,19,35,.543,.543,8,14,.571,14,20,34,5,4,4,3,9,46
288,Corey Maggette\maggeco01,SF,32,CHA,32,28,881,139,373,.373,24,66,.364,115,307,.375,.405,178,208,.856,21,104,125,39,23,1,59,83,480
289,Jamaal Magloire\magloja01,C,33,TOR,34,1,374,17,45,.378,0,0,,17,45,.378,.378,7,27,.259,25,88,113,6,4,10,22,66,41
290,Ian Mahinmi\mahinia01,C,25,DAL,61,12,1139,130,238,.546,0,1,.000,130,237,.549,.546,94,147,.639,108,181,289,12,38,31,50,176,354
291,Shawn Marion\mariosh01,SF,33,DAL,63,63,1919,288,646,.446,20,68,.294,268,578,.464,.461,74,93,.796,145,320,465,132,67,36,98,87,670
292,Cartier Martin\martica01,SF,27,WAS,17,2,391,59,134,.440,29,75,.387,30,59,.508,.549,11,19,.579,12,46,58,10,11,2,13,35,158
293,Kenyon Martin\martike01,PF,34,LAC,42,0,940,97,220,.441,3,13,.231,94,207,.454,.448,20,54,.370,49,132,181,18,44,43,32,103,217
294,Kevin Martin\martike02,SG,28,HOU,40,40,1264,222,537,.413,78,225,.347,144,312,.462,.486,160,179,.894,13,93,106,110,28,3,70,70,682
295,Roger Mason\masonro01,SG,31,WAS,52,0,697,103,258,.399,59,154,.383,44,104,.423,.514,21,27,.778,7,62,69,47,13,5,32,33,286
296,Wesley Matthews\matthwe02,SG,25,POR,66,53,2228,314,763,.412,129,337,.383,185,426,.434,.496,147,171,.860,56,168,224,113,96,15,73,148,904
297,Jason Maxiell\maxieja01,PF,28,DET,65,42,1466,183,383,.478,0,2,.000,183,381,.480,.478,58,106,.547,126,207,333,41,32,50,71,151,424
298,Eric Maynor\maynoer01,PG,24,OKC,9,0,137,14,39,.359,6,17,.353,8,22,.364,.436,4,4,1.000,3,10,13,22,5,0,11,13,38
299,O.J. Mayo\mayooj01,SG,24,MEM,66,0,1771,300,736,.408,100,275,.364,200,461,.434,.476,133,172,.773,30,180,210,169,71,23,124,137,833
300,Luc Mbah a Moute\mbahalu01,PF,25,MIL,43,22,1009,133,261,.510,1,4,.250,132,257,.514,.511,66,103,.641,77,150,227,29,40,22,39,93,333
301,JaVale McGee\mcgeeja01,C,24,TOT,61,45,1535,307,552,.556,0,0,,307,552,.556,.556,77,167,.461,163,314,477,31,35,132,87,166,691
301,JaVale McGee\mcgeeja01,C,24,WAS,41,40,1124,214,400,.535,0,0,,214,400,.535,.535,58,116,.500,127,235,362,25,25,101,68,118,486
301,JaVale McGee\mcgeeja01,C,24,DEN,20,5,411,93,152,.612,0,0,,93,152,.612,.612,19,51,.373,36,79,115,6,10,31,19,48,205
302,Tracy McGrady*\mcgratr01,SF,32,ATL,52,0,837,101,231,.437,15,33,.455,86,198,.434,.470,56,83,.675,23,131,154,110,16,15,53,35,273
303,Dominic McGuire\mcguido01,PF,26,GSW,64,6,1127,94,210,.448,0,4,.000,94,206,.456,.448,39,53,.736,73,173,246,110,44,36,56,104,227
304,Josh McRoberts\mcrobjo01,PF,24,LAL,50,6,718,56,118,.475,3,7,.429,53,111,.477,.487,23,36,.639,61,110,171,51,15,18,31,74,138
305,Jodie Meeks\meeksjo01,SG,24,PHI,66,50,1644,191,467,.409,97,266,.365,94,201,.468,.513,77,85,.906,17,144,161,54,40,3,29,82,556
306,C.J. Miles\milescj01,SG,24,UTA,56,14,1145,177,465,.381,46,150,.307,131,315,.416,.430,108,136,.794,27,89,116,69,46,18,53,122,508
307,Darko Miličić\milicda01,C,26,MIN,29,23,472,59,130,.454,0,0,,59,130,.454,.454,16,37,.432,35,62,97,17,9,25,32,59,134
308,Andre Miller\millean02,SG,35,DEN,66,7,1809,242,552,.438,18,83,.217,224,469,.478,.455,137,169,.811,53,168,221,441,63,9,177,133,639
309,Brad Miller\millebr01,C,35,MIN,15,1,146,9,27,.333,7,15,.467,2,12,.167,.463,10,12,.833,4,15,19,24,4,2,12,10,35
310,Mike Miller\millemi01,SG,31,MIA,39,2,752,91,209,.435,53,117,.453,38,92,.413,.562,2,5,.400,22,106,128,42,14,6,30,58,237
311,Patty Mills\millspa02,PG,23,SAS,16,3,261,63,130,.485,24,56,.429,39,74,.527,.577,15,15,1.000,4,24,28,39,10,1,26,14,165
312,Paul Millsap\millspa01,PF,26,UTA,64,62,2100,426,861,.495,7,31,.226,419,830,.505,.499,202,255,.792,180,383,563,150,118,52,112,222,1061
313,Nazr Mohammed\mohamna01,C,34,OKC,63,1,692,79,169,.467,0,1,.000,79,168,.470,.467,13,23,.565,59,111,170,14,20,37,26,101,171
314,Greg Monroe\monrogr01,C,21,DET,66,66,2082,407,781,.521,0,1,.000,407,780,.522,.521,201,272,.739,239,398,637,152,83,46,161,180,1015
315,Jamario Moon\moonja01,SF,31,CHA,8,0,123,7,24,.292,2,10,.200,5,14,.357,.333,2,2,1.000,2,20,22,5,1,5,8,5,18
316,E'Twaun Moore\mooreet01,PG,22,BOS,38,0,331,43,113,.381,17,45,.378,26,68,.382,.456,7,7,1.000,4,29,33,34,11,3,21,33,110
317,Mikki Moore\mooremi01,C,36,GSW,7,0,118,9,20,.450,0,0,,9,20,.450,.450,6,7,.857,7,15,22,5,3,3,7,24,24
318,Darius Morris\morrida01,PG,21,LAL,19,0,169,18,42,.429,4,9,.444,14,33,.424,.476,6,9,.667,2,14,16,21,2,0,19,16,46
319,Marcus Morris\morrima03,PF,22,HOU,17,0,126,16,54,.296,2,17,.118,14,37,.378,.315,6,8,.750,5,11,16,3,2,2,4,12,40
320,Markieff Morris\morrima02,PF,22,PHO,63,7,1227,174,436,.399,43,124,.347,131,312,.420,.448,76,106,.717,69,210,279,65,41,42,70,179,467
321,Anthony Morrow\morroan01,SG,26,NJN,62,18,1636,272,658,.413,106,286,.371,166,372,.446,.494,97,104,.933,31,96,127,61,46,9,70,86,747
322,Timofey Mozgov\mozgoti01,C,25,DEN,44,35,687,100,190,.526,0,0,,100,190,.526,.526,39,57,.684,53,126,179,22,15,42,53,86,239
323,Byron Mullens\mulleby01,C,22,CHA,65,25,1465,251,591,.425,12,51,.235,239,540,.443,.435,92,112,.821,96,231,327,57,21,52,74,137,606
324,Troy Murphy\murphtr01,PF,31,LAL,59,0,956,77,171,.450,28,67,.418,49,104,.471,.532,6,9,.667,40,151,191,51,15,16,26,98,188
325,Hamady N'Diaye\ndiayha01,C,25,WAS,3,0,3,0,1,.000,0,0,,0,1,.000,.000,0,0,,0,0,0,0,0,0,0,0,0
326,Eduardo Nájera\najered01,PF,35,CHA,22,0,270,24,64,.375,8,29,.276,16,35,.457,.438,2,4,.500,11,39,50,12,19,4,7,40,58
327,Steve Nash*\nashst01,PG,37,PHO,62,62,1961,295,555,.532,55,141,.390,240,414,.580,.581,127,142,.894,26,160,186,664,38,8,229,53,772
328,Gary Neal\nealga01,SG,27,SAS,56,7,1206,212,486,.436,83,198,.419,129,288,.448,.522,50,64,.781,12,106,118,117,27,2,60,75,557
329,Jameer Nelson\nelsoja01,PG,29,ORL,57,57,1706,259,606,.427,87,231,.377,172,375,.459,.499,71,88,.807,29,152,181,325,38,5,135,130,676
330,Joakim Noah\noahjo01,C,26,CHI,64,64,1945,249,490,.508,0,1,.000,249,489,.509,.508,154,206,.748,242,387,629,160,41,92,92,162,652
331,Andrés Nocioni\nocioan01,SF,32,PHI,11,1,56,5,20,.250,1,6,.167,4,14,.286,.275,6,11,.545,1,13,14,1,1,1,5,4,17
332,Steve Novak\novakst01,PF,28,NYK,54,0,1020,161,337,.478,133,282,.472,28,55,.509,.675,22,26,.846,9,95,104,12,16,9,21,59,477
333,Dirk Nowitzki\nowitdi01,PF,33,DAL,62,62,2079,473,1034,.457,78,212,.368,395,822,.481,.495,318,355,.896,46,372,418,136,42,30,117,129,1342
334,Jermaine O'Neal\onealje01,C,33,BOS,25,24,570,52,120,.433,0,0,,52,120,.433,.433,21,31,.677,37,98,135,10,8,43,21,80,125
335,Lamar Odom\odomla01,SF,32,DAL,50,4,1027,123,349,.352,28,111,.252,95,238,.399,.393,58,98,.592,36,172,208,83,20,18,52,97,332
336,Emeka Okafor\okafoem01,C,29,NOH,27,27,781,114,214,.533,0,0,,114,214,.533,.533,38,74,.514,70,143,213,24,16,26,37,73,266
337,Mehmet Okur\okurme01,C,32,NJN,17,14,454,52,139,.374,23,72,.319,29,67,.433,.457,3,5,.600,22,59,81,30,9,5,25,45,130
338,Daniel Orton\ortonda01,PF,21,ORL,16,2,187,17,30,.567,0,1,.000,17,29,.586,.567,11,25,.440,19,20,39,5,8,9,7,30,45
339,Travis Outlaw\outlatr01,SF,27,SAC,39,5,500,60,175,.343,16,60,.267,44,115,.383,.389,31,46,.674,19,42,61,16,19,21,20,34,167
340,Larry Owens\owensla01,SF,29,NJN,7,0,75,4,11,.364,2,5,.400,2,6,.333,.455,3,4,.750,2,11,13,4,0,1,2,10,13
341,Zaza Pachulia\pachuza01,C,27,ATL,58,44,1640,169,339,.499,0,0,,169,339,.499,.499,117,158,.741,154,303,457,79,55,29,81,172,455
342,Jannero Pargo\pargoja01,PG,32,ATL,50,0,671,105,253,.415,53,138,.384,52,115,.452,.520,19,20,.950,9,64,73,96,20,2,49,64,282
343,Jeremy Pargo\pargoje01,PG,25,MEM,44,5,424,50,150,.333,10,38,.263,40,112,.357,.367,16,27,.593,12,25,37,55,15,0,46,46,126
344,Anthony Parker\parkean01,SF,36,CLE,51,51,1280,141,326,.433,50,138,.362,91,188,.484,.509,35,56,.625,10,128,138,120,38,7,50,65,367
345,Tony Parker\parketo01,PG,29,SAS,60,60,1923,427,890,.480,14,61,.230,413,829,.498,.488,227,284,.799,22,149,171,463,57,5,153,75,1095
346,Chandler Parsons\parsoch01,SF,23,HOU,63,57,1804,248,549,.452,60,178,.337,188,371,.507,.506,43,78,.551,90,210,300,134,73,29,81,142,599
347,Patrick Patterson\pattepa01,PF,22,HOU,64,1,1483,225,511,.440,0,3,.000,225,508,.443,.440,40,57,.702,112,174,286,53,27,36,49,113,490
348,Chris Paul\paulch01,PG,26,LAC,60,60,2181,425,890,.478,79,213,.371,346,677,.511,.522,260,302,.861,42,171,213,543,152,4,124,138,1189
349,Sasha Pavlović\pavloal01,SF,28,BOS,45,7,527,50,128,.391,17,58,.293,33,70,.471,.457,3,8,.375,4,68,72,18,20,15,20,54,120
350,Nikola Peković\pekovni01,C,26,MIN,47,35,1264,256,454,.564,0,0,,256,454,.564,.564,139,187,.743,181,165,346,31,29,31,87,98,651
351,Kendrick Perkins\perkike01,C,27,OKC,65,65,1744,128,262,.489,0,0,,128,262,.489,.489,73,112,.652,120,306,426,78,25,73,118,189,329
352,Johan Petro\petrojo01,C,26,NJN,59,10,920,109,260,.419,1,1,1.000,108,259,.417,.421,31,37,.838,68,156,224,45,21,23,38,122,250
353,Paul Pierce*\piercpa01,SF,34,BOS,61,61,2075,394,890,.443,100,273,.366,294,617,.476,.499,293,344,.852,37,280,317,274,70,26,173,147,1181
354,Mickaël Piétrus\pietrmi01,SG,29,BOS,42,6,921,104,270,.385,61,182,.335,43,88,.489,.498,20,31,.645,18,112,130,25,21,10,33,81,289
355,Dexter Pittman\pittmde01,C,23,MIA,35,6,301,44,94,.468,0,0,,44,94,.468,.468,18,28,.643,27,44,71,9,8,8,17,73,106
356,Quincy Pondexter\pondequ01,SF,23,MEM,64,8,1002,108,239,.452,22,73,.301,86,166,.518,.498,33,53,.623,55,71,126,27,27,5,30,90,271
357,A.J. Price\priceaj01,PG,25,IND,44,1,568,59,174,.339,26,88,.295,33,86,.384,.414,28,35,.800,13,48,61,86,20,2,32,30,172
358,Ronnie Price\pricero01,PG,28,PHO,36,8,517,49,130,.377,13,44,.295,36,86,.419,.427,20,25,.800,18,38,56,67,34,3,46,72,131
359,Tayshaun Prince\princta01,SF,31,DET,63,63,2087,336,798,.421,37,104,.356,299,694,.431,.444,89,115,.774,72,209,281,153,27,32,74,77,798
360,Joel Przybilla\przybjo01,C,32,POR,27,19,449,22,48,.458,0,0,,22,48,.458,.458,11,18,.611,29,109,138,6,4,16,22,66,55
361,Vladimir Radmanović\radmavl01,SF,31,ATL,49,3,755,74,197,.376,50,135,.370,24,62,.387,.503,22,29,.759,34,109,143,54,21,15,35,62,220
362,Anthony Randolph\randoan01,PF,22,MIN,34,5,517,94,200,.470,0,1,.000,94,199,.472,.470,64,84,.762,42,81,123,19,13,35,40,56,252
363,Zach Randolph\randoza01,PF,30,MEM,28,8,735,132,285,.463,2,8,.250,130,277,.469,.467,58,88,.659,78,147,225,48,21,4,40,57,324
364,Michael Redd\reddmi01,SG,32,PHO,51,2,770,144,360,.400,42,132,.318,102,228,.447,.458,88,111,.793,14,63,77,33,13,0,37,29,418
365,J.J. Redick\redicjj01,SG,27,ORL,65,22,1765,248,584,.425,112,268,.418,136,316,.430,.521,143,157,.911,18,132,150,164,27,6,68,92,751
366,Ryan Reid\reidry01,PF,25,OKC,5,0,17,4,5,.800,0,0,,4,5,.800,.800,0,0,,1,1,2,0,0,0,1,1,8
367,Jason Richardson\richaja01,SG,31,ORL,54,54,1591,243,596,.408,102,277,.368,141,319,.442,.493,41,69,.594,36,158,194,107,53,22,60,91,629
368,Quentin Richardson\richaqu01,SF,31,ORL,48,3,866,74,197,.376,42,121,.347,32,76,.421,.482,25,30,.833,15,108,123,38,28,6,29,74,215
369,Luke Ridnour\ridnolu01,SG,30,MIN,53,53,1750,242,550,.440,49,152,.322,193,398,.485,.485,106,119,.891,19,122,141,252,56,16,96,136,639
370,Nate Robinson\robinna01,PG,27,GSW,51,9,1192,205,484,.424,66,181,.365,139,303,.459,.492,94,113,.832,15,85,100,231,59,2,75,118,570
371,Rajon Rondo\rondora01,PG,25,BOS,53,53,1957,256,572,.448,10,42,.238,246,530,.464,.456,108,181,.597,62,195,257,620,95,3,193,99,630
372,Derrick Rose\rosede01,PG,23,CHI,39,39,1375,302,695,.435,54,173,.312,248,522,.475,.473,194,239,.812,26,105,131,307,35,28,119,52,852
373,Ricky Rubio\rubiori01,PG,21,MIN,41,31,1404,139,389,.357,32,94,.340,107,295,.363,.398,126,157,.803,21,150,171,336,91,8,131,97,436
374,Brandon Rush\rushbr01,SF,26,GSW,65,1,1717,235,469,.501,99,219,.452,136,250,.544,.607,65,82,.793,33,218,251,88,35,58,68,64,634
375,Walker Russell\russewa02,PG,29,DET,28,0,357,33,95,.347,4,13,.308,29,82,.354,.368,14,22,.636,7,19,26,58,18,1,33,29,84
376,John Salmons\salmojo01,SF,32,SAC,46,32,1250,141,345,.409,33,112,.295,108,233,.464,.457,29,45,.644,20,114,134,93,37,7,45,77,344
377,Samardo Samuels\samuesa01,C,23,CLE,54,0,825,105,231,.455,0,0,,105,231,.455,.455,82,117,.701,63,117,180,20,20,20,56,113,292
378,Larry Sanders\sandela01,PF,23,MIL,52,0,643,84,184,.457,0,2,.000,84,182,.462,.457,18,38,.474,62,98,160,33,32,76,43,133,186
379,Brian Scalabrine\scalabr01,PF,33,CHI,28,0,122,14,30,.467,1,7,.143,13,23,.565,.483,3,6,.500,8,13,21,15,5,6,9,9,32
380,Luis Scola\scolalu01,PF,31,HOU,66,66,2067,436,888,.491,0,3,.000,436,885,.493,.491,153,198,.773,122,306,428,140,35,24,153,214,1025
381,Thabo Sefolosha\sefolth01,SG,27,OKC,42,42,914,67,155,.432,31,71,.437,36,84,.429,.532,38,43,.884,21,107,128,47,37,17,40,78,203
382,Josh Selby\selbyjo01,PG,20,MEM,28,0,237,25,72,.347,2,15,.133,23,57,.404,.361,11,14,.786,2,13,15,30,7,0,29,17,63
383,Kevin Séraphin\serapke01,C,22,WAS,57,21,1176,203,382,.531,0,1,.000,203,381,.533,.531,47,70,.671,103,177,280,33,19,76,66,133,453
384,Ramon Sessions\sessira01,PG,25,TOT,64,23,1707,242,565,.428,43,97,.443,199,468,.425,.466,194,248,.782,33,181,214,354,44,3,141,100,721
384,Ramon Sessions\sessira01,PG,25,CLE,41,4,1006,141,354,.398,26,62,.419,115,292,.394,.435,122,147,.830,19,108,127,212,27,1,82,63,430
384,Ramon Sessions\sessira01,PG,25,LAL,23,19,701,101,211,.479,17,35,.486,84,176,.477,.519,72,101,.713,14,73,87,142,17,2,59,37,291
385,Iman Shumpert\shumpim01,PG,21,NYK,59,35,1705,214,534,.401,48,157,.306,166,377,.440,.446,87,109,.798,42,144,186,164,101,8,111,173,563
386,Xavier Silas\silasxa01,SG,24,PHI,2,0,39,4,15,.267,1,6,.167,3,9,.333,.300,2,3,.667,2,2,4,3,0,0,3,5,11
387,Bobby Simmons\simmobo01,SF,31,LAC,28,0,418,28,90,.311,20,60,.333,8,30,.267,.422,4,7,.571,17,38,55,11,15,3,10,41,80
388,Chris Singleton\singlch01,SF,22,WAS,66,51,1431,116,312,.372,44,127,.346,72,185,.389,.442,30,44,.682,43,190,233,49,70,30,38,176,306
389,James Singleton\singlja01,PF,30,WAS,12,0,262,41,75,.547,2,9,.222,39,66,.591,.560,14,15,.933,25,56,81,15,9,8,10,27,98
390,Brian Skinner\skinnbr01,C,35,MEM,1,0,4,0,1,.000,0,0,,0,1,.000,.000,0,0,,0,0,0,0,0,0,0,1,0
391,Donald Sloan\sloando01,PG,24,TOT,33,11,669,79,198,.399,2,25,.080,77,173,.445,.404,23,30,.767,18,49,67,105,13,3,49,37,183
391,Donald Sloan\sloando01,PG,24,ATL,5,0,20,3,8,.375,0,1,.000,3,7,.429,.375,0,0,,1,4,5,5,1,0,2,3,6
391,Donald Sloan\sloando01,PG,24,NOH,3,0,41,5,14,.357,0,2,.000,5,12,.417,.357,2,4,.500,2,1,3,8,2,0,5,2,12
391,Donald Sloan\sloando01,PG,24,CLE,25,11,608,71,176,.403,2,22,.091,69,154,.448,.409,21,26,.808,15,44,59,92,10,3,42,32,165
392,Craig Smith\smithcr01,PF,28,POR,47,0,464,59,117,.504,0,1,.000,59,116,.509,.504,38,53,.717,33,77,110,19,16,5,24,55,156
393,Greg Smith\smithgr02,C,21,HOU,8,0,69,7,11,.636,0,0,,7,11,.636,.636,0,0,,5,15,20,1,2,5,1,17,14
394,Ish Smith\smithis01,PG,23,TOT,26,1,234,31,81,.383,3,9,.333,28,72,.389,.401,7,10,.700,7,28,35,41,15,2,13,15,72
394,Ish Smith\smithis01,PG,23,GSW,6,1,63,12,30,.400,2,5,.400,10,25,.400,.433,1,2,.500,2,7,9,9,4,0,1,4,27
394,Ish Smith\smithis01,PG,23,ORL,20,0,171,19,51,.373,1,4,.250,18,47,.383,.382,6,8,.750,5,21,26,32,11,2,12,11,45
395,J.R. Smith\smithjr01,SG,26,NYK,35,1,967,165,405,.407,67,193,.347,98,212,.462,.490,39,55,.709,29,107,136,84,54,6,46,87,436
396,Jason Smith\smithja02,PF,25,NOH,40,29,947,181,348,.520,1,9,.111,180,339,.531,.522,33,47,.702,72,124,196,34,21,41,40,102,396
397,Jerry Smith\smithje01,PG,24,NJN,5,0,46,3,14,.214,1,6,.167,2,8,.250,.250,0,0,,2,5,7,4,5,0,0,5,7
398,Josh Smith\smithjo03,PF,26,ATL,66,66,2329,504,1101,.458,28,109,.257,476,992,.480,.470,203,322,.630,136,496,632,257,93,115,164,172,1239
399,Nolan Smith\smithno01,PG,23,POR,44,4,541,67,180,.372,13,45,.289,54,135,.400,.408,20,28,.714,17,39,56,62,18,3,42,55,167
400,Marreese Speights\speigma01,PF,24,MEM,60,54,1345,221,488,.453,0,3,.000,221,485,.456,.453,84,109,.771,133,241,374,48,21,29,74,147,526
401,Tiago Splitter\splitti01,C,27,SAS,59,2,1121,212,343,.618,0,0,,212,343,.618,.618,125,181,.691,93,213,306,65,21,47,87,134,549
402,Jerry Stackhouse\stackje01,SF,37,ATL,30,0,273,37,100,.370,13,38,.342,24,62,.387,.435,21,23,.913,6,17,23,14,10,3,13,12,108
403,Lance Stephenson\stephla01,SG,21,IND,42,1,442,47,125,.376,4,30,.133,43,95,.453,.392,8,17,.471,12,41,53,46,21,5,36,30,106
404,DeShawn Stevenson\stevede01,SF,30,NJN,51,30,960,49,172,.285,41,145,.283,8,27,.296,.404,9,16,.563,7,94,101,41,19,4,19,59,148
405,Greg Stiemsma\stiemgr01,C,26,BOS,55,3,766,66,121,.545,0,0,,66,121,.545,.545,29,41,.707,48,129,177,28,37,85,33,144,161
406,Julyan Stone\stoneju01,SG,23,DEN,22,2,179,13,31,.419,2,11,.182,11,20,.550,.452,8,11,.727,5,20,25,37,8,6,11,18,36
407,Amar'e Stoudemire\stoudam01,PF,29,NYK,47,47,1543,316,654,.483,5,21,.238,311,633,.491,.487,186,243,.765,106,261,367,52,38,45,112,138,823
408,Rodney Stuckey\stuckro01,SG,25,DET,55,48,1644,256,597,.429,33,104,.317,223,493,.452,.456,267,320,.834,38,104,142,210,44,10,106,124,812
409,DaJuan Summers\summeda01,SF,24,NOH,15,6,209,28,65,.431,5,16,.313,23,49,.469,.469,7,9,.778,8,15,23,10,7,0,8,31,68
410,Jeff Teague\teaguje01,PG,23,ATL,66,66,2183,320,672,.476,51,149,.342,269,523,.514,.514,140,185,.757,21,138,159,321,106,37,134,145,831
411,Sebastian Telfair\telfase01,PG,26,PHO,60,1,895,141,342,.412,33,105,.314,108,237,.456,.461,53,67,.791,20,71,91,138,41,12,68,120,368
412,Jason Terry\terryja01,SG,34,DAL,63,1,2000,357,830,.430,138,365,.378,219,465,.471,.513,98,111,.883,16,133,149,226,73,11,127,69,950
413,Hasheem Thabeet\thabeha01,C,24,TOT,20,3,139,11,21,.524,0,0,,11,21,.524,.524,13,20,.650,16,26,42,0,1,10,8,20,35
413,Hasheem Thabeet\thabeha01,C,24,HOU,5,0,23,3,3,1.000,0,0,,3,3,1.000,1.000,0,0,,1,6,7,0,0,2,0,5,6
413,Hasheem Thabeet\thabeha01,C,24,POR,15,3,116,8,18,.444,0,0,,8,18,.444,.444,13,20,.650,15,20,35,0,1,8,8,15,29
414,Isaiah Thomas\thomais02,PG,22,SAC,65,37,1656,256,571,.448,83,219,.379,173,352,.491,.521,154,185,.832,48,120,168,266,53,8,105,121,749
415,Kurt Thomas\thomaku01,C,39,POR,53,3,803,73,157,.465,0,0,,73,157,.465,.465,14,20,.700,39,149,188,46,24,31,31,123,160
416,Lance Thomas\thomala01,PF,23,NOH,42,10,630,57,126,.452,0,1,.000,57,125,.456,.452,52,62,.839,49,77,126,12,10,7,24,78,166
417,Malcolm Thomas\thomama01,PF,23,SAS,3,0,15,0,3,.000,0,0,,0,3,.000,.000,1,2,.500,1,2,3,1,1,1,0,0,1
418,Tyrus Thomas\thomaty01,PF,25,CHA,54,30,1013,120,327,.367,1,3,.333,119,324,.367,.369,63,83,.759,49,151,200,35,36,60,53,144,304
419,Trey Thompkins\thomptr02,C,21,LAC,24,0,119,24,61,.393,4,13,.308,20,48,.417,.426,5,7,.714,4,20,24,3,3,3,6,10,57
420,Jason Thompson\thompja02,PF,25,SAC,64,47,1657,237,443,.535,0,2,.000,237,441,.537,.535,109,181,.602,166,277,443,79,43,44,68,149,583
421,Klay Thompson\thompkl01,SG,21,GSW,66,29,1608,318,718,.443,111,268,.414,207,450,.460,.520,79,91,.868,24,137,161,133,49,20,103,155,826
422,Mychel Thompson\thompmy02,SG,23,CLE,5,3,95,7,24,.292,4,11,.364,3,13,.231,.375,0,0,,0,5,5,7,2,1,5,8,18
423,Tristan Thompson\thomptr01,PF,20,CLE,60,25,1424,194,442,.439,0,2,.000,194,440,.441,.439,106,192,.552,187,202,389,27,27,62,81,134,494
424,Marcus Thornton\thornma01,SG,24,SAC,51,51,1780,352,803,.438,107,310,.345,245,493,.497,.505,141,163,.865,84,104,188,98,71,12,84,111,952
425,Jamaal Tinsley\tinslja01,PG,33,UTA,37,1,507,57,141,.404,10,37,.270,47,104,.452,.440,13,17,.765,6,39,45,123,17,8,52,47,137
426,Anthony Tolliver\tollian01,SF,26,MIN,51,0,882,71,182,.390,25,101,.248,46,81,.568,.459,41,55,.745,50,103,153,22,18,19,35,86,208
427,Ronny Turiaf\turiaro01,C,29,TOT,17,5,279,19,33,.576,0,1,.000,19,32,.594,.576,13,22,.591,20,50,70,10,14,17,14,39,51
427,Ronny Turiaf\turiaro01,C,29,WAS,4,0,58,3,3,1.000,0,0,,3,3,1.000,1.000,0,0,,1,11,12,5,6,3,6,7,6
427,Ronny Turiaf\turiaro01,C,29,MIA,13,5,221,16,30,.533,0,1,.000,16,29,.552,.533,13,22,.591,19,39,58,5,8,14,8,32,45
428,Hedo Türkoğlu\turkohe01,SF,32,ORL,53,53,1653,209,504,.415,91,258,.353,118,246,.480,.505,67,95,.705,24,175,199,233,45,17,142,139,576
429,Evan Turner\turneev01,SF,23,PHI,65,20,1713,263,590,.446,11,49,.224,252,541,.466,.455,73,108,.676,27,349,376,180,40,20,105,117,610
430,Jeremy Tyler\tylerje01,C,20,GSW,42,23,568,88,209,.421,0,1,.000,88,208,.423,.421,29,52,.558,54,86,140,16,16,20,36,84,205
431,Edwin Ubiles\ubileed01,SF,25,WAS,4,0,52,5,18,.278,1,5,.200,4,13,.308,.306,3,3,1.000,2,8,10,1,1,1,1,1,14
432,Ekpe Udoh\udohek01,C,24,TOT,61,11,1290,127,295,.431,0,2,.000,127,293,.433,.431,86,114,.754,100,154,254,57,40,102,53,174,340
432,Ekpe Udoh\udohek01,C,24,GSW,38,6,827,82,185,.443,0,0,,82,185,.443,.443,46,64,.719,58,89,147,31,25,65,35,115,210
432,Ekpe Udoh\udohek01,C,24,MIL,23,5,463,45,110,.409,0,2,.000,45,108,.417,.409,40,50,.800,42,65,107,26,15,37,18,59,130
433,Beno Udrih\udrihbe01,SG,29,MIL,59,0,1080,146,332,.440,17,59,.288,129,273,.473,.465,39,55,.709,26,76,102,227,37,1,77,69,348
434,Ben Uzoh\uzohbe01,PG,23,TOT,18,8,370,35,99,.354,0,1,.000,35,98,.357,.354,11,19,.579,19,48,67,61,17,3,19,31,81
434,Ben Uzoh\uzohbe01,PG,23,CLE,2,0,13,2,5,.400,0,0,,2,5,.400,.400,0,0,,2,2,4,2,1,0,0,1,4
434,Ben Uzoh\uzohbe01,PG,23,TOR,16,8,357,33,94,.351,0,1,.000,33,93,.355,.351,11,19,.579,17,46,63,59,16,3,19,30,77
435,Anderson Varejão\varejan01,C,29,CLE,25,25,785,114,222,.514,0,4,.000,114,218,.523,.514,43,64,.672,109,178,287,43,35,17,45,62,271
436,Greivis Vásquez\vasqugr01,PG,25,NOH,66,26,1706,225,523,.430,43,135,.319,182,388,.469,.471,96,117,.821,23,150,173,359,60,8,148,126,589
437,Jan Veselý\veselja01,PF,21,WAS,57,20,1078,117,218,.537,0,1,.000,117,217,.539,.537,33,62,.532,101,148,249,47,39,32,60,156,267
438,Charlie Villanueva\villach01,PF,27,DET,13,0,180,35,91,.385,15,45,.333,20,46,.435,.467,6,7,.857,9,39,48,6,7,5,7,25,91
439,Nikola Vučević\vucevni01,C,21,PHI,51,15,812,131,291,.450,3,8,.375,128,283,.452,.455,18,34,.529,88,158,246,31,20,34,33,111,283
440,Dwyane Wade\wadedw01,SG,30,MIA,49,49,1625,416,837,.497,15,56,.268,401,781,.513,.506,235,297,.791,73,164,237,225,82,63,129,110,1082
441,Von Wafer\wafervo01,SG,26,ORL,33,1,469,71,157,.452,14,39,.359,57,118,.483,.497,38,54,.704,6,39,45,29,10,3,35,26,194
442,Henry Walker\walkebi01,SG,24,NYK,32,8,620,68,171,.398,36,113,.319,32,58,.552,.503,17,20,.850,9,71,80,37,19,7,35,84,189
443,Kemba Walker\walkeke02,PG,21,CHA,66,25,1792,281,767,.366,69,226,.305,212,541,.392,.411,168,213,.789,30,204,234,289,60,20,119,79,799
444,John Wall\walljo01,PG,21,WAS,66,66,2386,378,894,.423,3,42,.071,375,852,.440,.424,317,402,.789,48,252,300,530,95,57,255,137,1076
445,Ben Wallace*\wallabe01,C,37,DET,62,11,980,34,86,.395,1,4,.250,33,82,.402,.401,16,47,.340,81,188,269,43,47,51,34,60,85
446,Gerald Wallace\wallage01,SF,29,TOT,58,58,2076,287,632,.454,46,150,.307,241,482,.500,.491,180,225,.800,87,299,386,164,85,36,111,145,800
446,Gerald Wallace\wallage01,SF,29,POR,42,42,1503,203,430,.472,26,98,.265,177,332,.533,.502,125,161,.776,63,214,277,115,62,25,84,107,557
446,Gerald Wallace\wallage01,SF,29,NJN,16,16,573,84,202,.416,20,52,.385,64,150,.427,.465,55,64,.859,24,85,109,49,23,11,27,38,243
447,Luke Walton\waltolu01,PF-SF,31,TOT,30,0,364,24,65,.369,7,20,.350,17,45,.378,.423,0,0,,13,36,49,35,5,1,27,41,55
447,Luke Walton\waltolu01,SF,31,LAL,9,0,65,6,14,.429,0,4,.000,6,10,.600,.429,0,0,,6,8,14,5,2,0,2,9,12
447,Luke Walton\waltolu01,PF,31,CLE,21,0,299,18,51,.353,7,16,.438,11,35,.314,.422,0,0,,7,28,35,30,3,1,25,32,43
448,Hakim Warrick\warriha01,PF,29,PHO,35,0,503,74,180,.411,1,10,.100,73,170,.429,.414,76,99,.768,31,61,92,30,8,3,36,35,225
449,Darryl Watkins\watkida01,C,27,NOH,5,0,98,7,14,.500,0,0,,7,14,.500,.500,9,18,.500,8,19,27,3,5,4,8,14,23
450,C.J. Watson\watsocj01,PG,27,CHI,49,25,1159,161,437,.368,68,173,.393,93,264,.352,.446,84,104,.808,21,84,105,200,45,8,97,103,474
451,Earl Watson\watsoea01,PG,32,UTA,50,2,1033,54,160,.338,10,52,.192,44,108,.407,.369,31,46,.674,30,91,121,217,54,22,85,105,149
452,Martell Webster\webstma02,SF,25,MIN,47,26,1140,115,272,.423,37,109,.339,78,163,.479,.491,57,72,.792,42,126,168,40,31,17,46,86,324
453,David West\westda01,PF,31,IND,66,66,1925,349,716,.487,2,9,.222,347,707,.491,.489,142,176,.807,118,315,433,140,52,46,93,160,842
454,Delonte West\westde01,PG,28,DAL,44,33,1060,166,360,.461,27,76,.355,139,284,.489,.499,62,70,.886,13,88,101,139,58,11,76,67,421
455,Russell Westbrook\westbru01,PG,23,OKC,66,66,2331,578,1266,.457,62,196,.316,516,1070,.482,.481,340,413,.823,96,205,301,362,112,21,239,147,1558
456,D.J. White\whitedj01,PF,25,CHA,58,11,1098,174,353,.493,1,1,1.000,173,352,.491,.494,43,61,.705,50,159,209,47,17,23,43,94,392
457,Hassan Whiteside\whiteha01,C,22,SAC,18,0,109,12,27,.444,0,0,,12,27,.444,.444,5,12,.417,16,23,39,0,3,15,5,12,29
458,Chris Wilcox\wilcoch01,C,29,BOS,28,4,481,64,107,.598,0,0,,64,107,.598,.598,24,39,.615,38,84,122,12,11,9,30,64,152
459,Damien Wilkins\wilkida02,SF,32,DET,60,2,922,76,193,.394,7,23,.304,69,170,.406,.412,34,54,.630,22,78,100,44,29,13,30,85,193
460,Deron Williams\willide01,PG,27,NJN,55,55,1999,391,961,.407,115,342,.336,276,619,.446,.467,257,305,.843,23,160,183,481,67,20,219,121,1154
461,Derrick Williams\willide02,PF,20,MIN,66,15,1418,205,498,.412,37,138,.268,168,360,.467,.449,136,195,.697,77,234,311,38,30,31,77,95,583
462,Elliot Williams\williel01,SG,22,POR,24,0,149,37,74,.500,8,27,.296,29,47,.617,.554,6,18,.333,7,12,19,6,6,3,5,18,88
463,Jordan Williams\willijo03,C,21,NJN,43,5,635,77,152,.507,0,0,,77,152,.507,.507,43,66,.652,66,90,156,11,21,15,23,61,197
464,Lou Williams\willilo02,PG,25,PHI,64,0,1682,318,782,.407,83,229,.362,235,553,.425,.460,237,292,.812,30,125,155,221,53,18,71,90,956
465,Marvin Williams\willima02,SF,25,ATL,57,37,1500,203,470,.432,58,149,.389,145,321,.452,.494,115,146,.788,76,218,294,71,47,18,39,84,579
466,Mo Williams\willima01,SG,29,LAC,52,1,1472,260,611,.426,93,239,.389,167,372,.449,.502,72,80,.900,23,76,99,160,51,7,86,103,685
467,Reggie Williams\willire02,SF,25,CHA,33,13,747,106,255,.416,33,107,.308,73,148,.493,.480,29,40,.725,27,66,93,60,20,3,33,34,274
468,Sean Williams\willise01,C,25,TOT,11,0,107,14,22,.636,0,0,,14,22,.636,.636,12,13,.923,13,12,25,5,4,8,10,18,40
468,Sean Williams\willise01,C,25,DAL,8,0,65,12,16,.750,0,0,,12,16,.750,.750,5,6,.833,9,4,13,2,1,5,7,14,29
468,Sean Williams\willise01,C,25,BOS,3,0,42,2,6,.333,0,0,,2,6,.333,.333,7,7,1.000,4,8,12,3,3,3,3,4,11
469,Shawne Williams\willish03,SF,25,NJN,25,6,514,42,147,.286,21,87,.241,21,60,.350,.357,8,11,.727,20,48,68,16,10,11,13,44,113
470,Shelden Williams\willish02,C,28,NJN,58,35,1276,96,201,.478,0,0,,96,201,.478,.478,76,104,.731,141,209,350,35,47,39,66,149,268
471,Terrence Williams\willite01,SG,24,TOT,30,0,550,85,198,.429,16,46,.348,69,152,.454,.470,27,46,.587,13,89,102,65,20,7,43,35,213
471,Terrence Williams\willite01,SG,24,HOU,12,0,181,20,57,.351,8,19,.421,12,38,.316,.421,6,12,.500,2,26,28,10,4,1,10,16,54
471,Terrence Williams\willite01,SG,24,SAC,18,0,369,65,141,.461,8,27,.296,57,114,.500,.489,21,34,.618,11,63,74,55,16,6,33,19,159
472,Metta World Peace\artesro01,SF,32,LAL,64,45,1720,183,465,.394,56,189,.296,127,276,.460,.454,71,115,.617,71,147,218,140,69,27,69,137,493
473,Brandan Wright\wrighbr03,C,24,DAL,49,0,791,144,233,.618,0,1,.000,144,232,.621,.618,52,82,.634,62,112,174,13,22,63,21,61,340
474,Chris Wright\wrighch01,SF,23,GSW,24,1,186,23,45,.511,0,0,,23,45,.511,.511,24,31,.774,19,26,45,4,7,13,8,22,70
475,Dorell Wright\wrighdo01,SF,26,GSW,61,61,1650,222,526,.422,105,292,.360,117,234,.500,.522,80,98,.816,60,218,278,94,58,26,51,97,629
476,Nick Young\youngni01,SG,26,TOT,62,35,1729,316,784,.403,103,282,.365,213,502,.424,.469,144,169,.852,31,102,133,56,44,17,83,141,879
476,Nick Young\youngni01,SG,26,WAS,40,32,1211,240,591,.406,73,197,.371,167,394,.424,.468,112,130,.862,20,77,97,46,30,11,59,90,665
476,Nick Young\youngni01,SG,26,LAC,22,3,518,76,193,.394,30,85,.353,46,108,.426,.472,32,39,.821,11,25,36,10,14,6,24,51,214
477,Sam Young\youngsa01,SF,26,TOT,35,2,375,45,127,.354,5,17,.294,40,110,.364,.374,19,26,.731,20,42,62,15,17,6,16,23,114
477,Sam Young\youngsa01,SF,26,MEM,21,2,240,32,83,.386,0,9,.000,32,74,.432,.386,10,12,.833,14,27,41,9,11,2,9,12,74
477,Sam Young\youngsa01,SF,26,PHI,14,0,135,13,44,.295,5,8,.625,8,36,.222,.352,9,14,.643,6,15,21,6,6,4,7,11,40
478,Thaddeus Young\youngth01,PF,23,PHI,63,1,1755,348,687,.507,1,4,.250,347,683,.508,.507,111,144,.771,137,188,325,74,64,41,55,127,808