Rk,Player,Pos,Age,Tm,G,GS,MP,FG,FGA,FG%,3P,3PA,3P%,2P,2PA,2P%,eFG%,FT,FTA,FT%,ORB,DRB,TRB,AST,STL,BLK,TOV,PF,PTS
1,Steven Adams\adamsst01,C,26,OKC,63,63,1680,283,478,.592,1,3,.333,282,475,.594,.593,117,201,.582,207,376,583,146,51,67,94,122,684
2,Bam Adebayo\adebaba01,PF,22,MIA,72,72,2417,440,790,.557,2,14,.143,438,776,.564,.558,264,382,.691,176,559,735,368,82,93,204,182,1146
3,LaMarcus Aldridge\aldrila01,C,34,SAS,53,53,1754,391,793,.493,61,157,.389,330,636,.519,.532,158,191,.827,103,289,392,129,36,87,74,128,1001
4,Kyle Alexander\alexaky01,C,23,MIA,2,0,13,1,2,.500,0,0,,1,2,.500,.500,0,0,,2,1,3,0,0,0,1,1,2
5,Nickeil Alexander-Walker\alexani01,SG,21,NOP,47,1,591,98,266,.368,46,133,.346,52,133,.391,.455,25,37,.676,9,75,84,89,17,8,54,57,267
6,Grayson Allen\allengr01,SG,24,MEM,38,0,718,117,251,.466,57,141,.404,60,110,.545,.580,39,45,.867,8,77,85,52,10,2,33,53,330
7,Jarrett Allen\allenja01,C,21,BRK,70,64,1852,302,465,.649,0,6,.000,302,459,.658,.649,171,270,.633,216,455,671,110,40,92,77,162,775
8,Kadeem Allen\allenka01,PG,27,NYK,10,0,117,19,44,.432,5,16,.313,14,28,.500,.489,7,11,.636,2,7,9,21,5,2,8,7,50
9,Al-Farouq Aminu\aminual01,PF,29,ORL,18,2,380,25,86,.291,9,36,.250,16,50,.320,.343,19,29,.655,24,63,87,21,18,8,17,27,78
10,Justin Anderson\anderju01,SG,26,BRK,10,1,107,10,38,.263,6,29,.207,4,9,.444,.342,2,4,.500,1,20,21,8,0,6,4,13,28
11,Kyle Anderson\anderky01,SF,26,MEM,67,28,1330,157,331,.474,24,85,.282,133,246,.541,.511,52,78,.667,58,227,285,162,54,37,66,111,390
12,Ryan Anderson\anderry01,C,31,HOU,2,0,14,2,7,.286,1,5,.200,1,2,.500,.357,0,0,,0,7,7,2,1,0,1,1,5
13,Giannis Antetokounmpo\antetgi01,PF,25,MIL,63,63,1917,685,1238,.553,89,293,.304,596,945,.631,.589,398,629,.633,140,716,856,354,61,66,230,195,1857
14,Kostas Antetokounmpo\antetko01,PF,22,LAL,5,0,20,3,3,1.000,0,0,,3,3,1.000,1.000,1,2,.500,2,1,3,2,0,0,1,2,7
15,Thanasis Antetokounmpo\antetth01,SF,27,MIL,20,2,129,24,48,.500,0,10,.000,24,38,.632,.500,7,17,.412,12,12,24,15,7,2,12,18,55
16,Carmelo Anthony\anthoca01,PF,35,POR,58,58,1902,336,782,.430,87,226,.385,249,556,.448,.485,136,161,.845,71,297,368,85,49,27,100,171,895
17,OG Anunoby\anunoog01,SF,22,TOR,69,68,2066,286,566,.505,89,228,.390,197,338,.583,.584,72,102,.706,80,284,364,108,96,45,79,167,733
18,Ryan Arcidiacono\arcidry01,PG,25,CHI,58,4,930,90,220,.409,54,138,.391,36,82,.439,.532,27,38,.711,20,90,110,96,27,3,37,96,261
19,Trevor Ariza\arizatr01,SF,34,TOT,53,21,1493,142,324,.438,77,207,.372,65,117,.556,.557,62,74,.838,34,212,246,91,69,15,56,111,423
19,Trevor Ariza\arizatr01,SF,34,SAC,32,0,791,64,165,.388,43,122,.352,21,43,.488,.518,21,27,.778,21,125,146,50,35,7,28,63,192
19,Trevor Ariza\arizatr01,SF,34,POR,21,21,702,78,159,.491,34,85,.400,44,74,.595,.597,41,47,.872,13,87,100,41,34,8,28,48,231
20,D.J. Augustin\augusdj01,PG,32,ORL,57,13,1420,184,461,.399,70,201,.348,114,260,.438,.475,161,181,.890,22,100,122,262,34,1,86,72,599
21,Deandre Ayton\aytonde01,C,21,PHO,38,32,1236,310,568,.546,3,13,.231,307,555,.553,.548,67,89,.753,147,289,436,72,26,58,80,117,690
22,Dwayne Bacon\bacondw01,SG,24,CHO,39,11,687,85,244,.348,19,67,.284,66,177,.373,.387,35,53,.660,15,85,100,52,23,2,37,52,224
23,Marvin Bagley III\baglema01,C,20,SAC,13,6,334,78,167,.467,4,22,.182,74,145,.510,.479,25,31,.806,29,68,97,10,6,12,18,43,185
24,Lonzo Ball\balllo01,PG,22,NOP,63,54,2025,277,687,.403,148,395,.375,129,292,.442,.511,43,76,.566,71,312,383,438,88,38,193,128,745
25,Mo Bamba\bambamo01,C,21,ORL,62,0,878,132,286,.462,37,107,.346,95,179,.531,.526,31,46,.674,100,202,302,42,23,86,42,116,332
26,J.J. Barea\bareajo01,PG,35,DAL,29,6,450,85,207,.411,32,85,.376,53,122,.434,.488,20,22,.909,10,43,53,112,5,2,38,27,222
27,Harrison Barnes\barneha02,PF,27,SAC,72,72,2482,365,793,.460,102,268,.381,263,525,.501,.525,214,267,.801,77,278,355,159,43,12,88,93,1046
28,RJ Barrett\barrerj01,SG,19,NYK,56,55,1704,292,727,.402,63,197,.320,229,530,.432,.445,156,254,.614,50,229,279,143,55,17,124,122,803
29,Will Barton\bartowi01,SF,29,DEN,58,58,1916,332,738,.450,108,288,.375,224,450,.498,.523,102,133,.767,76,289,365,212,61,29,88,121,874
30,Keita Bates-Diop\bateske01,PF-SF,24,TOT,44,0,744,100,234,.427,34,103,.330,66,131,.504,.500,54,75,.720,25,102,127,30,19,24,17,43,288
30,Keita Bates-Diop\bateske01,PF,24,MIN,37,0,646,87,206,.422,31,94,.330,56,112,.500,.498,46,65,.708,21,89,110,30,17,20,14,36,251
30,Keita Bates-Diop\bateske01,SF,24,DEN,7,0,98,13,28,.464,3,9,.333,10,19,.526,.518,8,10,.800,4,13,17,0,2,4,3,7,37
31,Nicolas Batum\batumni01,SF,31,CHO,22,3,505,28,81,.346,14,49,.286,14,32,.438,.432,9,10,.900,25,75,100,66,17,8,22,41,79
32,Aron Baynes\baynear01,C,33,PHO,42,28,934,183,381,.480,59,168,.351,124,213,.582,.558,56,75,.747,71,166,237,67,10,23,50,141,481
33,Kent Bazemore\bazemke01,SF,30,TOT,68,21,1688,200,534,.375,84,244,.344,116,290,.400,.453,113,147,.769,27,267,294,93,74,40,91,196,597
33,Kent Bazemore\bazemke01,SF,30,POR,43,21,1111,113,326,.347,56,171,.327,57,155,.368,.433,58,72,.806,13,159,172,61,45,31,60,121,340
33,Kent Bazemore\bazemke01,SF,30,SAC,25,0,577,87,208,.418,28,73,.384,59,135,.437,.486,55,75,.733,14,108,122,32,29,9,31,75,257
34,Darius Bazley\bazleda01,PF,19,OKC,61,9,1130,125,317,.394,49,141,.348,76,176,.432,.472,43,62,.694,30,216,246,41,23,41,45,55,342
35,Bradley Beal\bealbr01,SG,26,WAS,57,57,2053,593,1303,.455,170,481,.353,423,822,.515,.520,385,457,.842,52,190,242,347,71,23,194,126,1741
36,Malik Beasley\beaslma01,SG,23,TOT,55,14,1209,227,534,.425,107,276,.388,120,258,.465,.525,54,66,.818,18,130,148,75,40,8,57,77,615
36,Malik Beasley\beaslma01,SG,23,DEN,41,0,746,117,301,.389,58,161,.360,59,140,.421,.485,33,38,.868,9,68,77,48,31,6,36,50,325
36,Malik Beasley\beaslma01,SG,23,MIN,14,14,463,110,233,.472,49,115,.426,61,118,.517,.577,21,28,.750,9,62,71,27,9,2,21,27,290
37,Marco Belinelli\belinma01,SG,33,SAS,57,0,883,123,314,.392,67,178,.376,56,136,.412,.498,48,58,.828,7,92,99,69,12,1,19,45,361
38,Jordan Bell\belljo01,C,25,TOT,29,0,256,35,67,.522,4,12,.333,31,55,.564,.552,19,31,.613,30,51,81,16,3,10,21,19,93
38,Jordan Bell\belljo01,C,25,MIN,27,0,235,32,60,.533,2,9,.222,30,51,.588,.550,17,29,.586,28,50,78,14,2,10,18,17,83
38,Jordan Bell\belljo01,C,25,MEM,2,0,21,3,7,.429,2,3,.667,1,4,.250,.571,2,2,1.000,2,1,3,2,1,0,3,2,10
39,DeAndre' Bembry\bembrde01,SG,25,ATL,43,4,915,104,228,.456,15,65,.231,89,163,.546,.489,26,48,.542,34,118,152,81,55,19,60,84,249
40,Dragan Bender\bendedr01,PF-C,22,TOT,16,3,286,41,92,.446,15,43,.349,26,49,.531,.527,10,14,.714,16,57,73,28,4,9,21,42,107
40,Dragan Bender\bendedr01,C,22,MIL,7,0,91,10,21,.476,4,9,.444,6,12,.500,.571,2,3,.667,0,20,20,9,0,5,5,16,26
40,Dragan Bender\bendedr01,PF,22,GSW,9,3,195,31,71,.437,11,34,.324,20,37,.541,.514,8,11,.727,16,37,53,19,4,4,16,26,81
41,Dāvis Bertāns\bertada01,PF,27,WAS,54,4,1583,265,610,.434,200,472,.424,65,138,.471,.598,104,122,.852,35,210,245,92,37,33,59,139,834
42,Patrick Beverley\beverpa01,PG,31,LAC,51,50,1342,147,341,.431,80,206,.388,67,135,.496,.548,31,47,.660,57,209,266,183,54,25,66,156,405
43,Khem Birch\birchkh01,C,27,ORL,48,24,922,73,143,.510,0,1,.000,73,142,.514,.510,66,101,.653,91,129,220,50,20,23,31,91,212
44,Goga Bitadze\bitadgo01,C,20,IND,54,2,471,70,150,.467,8,42,.190,62,108,.574,.493,24,33,.727,25,81,106,23,10,37,28,65,172
45,Bismack Biyombo\biyombi01,C,27,CHO,53,29,1029,151,278,.543,0,0,,151,278,.543,.543,91,151,.603,120,188,308,50,10,49,48,116,393
46,Nemanja Bjelica\bjeline01,PF,31,SAC,72,67,2011,314,653,.481,134,320,.419,180,333,.541,.583,69,84,.821,111,347,458,203,62,40,99,216,831
47,Eric Bledsoe\bledser01,PG,30,MIL,61,61,1646,334,703,.475,74,215,.344,260,488,.533,.528,169,214,.790,43,239,282,328,57,26,148,128,911
48,Bogdan Bogdanović\bogdabo01,SG,27,SAC,61,28,1766,337,766,.440,164,441,.372,173,325,.532,.547,86,116,.741,26,181,207,207,64,15,102,133,924
49,Bojan Bogdanović\bogdabo02,SF,30,UTA,63,63,2083,418,935,.447,189,457,.414,229,478,.479,.548,250,277,.903,39,220,259,131,34,7,159,110,1275
50,Bol Bol\bolbo01,PF,20,DEN,7,0,87,14,28,.500,4,9,.444,10,19,.526,.571,8,10,.800,5,14,19,6,2,6,10,11,40
51,Jonah Bolden\boldejo01,C,24,TOT,7,0,47,4,11,.364,0,4,.000,4,7,.571,.364,2,4,.500,3,6,9,0,3,2,2,10,10
51,Jonah Bolden\boldejo01,C,24,PHI,4,0,14,2,3,.667,0,1,.000,2,2,1.000,.667,0,2,.000,0,1,1,0,1,0,2,4,4
51,Jonah Bolden\boldejo01,C,24,PHO,3,0,33,2,8,.250,0,3,.000,2,5,.400,.250,2,2,1.000,3,5,8,0,2,2,0,6,6
52,Marques Bolden\boldema01,C,21,CLE,1,0,3,0,0,,0,0,,0,0,,,0,0,,0,2,2,0,1,0,0,1,0
53,Jordan Bone\bonejo01,PG,22,DET,10,0,53,5,20,.250,2,10,.200,3,10,.300,.300,0,0,,0,4,4,8,1,0,2,6,12
54,Isaac Bonga\bongais01,SF,20,WAS,66,49,1250,118,234,.504,25,71,.352,93,163,.571,.558,69,85,.812,71,151,222,76,45,22,58,156,330
55,Devin Booker\bookede01,SG,23,PHO,70,70,2512,627,1283,.489,141,398,.354,486,885,.549,.544,468,509,.919,29,268,297,456,49,18,264,213,1863
56,Chris Boucher\bouchch01,C,27,TOR,62,0,819,141,299,.472,38,118,.322,103,181,.569,.535,91,116,.784,107,170,277,26,22,61,28,114,411
57,Brian Bowen\bowenbr02,SF,21,IND,6,1,31,3,10,.300,0,2,.000,3,8,.375,.300,0,0,,1,6,7,0,0,1,1,3,6
58,Ky Bowman\bowmaky01,PG,22,GSW,45,12,1015,134,321,.417,33,107,.308,101,214,.472,.469,34,41,.829,24,97,121,131,44,10,70,102,335
59,Avery Bradley\bradlav01,SG,29,LAL,49,44,1186,170,383,.444,63,173,.364,107,210,.510,.526,20,24,.833,18,97,115,63,43,5,47,110,423
60,Tony Bradley\bradlto01,C,22,UTA,58,3,663,126,189,.667,3,3,1.000,123,186,.661,.675,30,46,.652,111,156,267,23,14,33,30,115,285
61,Jarrell Brantley\brantja01,PF,23,UTA,9,0,96,10,28,.357,3,13,.231,7,15,.467,.411,1,2,.500,2,18,20,11,3,5,7,7,24
62,Ignas Brazdeikis\brazdig01,SF,21,NYK,9,0,53,6,22,.273,1,9,.111,5,13,.385,.295,4,5,.800,2,3,5,4,0,1,2,3,17
63,Corey Brewer\breweco01,PF,33,SAC,5,0,33,2,4,.500,0,1,.000,2,3,.667,.500,1,3,.333,2,6,8,2,4,0,2,7,5
64,Mikal Bridges\bridgmi01,SF,23,PHO,73,32,2042,247,484,.510,70,194,.361,177,290,.610,.583,103,122,.844,66,226,292,129,102,46,73,163,667
65,Miles Bridges\bridgmi02,SF,21,CHO,65,64,1995,319,753,.424,99,300,.330,220,453,.486,.489,106,131,.809,88,274,362,114,40,48,95,132,843
66,Oshae Brissett\brissos01,SF,21,TOR,19,0,135,13,36,.361,3,15,.200,10,21,.476,.403,8,10,.800,9,17,26,7,4,1,7,18,37
67,Ryan Broekhoff\broekry01,SF,29,DAL,17,1,180,22,59,.373,20,51,.392,2,8,.250,.542,7,8,.875,5,38,43,11,5,4,6,15,71
68,Malcolm Brogdon\brogdma01,PG,27,IND,54,54,1666,326,744,.438,75,230,.326,251,514,.488,.489,166,186,.892,46,216,262,381,35,10,131,98,893
69,Dillon Brooks\brookdi01,SG,24,MEM,73,73,2112,435,1068,.407,147,411,.358,288,657,.438,.476,164,203,.808,68,175,243,150,63,27,124,278,1181
70,Bruce Brown\brownbr01,PG,23,DET,58,43,1634,198,447,.443,33,96,.344,165,351,.470,.480,88,119,.739,61,213,274,230,63,29,100,162,517
71,Charlie Brown Jr.\brownch02,SG,22,ATL,10,0,40,6,19,.316,3,9,.333,3,10,.300,.395,5,5,1.000,2,2,4,2,2,2,3,3,20
72,Jaylen Brown\brownja02,SG,23,BOS,57,57,1934,427,887,.481,129,338,.382,298,549,.543,.554,176,243,.724,62,302,364,118,65,20,125,167,1159
73,Moses Brown\brownmo01,C,20,POR,9,0,33,4,10,.400,0,0,,4,10,.400,.400,3,8,.375,3,11,14,1,1,1,3,7,11
74,Sterling Brown\brownst02,SF,24,MIL,52,1,767,95,256,.371,44,136,.324,51,120,.425,.457,32,40,.800,31,152,183,51,29,7,42,54,266
75,Troy Brown Jr.\browntr01,SF,20,WAS,69,22,1782,273,622,.439,61,179,.341,212,443,.479,.488,109,139,.784,76,307,383,178,85,7,79,132,716
76,Jalen Brunson\brunsja01,PG,23,DAL,57,16,1022,181,388,.466,43,120,.358,138,268,.515,.522,61,75,.813,22,112,134,188,22,4,66,74,466
77,Thomas Bryant\bryanth01,C,22,WAS,46,36,1147,243,418,.581,37,91,.407,206,327,.630,.626,86,116,.741,98,233,331,83,25,49,53,103,609
78,Reggie Bullock\bullore01,SG,28,NYK,29,19,684,90,224,.402,37,111,.333,53,113,.469,.484,17,21,.810,13,55,68,42,25,3,19,56,234
79,Trey Burke\burketr01,PG,27,TOT,33,1,520,94,209,.450,32,75,.427,62,134,.463,.526,23,29,.793,16,34,50,83,16,2,21,33,243
79,Trey Burke\burketr01,PG,27,PHI,25,0,329,59,127,.465,16,38,.421,43,89,.483,.528,13,18,.722,15,20,35,53,7,1,12,21,147
79,Trey Burke\burketr01,PG,27,DAL,8,1,191,35,82,.427,16,37,.432,19,45,.422,.524,10,11,.909,1,14,15,30,9,1,9,12,96
80,Alec Burks\burksal01,SF-SG,28,TOT,66,19,1754,321,768,.418,116,301,.385,205,467,.439,.493,235,265,.887,48,234,282,189,62,17,91,128,993
80,Alec Burks\burksal01,SF,28,GSW,48,18,1390,244,601,.406,84,224,.375,160,377,.424,.476,201,224,.897,37,189,226,151,50,17,76,107,773
80,Alec Burks\burksal01,SG,28,PHI,18,1,364,77,167,.461,32,77,.416,45,90,.500,.557,34,41,.829,11,45,56,38,12,0,15,21,220
81,Deonte Burton\burtode02,SF,26,OKC,39,0,356,43,125,.344,10,53,.189,33,72,.458,.384,8,14,.571,7,50,57,17,7,10,19,34,104
82,Jimmy Butler\butleji01,SF,30,MIA,58,58,1959,345,758,.455,29,119,.244,316,639,.495,.474,438,525,.834,106,280,386,350,103,32,127,81,1157
83,Bruno Caboclo\cabocbr01,C,24,TOT,30,0,244,38,89,.427,6,33,.182,32,56,.571,.461,8,9,.889,23,37,60,12,15,17,13,31,90
83,Bruno Caboclo\cabocbr01,C,24,MEM,22,0,192,28,69,.406,4,25,.160,24,44,.545,.435,2,3,.667,17,27,44,10,10,12,7,23,62
83,Bruno Caboclo\cabocbr01,C,24,HOU,8,0,52,10,20,.500,2,8,.250,8,12,.667,.550,6,6,1.000,6,10,16,2,5,5,6,8,28
84,Devontae Cacok\cacokde01,C,23,LAL,1,0,9,3,6,.500,0,0,,3,6,.500,.500,0,0,,2,3,5,1,0,0,0,0,6
85,Kentavious Caldwell-Pope\caldwke01,SG,26,LAL,69,26,1762,237,507,.467,92,239,.385,145,268,.541,.558,79,102,.775,38,104,142,111,57,14,62,128,645
86,Vlatko Čančar\cancavl01,PF,22,DEN,14,0,45,6,15,.400,1,6,.167,5,9,.556,.433,4,4,1.000,5,5,10,3,1,1,3,7,17
87,Clint Capela\capelca01,C,25,HOU,39,39,1279,244,388,.629,0,0,,244,388,.629,.629,55,104,.529,168,369,537,48,33,72,63,102,543
88,DeMarre Carroll\carrode01,SF-C,33,TOT,24,0,290,25,66,.379,8,33,.242,17,33,.515,.439,29,42,.690,12,43,55,25,8,5,17,32,87
88,DeMarre Carroll\carrode01,SF,33,SAS,15,0,135,9,29,.310,3,13,.231,6,16,.375,.362,12,20,.600,7,24,31,11,2,2,10,20,33
88,DeMarre Carroll\carrode01,C,33,HOU,9,0,155,16,37,.432,5,20,.250,11,17,.647,.500,17,22,.773,5,19,24,14,6,3,7,12,54
89,Jevon Carter\carteje01,PG,24,PHO,58,2,945,101,243,.416,62,146,.425,39,97,.402,.543,23,27,.852,30,88,118,84,47,17,32,86,287
90,Vince Carter\cartevi01,PF,43,ATL,60,0,876,107,304,.352,61,202,.302,46,102,.451,.452,23,29,.793,18,106,124,48,23,25,33,90,298
91,Wendell Carter Jr.\cartewe01,C,20,CHI,43,43,1256,183,343,.534,6,29,.207,177,314,.564,.542,112,152,.737,139,266,405,51,33,36,72,162,484
92,Michael Carter-Williams\cartemi01,SG,28,ORL,45,0,833,111,260,.427,22,75,.293,89,185,.481,.469,79,95,.832,46,101,147,109,49,22,52,87,323
93,Alex Caruso\carusal01,PG,25,LAL,64,2,1175,120,291,.412,40,120,.333,80,171,.468,.481,69,94,.734,17,106,123,124,70,18,53,98,349
94,Willie Cauley-Stein\caulewi01,C,26,TOT,54,39,1097,175,302,.579,0,1,.000,175,301,.581,.579,40,66,.606,84,231,315,70,49,61,40,121,390
94,Willie Cauley-Stein\caulewi01,C,26,GSW,41,37,940,144,257,.560,0,0,,144,257,.560,.560,35,57,.614,71,184,255,60,45,50,35,102,323
94,Willie Cauley-Stein\caulewi01,C,26,DAL,13,2,157,31,45,.689,0,1,.000,31,44,.705,.689,5,9,.556,13,47,60,10,4,11,5,19,67
95,Tyson Chandler\chandty01,C,37,HOU,26,5,219,14,18,.778,0,0,,14,18,.778,.778,6,13,.462,25,41,66,6,6,8,8,32,34
96,Wilson Chandler\chandwi01,PF,32,BRK,35,3,734,74,183,.404,37,121,.306,37,62,.597,.505,20,23,.870,11,134,145,39,16,12,34,79,205
97,Joe Chealey\chealjo01,PG,24,CHO,4,0,33,0,7,.000,0,4,.000,0,3,.000,.000,2,2,1.000,0,0,0,1,4,0,2,2,2
98,Zylan Cheatham\cheatzy01,PF,24,NOP,4,0,51,6,9,.667,0,1,.000,6,8,.750,.667,0,0,,3,6,9,3,1,1,4,10,12
99,Chris Chiozza\chiozch01,PG,24,TOT,28,2,401,55,140,.393,27,72,.375,28,68,.412,.489,5,5,1.000,9,44,53,83,21,4,32,37,142
99,Chris Chiozza\chiozch01,PG,24,WAS,10,0,123,10,34,.294,7,16,.438,3,18,.167,.397,0,0,,0,15,15,28,10,2,9,12,27
99,Chris Chiozza\chiozch01,PG,24,BRK,18,2,278,45,106,.425,20,56,.357,25,50,.500,.519,5,5,1.000,9,29,38,55,11,2,23,25,115
100,Marquese Chriss\chrisma01,PF,22,GSW,59,21,1196,210,385,.545,8,39,.205,202,346,.584,.556,120,156,.769,114,251,365,114,39,62,78,122,548
101,Gary Clark\clarkga01,SF-PF,25,TOT,42,5,567,54,133,.406,39,111,.351,15,22,.682,.553,9,10,.900,37,73,110,17,6,22,10,46,156
101,Gary Clark\clarkga01,PF,25,HOU,18,0,212,23,59,.390,18,51,.353,5,8,.625,.542,6,7,.857,11,29,40,12,2,7,2,21,70
101,Gary Clark\clarkga01,SF,25,ORL,24,5,355,31,74,.419,21,60,.350,10,14,.714,.561,3,3,1.000,26,44,70,5,4,15,8,25,86
102,Brandon Clarke\clarkbr01,PF,23,MEM,58,4,1300,296,479,.618,23,64,.359,273,415,.658,.642,85,112,.759,92,253,345,81,32,48,55,100,700
103,Jordan Clarkson\clarkjo01,SG,27,TOT,71,2,1705,394,867,.454,152,413,.368,242,454,.533,.542,138,165,.836,50,137,187,136,46,16,97,108,1078
103,Jordan Clarkson\clarkjo01,SG,27,CLE,29,0,666,144,326,.442,59,159,.371,85,167,.509,.532,76,86,.884,21,48,69,70,17,8,39,33,423
103,Jordan Clarkson\clarkjo01,SG,27,UTA,42,2,1039,250,541,.462,93,254,.366,157,287,.547,.548,62,79,.785,29,89,118,66,29,8,58,75,655
104,Nic Claxton\claxtni01,C,20,BRK,15,0,187,27,48,.563,1,7,.143,26,41,.634,.573,11,21,.524,19,25,44,16,1,8,9,14,66
105,Chris Clemons\clemoch01,SG,22,HOU,33,0,291,57,142,.401,37,107,.346,20,35,.571,.532,10,11,.909,4,26,30,27,9,6,19,26,161
106,Antonius Cleveland\clevean01,SG,25,DAL,11,0,46,4,14,.286,0,3,.000,4,11,.364,.286,3,5,.600,2,5,7,1,1,3,2,8,11
107,Amir Coffey\coffeam01,SG,22,LAC,18,1,159,23,54,.426,6,19,.316,17,35,.486,.481,6,11,.545,4,12,16,14,5,2,8,20,58
108,John Collins\collijo01,PF,22,ATL,41,41,1363,353,605,.583,59,147,.401,294,458,.642,.632,120,150,.800,116,300,416,60,31,66,75,138,885
109,Zach Collins\colliza01,PF,22,POR,11,11,290,32,68,.471,7,19,.368,25,49,.510,.522,6,8,.750,25,44,69,16,5,5,14,36,77
110,Mike Conley\conlemi01,PG,32,UTA,47,41,1363,232,567,.409,96,256,.375,136,311,.437,.494,115,139,.827,33,118,151,208,36,5,92,104,675
111,Pat Connaughton\connapa01,SG,27,MIL,67,4,1243,137,301,.455,55,166,.331,82,135,.607,.547,31,40,.775,60,224,284,107,25,31,52,70,360
112,Quinn Cook\cookqu01,PG,26,LAL,44,1,508,91,214,.425,31,85,.365,60,129,.465,.498,11,14,.786,11,40,51,49,12,2,33,27,224
113,Tyler Cook\cookty01,PF-SF,22,TOT,13,0,54,8,12,.667,0,0,,8,12,.667,.667,7,8,.875,6,8,14,1,3,0,3,5,23
113,Tyler Cook\cookty01,PF,22,CLE,11,0,35,7,10,.700,0,0,,7,10,.700,.700,5,6,.833,4,6,10,1,1,0,1,4,19
113,Tyler Cook\cookty01,SF,22,DEN,2,0,19,1,2,.500,0,0,,1,2,.500,.500,2,2,1.000,2,2,4,0,2,0,2,1,4
114,Robert Covington\covinro01,PF-C,29,TOT,70,68,2137,305,723,.422,161,480,.335,144,243,.593,.533,99,124,.798,63,400,463,88,115,93,103,220,870
114,Robert Covington\covinro01,PF,29,MIN,48,47,1411,216,496,.435,108,312,.346,108,184,.587,.544,75,94,.798,36,251,287,56,80,45,73,148,615
114,Robert Covington\covinro01,C,29,HOU,22,21,726,89,227,.392,53,168,.315,36,59,.610,.509,24,30,.800,27,149,176,32,35,48,30,72,255
115,Allen Crabbe\crabbal01,SG-SF,27,TOT,37,1,653,63,177,.356,36,119,.303,27,58,.466,.458,10,14,.714,11,66,77,33,15,4,17,47,172
115,Allen Crabbe\crabbal01,SG,27,ATL,28,1,522,52,143,.364,30,93,.323,22,50,.440,.469,9,12,.750,10,55,65,28,15,4,12,36,143
115,Allen Crabbe\crabbal01,SF,27,MIN,9,0,131,11,34,.324,6,26,.231,5,8,.625,.412,1,2,.500,1,11,12,5,0,0,5,11,29
116,Torrey Craig\craigto01,SF,29,DEN,58,27,1072,124,269,.461,45,138,.326,79,131,.603,.545,22,36,.611,63,126,189,47,23,36,25,135,315
117,Jamal Crawford\crawfja01,SG,39,BRK,1,0,6,2,4,.500,1,2,.500,1,2,.500,.625,0,0,,0,0,0,3,0,0,0,1,5
118,Jae Crowder\crowdja01,SF-PF,29,TOT,65,53,1875,226,563,.401,135,394,.343,91,169,.538,.521,97,125,.776,52,332,384,161,72,24,69,143,684
118,Jae Crowder\crowdja01,SF,29,MEM,45,45,1322,147,399,.368,78,266,.293,69,133,.519,.466,75,95,.789,40,237,277,125,47,14,54,85,447
118,Jae Crowder\crowdja01,PF,29,MIA,20,8,553,79,164,.482,57,128,.445,22,36,.611,.655,22,30,.733,12,95,107,36,25,10,15,58,237
119,Jarrett Culver\culveja01,SG,20,MIN,63,35,1506,230,569,.404,66,221,.299,164,348,.471,.462,54,117,.462,70,142,212,110,57,38,81,125,580
120,Seth Curry\curryse01,SG,29,DAL,64,25,1576,284,574,.495,145,321,.452,139,253,.549,.621,80,97,.825,27,118,145,124,38,9,62,113,793
121,Stephen Curry\curryst01,PG,31,GSW,5,5,139,33,82,.402,12,49,.245,21,33,.636,.476,26,26,1.000,4,22,26,33,5,2,16,11,104
122,Troy Daniels\danietr01,SG,28,TOT,47,0,532,72,186,.387,46,132,.348,26,54,.481,.511,10,16,.625,12,40,52,17,11,3,12,37,200
122,Troy Daniels\danietr01,SG,28,LAL,41,0,456,62,158,.392,40,112,.357,22,46,.478,.519,10,16,.625,12,34,46,14,8,3,9,30,174
122,Troy Daniels\danietr01,SG,28,DEN,6,0,76,10,28,.357,6,20,.300,4,8,.500,.464,0,0,,0,6,6,3,3,0,3,7,26
123,Anthony Davis\davisan02,PF,26,LAL,62,62,2131,551,1096,.503,72,218,.330,479,878,.546,.536,444,525,.846,142,435,577,200,91,143,154,156,1618
124,Ed Davis\davised01,C,30,UTA,28,1,303,22,46,.478,0,0,,22,46,.478,.478,7,14,.500,35,70,105,12,11,9,13,61,51
125,Terence Davis\daviste02,SG,22,TOR,72,4,1209,199,436,.456,94,242,.388,105,194,.541,.564,51,59,.864,50,187,237,115,39,14,76,124,543
126,Dewayne Dedmon\dedmode01,C,30,TOT,44,18,774,102,255,.400,22,107,.206,80,148,.541,.443,30,36,.833,60,189,249,22,25,41,57,133,256
126,Dewayne Dedmon\dedmode01,C,30,SAC,34,10,541,69,171,.404,14,71,.197,55,100,.550,.444,23,28,.821,46,121,167,15,15,26,47,93,175
126,Dewayne Dedmon\dedmode01,C,30,ATL,10,8,233,33,84,.393,8,36,.222,25,48,.521,.440,7,8,.875,14,68,82,7,10,15,10,40,81
127,Matthew Dellavedova\dellama01,PG,29,CLE,57,4,821,62,175,.354,21,91,.231,41,84,.488,.414,32,37,.865,18,57,75,180,20,2,59,78,177
128,DeMar DeRozan\derozde01,SF,30,SAS,68,68,2316,557,1049,.531,9,35,.257,548,1014,.540,.535,381,451,.845,44,331,375,380,70,20,164,180,1504
129,Cheick Diallo\diallch01,C,23,PHO,47,2,479,92,142,.648,1,3,.333,91,139,.655,.651,34,39,.872,30,101,131,22,11,12,32,55,219
130,Hamidou Diallo\diallha01,SF,21,OKC,46,3,896,132,296,.446,16,57,.281,116,239,.485,.473,38,63,.603,44,123,167,36,37,9,51,101,318
131,Gorgui Dieng\dienggo01,C,30,TOT,63,17,1096,166,364,.456,54,152,.355,112,212,.528,.530,78,101,.772,91,263,354,73,51,59,60,124,464
131,Gorgui Dieng\dienggo01,C,30,MIN,46,17,778,124,277,.448,46,120,.383,78,157,.497,.531,47,59,.797,73,183,256,58,37,42,44,89,341
131,Gorgui Dieng\dienggo01,C,30,MEM,17,0,318,42,87,.483,8,32,.250,34,55,.618,.529,31,42,.738,18,80,98,15,14,17,16,35,123
132,Spencer Dinwiddie\dinwisp01,PG,26,BRK,64,49,1994,424,1021,.415,123,400,.308,301,621,.485,.476,347,446,.778,32,189,221,432,40,21,174,180,1318
133,Donte DiVincenzo\divindo01,SG,23,MIL,66,24,1520,232,510,.455,83,247,.336,149,263,.567,.536,63,86,.733,66,252,318,154,85,20,90,113,610
134,Luka Dončić\doncilu01,PG,20,DAL,61,61,2047,581,1255,.463,171,541,.316,410,714,.574,.531,426,562,.758,78,495,573,538,62,14,260,153,1759
135,Luguentz Dort\dortlu01,SF,20,OKC,36,28,820,86,218,.394,30,101,.297,56,117,.479,.463,42,53,.792,24,57,81,27,31,4,22,97,244
136,Damyean Dotson\dotsoda01,SG,25,NYK,48,0,836,120,290,.414,59,163,.362,61,127,.480,.516,22,33,.667,10,81,91,57,23,4,21,44,321
137,Sekou Doumbouya\doumbse01,PF,19,DET,38,19,754,92,236,.390,28,98,.286,64,138,.464,.449,31,46,.674,20,98,118,19,20,8,35,80,243
138,PJ Dozier\doziepj01,SG,23,DEN,29,0,412,65,157,.414,17,49,.347,48,108,.444,.468,21,29,.724,10,45,55,63,14,6,27,45,168
139,Goran Dragić\dragigo01,PG,33,MIA,59,3,1663,319,724,.441,124,338,.367,195,386,.505,.526,191,246,.776,29,158,187,301,40,10,144,124,953
140,Andre Drummond\drumman01,C,26,TOT,57,56,1879,418,784,.533,5,35,.143,413,749,.551,.536,169,294,.575,250,614,864,152,109,93,203,201,1010
140,Andre Drummond\drumman01,C,26,DET,49,48,1654,360,679,.530,1,21,.048,359,658,.546,.531,149,255,.584,226,549,775,138,97,82,174,176,870
140,Andre Drummond\drumman01,C,26,CLE,8,8,225,58,105,.552,4,14,.286,54,91,.593,.571,20,39,.513,24,65,89,14,12,11,29,25,140
141,Jared Dudley\dudleja01,PF,34,LAL,45,1,364,24,60,.400,18,42,.429,6,18,.333,.550,2,2,1.000,6,46,52,28,15,3,8,41,68
142,Kris Dunn\dunnkr01,PG,25,CHI,51,32,1269,152,342,.444,29,112,.259,123,230,.535,.487,40,54,.741,23,163,186,173,101,17,68,158,373
143,Carsen Edwards\edwarca01,SG,21,BOS,37,0,351,42,128,.328,24,76,.316,18,52,.346,.422,13,19,.684,6,41,47,24,12,4,15,34,121
144,Henry Ellenson\ellenhe01,C,23,BRK,5,0,15,1,7,.143,0,4,.000,1,3,.333,.143,0,0,,2,4,6,1,0,0,0,1,2
145,Wayne Ellington\ellinwa01,SG,32,NYK,36,1,558,61,174,.351,50,143,.350,11,31,.355,.494,11,13,.846,4,61,65,44,13,4,18,41,183
146,Joel Embiid\embiijo01,C,25,PHI,51,51,1506,382,801,.477,57,172,.331,325,629,.517,.512,351,435,.807,141,452,593,152,45,65,159,174,1172
147,James Ennis III\ennisja01,SF-SG,29,TOT,69,18,1265,160,359,.446,55,169,.325,105,190,.553,.522,79,98,.806,71,174,245,63,35,22,58,137,454
147,James Ennis III\ennisja01,SF,29,PHI,49,0,776,100,226,.442,37,106,.349,63,120,.525,.524,48,61,.787,48,102,150,41,23,14,31,85,285
147,James Ennis III\ennisja01,SG,29,ORL,20,18,489,60,133,.451,18,63,.286,42,70,.600,.519,31,37,.838,23,72,95,22,12,8,27,52,169
148,Drew Eubanks\eubandr01,C,22,SAS,22,3,272,43,67,.642,1,1,1.000,42,66,.636,.649,20,26,.769,28,57,85,15,5,17,21,37,107
149,Jacob Evans\evansja02,SG,22,TOT,29,1,418,45,134,.336,13,39,.333,32,95,.337,.384,25,29,.862,9,32,41,31,11,12,25,41,128
149,Jacob Evans\evansja02,SG,22,GSW,27,1,414,45,133,.338,13,38,.342,32,95,.337,.387,25,29,.862,9,32,41,31,11,12,25,41,128
149,Jacob Evans\evansja02,SG,22,MIN,2,0,4,0,1,.000,0,1,.000,0,0,,.000,0,0,,0,0,0,0,0,0,0,0,0
150,Dante Exum\exumda01,SG,24,TOT,35,1,485,56,119,.471,15,43,.349,41,76,.539,.534,32,43,.744,12,55,67,40,13,8,31,38,159
150,Dante Exum\exumda01,SG,24,UTA,11,0,83,10,23,.435,2,6,.333,8,17,.471,.478,2,2,1.000,3,9,12,7,1,2,10,8,24
150,Dante Exum\exumda01,SG,24,CLE,24,1,402,46,96,.479,13,37,.351,33,59,.559,.547,30,41,.732,9,46,55,33,12,6,21,30,135
151,Tacko Fall\fallta01,C,24,BOS,7,0,33,11,14,.786,0,0,,11,14,.786,.786,1,3,.333,1,14,15,1,1,4,3,7,23
152,Derrick Favors\favorde01,C,28,NOP,51,49,1243,209,339,.617,1,7,.143,208,332,.627,.618,40,71,.563,163,338,501,81,30,46,55,107,459
153,Cristiano Felício\feliccr01,C,27,CHI,22,0,386,34,54,.630,0,2,.000,34,52,.654,.630,18,23,.783,55,47,102,16,10,2,18,34,86
154,Terrance Ferguson\fergute01,SF,21,OKC,56,38,1257,78,220,.355,49,168,.292,29,52,.558,.466,15,20,.750,23,51,74,51,27,17,31,155,220
155,Bruno Fernando\fernabr01,C,21,ATL,56,13,713,103,199,.518,5,37,.135,98,162,.605,.530,29,51,.569,67,131,198,49,18,17,42,107,240
156,Yogi Ferrell\ferreyo01,PG,26,SAC,50,0,530,79,188,.420,24,79,.304,55,109,.505,.484,36,42,.857,6,43,49,69,18,4,28,38,218
157,Dorian Finney-Smith\finnedo01,PF,26,DAL,71,68,2120,243,522,.466,114,303,.376,129,219,.589,.575,78,108,.722,145,260,405,114,45,39,69,178,678
158,Bryn Forbes\forbebr01,SG,26,SAS,63,62,1579,242,581,.417,148,381,.388,94,200,.470,.544,75,90,.833,12,114,126,108,33,0,57,113,707
159,Evan Fournier\fournev01,SF,27,ORL,66,66,2076,434,929,.467,173,434,.399,261,495,.527,.560,180,220,.818,18,153,171,209,71,15,125,161,1221
160,De'Aaron Fox\foxde01,PG,22,SAC,51,49,1634,391,815,.480,54,185,.292,337,630,.535,.513,241,342,.705,35,161,196,348,74,25,158,145,1077
161,Melvin Frazier\frazime01,SG,23,ORL,19,0,126,15,34,.441,8,16,.500,7,18,.389,.559,2,4,.500,2,8,10,3,9,2,5,11,40
162,Michael Frazier\frazimi01,SG,25,HOU,13,0,145,7,29,.241,4,23,.174,3,6,.500,.310,9,14,.643,1,9,10,2,2,0,5,22,27
163,Tim Frazier\fraziti01,PG,29,DET,27,11,355,34,94,.362,10,30,.333,24,64,.375,.415,19,24,.792,9,24,33,93,14,4,36,42,97
164,Enes Freedom\kanteen01,C,27,BOS,58,7,983,199,348,.572,1,7,.143,198,341,.581,.573,70,99,.707,163,268,431,56,22,41,56,100,469
165,Markelle Fultz\fultzma01,PG,21,ORL,72,60,1996,359,772,.465,36,135,.267,323,637,.507,.488,116,159,.730,41,197,238,369,90,11,147,142,870
166,Wenyen Gabriel\gabriwe01,PF,22,TOT,30,1,235,21,48,.438,6,20,.300,15,28,.536,.500,15,22,.682,21,31,52,8,11,7,16,39,63
166,Wenyen Gabriel\gabriwe01,PF,22,SAC,11,0,61,6,17,.353,1,8,.125,5,9,.556,.382,6,10,.600,4,6,10,3,3,2,5,7,19
166,Wenyen Gabriel\gabriwe01,PF,22,POR,19,1,174,15,31,.484,5,12,.417,10,19,.526,.565,9,12,.750,17,25,42,5,8,5,11,32,44
167,Daniel Gafford\gaffoda01,C,21,CHI,43,7,609,94,134,.701,0,0,,94,134,.701,.701,32,60,.533,52,54,106,21,13,56,29,98,220
168,Danilo Gallinari\gallida01,PF,31,OKC,62,62,1834,358,817,.438,178,439,.405,180,378,.476,.547,266,298,.893,34,288,322,119,42,5,76,75,1160
169,Langston Galloway\gallola01,SG,28,DET,66,6,1702,236,542,.435,132,331,.399,104,211,.493,.557,73,85,.859,33,116,149,101,48,11,40,96,677
170,Darius Garland\garlada01,SG,20,CLE,59,59,1824,280,699,.401,105,296,.355,175,403,.434,.476,63,72,.875,27,84,111,229,42,4,151,92,728
171,Marc Gasol\gasolma01,C,35,TOR,44,43,1161,119,279,.427,57,148,.385,62,131,.473,.529,36,49,.735,31,244,275,147,34,38,59,124,331
172,Rudy Gay\gayru01,PF,33,SAS,67,5,1461,266,596,.446,74,220,.336,192,376,.511,.508,120,136,.882,61,301,362,114,35,33,88,103,726
173,Paul George\georgpa01,SF,29,LAC,48,48,1419,343,782,.439,157,381,.412,186,401,.464,.539,190,217,.876,24,248,272,185,68,20,125,113,1033
174,Taj Gibson\gibsota01,C,34,NYK,62,56,1025,167,286,.584,4,14,.286,163,272,.599,.591,41,56,.732,111,156,267,52,27,30,47,122,379
175,Harry Giles\gilesha01,C,21,SAC,46,17,667,139,251,.554,0,2,.000,139,249,.558,.554,38,49,.776,43,145,188,60,22,18,44,119,316
176,Shai Gilgeous-Alexander\gilgesh01,SG,21,OKC,70,70,2428,478,1015,.471,87,251,.347,391,764,.512,.514,288,357,.807,47,365,412,232,79,47,134,117,1331
177,Rudy Gobert\goberru01,C,27,UTA,68,68,2333,386,557,.693,0,0,,386,557,.693,.693,254,403,.630,230,686,916,101,51,135,130,215,1026
178,Brandon Goodwin\goodwbr01,PG,24,ATL,34,1,430,76,190,.400,26,87,.299,50,103,.485,.468,28,30,.933,11,61,72,51,12,4,29,43,206
179,Aaron Gordon\gordoaa01,PF,24,ORL,62,62,2017,335,767,.437,73,237,.308,262,530,.494,.484,151,224,.674,107,368,475,228,51,39,100,125,894
180,Eric Gordon\gordoer01,SF,31,HOU,36,15,1016,171,463,.369,96,303,.317,75,160,.469,.473,82,107,.766,9,62,71,54,23,13,43,70,520
181,Devonte' Graham\grahade01,PG,24,CHO,63,53,2211,368,963,.382,218,585,.373,150,378,.397,.495,191,233,.820,42,170,212,471,62,15,181,115,1145
182,Treveon Graham\grahatr01,SF,26,TOT,55,20,929,87,242,.360,33,120,.275,54,122,.443,.428,36,56,.643,51,99,150,45,24,6,29,102,243
182,Treveon Graham\grahatr01,SF,26,MIN,33,20,663,62,175,.354,20,83,.241,42,92,.457,.411,27,37,.730,29,71,100,30,17,2,19,66,171
182,Treveon Graham\grahatr01,SF,26,ATL,22,0,266,25,67,.373,13,37,.351,12,30,.400,.470,9,19,.474,22,28,50,15,7,4,10,36,72
183,Jerami Grant\grantje01,PF,25,DEN,71,24,1892,303,634,.478,98,252,.389,205,382,.537,.555,147,196,.750,58,190,248,88,50,57,63,154,851
184,Jerian Grant\grantje02,SG,27,WAS,6,0,80,10,27,.370,2,8,.250,8,19,.421,.407,5,7,.714,2,4,6,9,1,1,3,11,27
185,Josh Gray\grayjo01,PG,26,NOP,2,0,23,1,2,.500,0,0,,1,2,.500,.500,0,0,,1,1,2,2,0,0,5,1,2
186,Danny Green\greenda02,SG,32,LAL,68,68,1687,197,474,.416,120,327,.367,77,147,.524,.542,33,48,.688,51,174,225,91,85,32,63,136,547
187,Draymond Green\greendr01,PF,29,GSW,43,43,1222,123,316,.389,36,129,.279,87,187,.465,.446,63,83,.759,23,243,266,266,59,33,98,110,345
188,JaMychal Green\greenja01,PF,29,LAC,63,1,1307,151,352,.429,92,238,.387,59,114,.518,.560,36,48,.750,77,311,388,49,29,24,54,174,430
189,Javonte Green\greenja02,SG,26,BOS,48,2,468,63,126,.500,9,33,.273,54,93,.581,.536,28,42,.667,24,69,93,26,24,8,23,43,163
190,Jeff Green\greenje02,PF-C,33,TOT,48,4,960,159,344,.462,62,183,.339,97,161,.602,.552,73,91,.802,24,109,133,50,26,19,42,89,453
190,Jeff Green\greenje02,PF,33,UTA,30,2,553,75,195,.385,34,104,.327,41,91,.451,.472,49,63,.778,14,67,81,20,12,10,27,46,233
190,Jeff Green\greenje02,C,33,HOU,18,2,407,84,149,.564,28,79,.354,56,70,.800,.658,24,28,.857,10,42,52,30,14,9,15,43,220
191,Blake Griffin\griffbl01,PF,30,DET,18,18,512,88,250,.352,27,111,.243,61,139,.439,.406,76,98,.776,17,67,84,59,7,7,40,27,279
192,Marko Guduric\gudurma01,SG,24,MEM,44,0,484,62,157,.395,25,83,.301,37,74,.500,.475,24,26,.923,14,59,73,45,12,8,36,34,173
193,Kyle Guy\guyky01,SG,22,SAC,3,0,10,2,5,.400,0,3,.000,2,2,1.000,.400,0,0,,0,1,1,1,0,0,0,1,4
194,Rui Hachimura\hachiru01,PF,21,WAS,48,48,1444,254,545,.466,25,87,.287,229,458,.500,.489,116,140,.829,78,216,294,87,37,8,53,105,649
195,Devon Hall\hallde01,PG,24,OKC,11,0,81,6,30,.200,4,17,.235,2,13,.154,.267,4,8,.500,2,5,7,13,4,1,5,6,20
196,Donta Hall\halldo01,C-PF,22,TOT,9,0,133,15,22,.682,0,0,,15,22,.682,.682,9,18,.500,14,24,38,4,3,6,5,23,39
196,Donta Hall\halldo01,PF,22,DET,4,0,48,1,4,.250,0,0,,1,4,.250,.250,4,6,.667,6,9,15,2,1,1,2,9,6
196,Donta Hall\halldo01,C,22,BRK,5,0,85,14,18,.778,0,0,,14,18,.778,.778,5,12,.417,8,15,23,2,2,5,3,14,33
197,Dusty Hannahs\hannadu01,SG,26,MEM,2,0,13,4,9,.444,2,3,.667,2,6,.333,.556,2,2,1.000,0,1,1,0,0,0,0,1,12
198,Tim Hardaway Jr.\hardati02,SG,27,DAL,71,58,2091,384,884,.434,204,513,.398,180,371,.485,.550,149,182,.819,25,207,232,137,41,5,69,125,1121
199,James Harden\hardeja01,SG,30,HOU,68,68,2483,672,1514,.444,299,843,.355,373,671,.556,.543,692,800,.865,70,376,446,512,125,60,308,227,2335
200,Maurice Harkless\harklma01,PF-SF,26,TOT,62,48,1427,142,283,.502,34,98,.347,108,185,.584,.562,39,66,.591,55,185,240,68,58,33,53,148,357
200,Maurice Harkless\harklma01,PF,26,LAC,50,38,1141,112,217,.516,27,73,.370,85,144,.590,.578,24,42,.571,47,153,200,48,49,30,46,120,275
200,Maurice Harkless\harklma01,SF,26,NYK,12,10,286,30,66,.455,7,25,.280,23,41,.561,.508,15,24,.625,8,32,40,20,9,3,7,28,82
201,Jared Harper\harpeja01,PG,22,PHO,3,0,8,1,4,.250,0,2,.000,1,2,.500,.250,0,0,,0,0,0,0,0,0,0,0,2
202,Montrezl Harrell\harremo01,C,26,LAC,63,2,1749,471,812,.580,0,18,.000,471,794,.593,.580,231,351,.658,163,282,445,107,39,72,108,146,1173
203,Gary Harris\harriga01,SG,25,DEN,56,55,1780,218,519,.420,70,210,.333,148,309,.479,.487,75,92,.815,26,137,163,118,76,14,60,116,581
204,Joe Harris\harrijo01,SF,28,BRK,69,69,2123,381,784,.486,172,406,.424,209,378,.553,.596,64,89,.719,64,234,298,144,41,17,104,159,998
205,Tobias Harris\harrito02,PF,27,PHI,72,72,2469,553,1173,.471,131,357,.367,422,816,.517,.527,174,216,.806,69,426,495,227,53,40,104,165,1411
206,Shaquille Harrison\harrish01,SG,26,CHI,43,10,484,77,165,.467,16,42,.381,61,123,.496,.515,39,50,.780,22,64,86,49,34,19,19,55,209
207,Josh Hart\hartjo01,SF,24,NOP,65,16,1755,225,532,.423,121,354,.342,104,178,.584,.537,85,115,.739,61,364,425,108,63,23,75,160,656
208,Isaiah Hartenstein\harteis01,C,21,HOU,23,2,266,44,67,.657,0,5,.000,44,62,.710,.657,19,28,.679,29,61,90,18,9,12,16,41,107
209,Udonis Haslem\hasleud01,C,39,MIA,4,1,44,4,11,.364,1,3,.333,3,8,.375,.409,3,4,.750,1,15,16,1,0,0,1,6,12
210,Jaxson Hayes\hayesja02,C,19,NOP,64,14,1080,174,259,.672,1,4,.250,173,255,.678,.674,123,190,.647,97,162,259,56,26,55,53,161,472
211,Gordon Hayward\haywago01,SF,29,BOS,52,52,1740,350,700,.500,85,222,.383,265,478,.554,.561,124,145,.855,55,293,348,212,38,22,96,96,909
212,John Henson\hensojo01,C,29,TOT,40,8,600,95,171,.556,8,36,.222,87,135,.644,.579,23,46,.500,46,116,162,54,24,42,36,78,221
212,John Henson\hensojo01,C,29,CLE,29,2,412,61,120,.508,6,31,.194,55,89,.618,.533,17,33,.515,32,82,114,43,16,32,21,55,145
212,John Henson\hensojo01,C,29,DET,11,6,188,34,51,.667,2,5,.400,32,46,.696,.686,6,13,.462,14,34,48,11,8,10,15,23,76
213,Dewan Hernandez\hernade01,C,23,TOR,6,0,28,5,14,.357,1,2,.500,4,12,.333,.393,3,5,.600,5,9,14,3,1,0,3,6,14
214,Juancho Hernangómez\hernaju01,PF,24,TOT,48,14,833,100,247,.405,44,129,.341,56,118,.475,.494,44,71,.620,43,154,197,40,19,9,32,64,288
214,Juancho Hernangómez\hernaju01,PF,24,DEN,34,0,422,38,110,.345,15,60,.250,23,50,.460,.414,16,25,.640,24,71,95,22,5,5,18,29,107
214,Juancho Hernangómez\hernaju01,PF,24,MIN,14,14,411,62,137,.453,29,69,.420,33,68,.485,.558,28,46,.609,19,83,102,18,14,4,14,35,181
215,Willy Hernangómez\hernawi01,C,25,CHO,31,0,375,74,139,.532,5,22,.227,69,117,.590,.550,37,59,.627,43,91,134,29,10,7,30,32,190
216,Tyler Herro\herroty01,SG,20,MIA,55,8,1508,270,631,.428,116,298,.389,154,333,.462,.520,87,100,.870,16,208,224,121,34,9,87,76,743
217,Kevin Hervey\herveke01,PF,23,OKC,10,0,52,7,27,.259,3,20,.150,4,7,.571,.315,0,0,,1,11,12,5,1,1,0,4,17
218,Mario Hezonja\hezonma01,PF,24,POR,53,4,871,92,218,.422,24,78,.308,68,140,.486,.477,48,59,.814,30,154,184,50,36,9,42,107,256
219,Buddy Hield\hieldbu01,SG,27,SAC,72,44,2216,498,1162,.429,271,688,.394,227,474,.479,.545,115,136,.846,57,271,328,213,66,17,168,165,1382
220,George Hill\hillge01,PG,33,MIL,59,2,1271,194,376,.516,81,176,.460,113,200,.565,.624,85,101,.842,50,127,177,180,47,5,57,84,554
221,Solomon Hill\hillso01,PF,28,TOT,59,4,1088,110,278,.396,63,171,.368,47,107,.439,.509,40,54,.741,29,136,165,104,43,12,51,85,323
221,Solomon Hill\hillso01,PF,28,MEM,48,3,901,96,233,.412,56,147,.381,40,86,.465,.532,26,38,.684,24,120,144,94,31,7,40,73,274
221,Solomon Hill\hillso01,PF,28,MIA,11,1,187,14,45,.311,7,24,.292,7,21,.333,.389,14,16,.875,5,16,21,10,12,5,11,12,49
222,Jaylen Hoard\hoardja01,PF,20,POR,13,0,103,15,32,.469,0,3,.000,15,29,.517,.469,8,13,.615,14,18,32,4,5,0,4,12,38
223,Aaron Holiday\holidaa01,PG,23,IND,66,33,1617,233,563,.414,87,221,.394,146,342,.427,.491,74,87,.851,22,134,156,225,55,16,88,120,627
224,Jrue Holiday\holidjr01,SG,29,NOP,61,61,2117,458,1006,.455,122,346,.353,336,660,.509,.516,129,182,.709,77,216,293,408,99,48,184,145,1167
225,Justin Holiday\holidju01,SF,30,IND,73,6,1826,208,486,.428,134,331,.405,74,155,.477,.566,53,67,.791,32,206,238,93,87,46,44,137,603
226,Rondae Hollis-Jefferson\holliro01,PF,25,TOR,60,6,1122,155,329,.471,3,23,.130,152,306,.497,.476,105,143,.734,110,173,283,106,46,23,59,115,418
227,Richaun Holmes\holmeri01,C,26,SAC,44,38,1242,223,344,.648,0,0,,223,344,.648,.648,93,118,.788,127,231,358,42,41,56,52,169,539
228,Rodney Hood\hoodro01,SF,27,POR,21,21,619,87,172,.506,35,71,.493,52,101,.515,.608,21,27,.778,10,62,72,32,17,4,19,46,230
229,Al Horford\horfoal01,C,33,PHI,67,61,2025,319,709,.450,99,283,.350,220,426,.516,.520,61,80,.763,103,353,456,270,52,61,80,142,798
230,Talen Horton-Tucker\hortota01,SG,19,LAL,6,1,81,14,30,.467,4,13,.308,10,17,.588,.533,2,4,.500,2,5,7,6,8,1,6,10,34
231,Danuel House Jr.\houseda01,SF,26,HOU,63,52,1913,230,539,.427,129,355,.363,101,184,.549,.546,73,90,.811,57,210,267,85,67,34,54,132,662
232,Dwight Howard\howardw01,C,34,LAL,69,2,1306,202,277,.729,3,5,.600,199,272,.732,.735,110,214,.514,172,335,507,45,31,79,84,222,517
233,William Howard\howarwi01,PF,26,HOU,2,0,13,0,4,.000,0,4,.000,0,0,,.000,0,0,,0,2,2,1,0,0,1,1,0
234,Kevin Huerter\huertke01,SG,21,ATL,56,48,1760,252,610,.413,127,334,.380,125,276,.453,.517,53,64,.828,35,193,228,213,51,27,87,139,684
235,De'Andre Hunter\huntede01,SF,22,ATL,63,62,2018,280,683,.410,108,304,.355,172,379,.454,.489,110,144,.764,44,242,286,112,44,18,103,182,778
236,Chandler Hutchison\hutchch01,SF,23,CHI,28,10,527,80,175,.457,12,38,.316,68,137,.496,.491,46,78,.590,18,90,108,26,27,7,27,47,218
237,Serge Ibaka\ibakase01,C,30,TOR,55,27,1485,343,670,.512,70,182,.385,273,488,.559,.564,89,124,.718,114,338,452,77,28,46,109,153,845
238,Andre Iguodala\iguodan01,SF,36,MIA,21,0,418,38,88,.432,14,47,.298,24,41,.585,.511,6,15,.400,17,61,78,51,14,21,26,35,96
239,Ersan İlyasova\ilyaser01,PF,32,MIL,63,8,986,146,313,.466,50,137,.365,96,176,.545,.546,72,87,.828,62,240,302,49,24,17,34,95,414
240,Joe Ingles\inglejo01,PF,32,UTA,72,45,2137,246,553,.445,141,353,.399,105,200,.525,.572,74,94,.787,27,251,278,373,65,11,142,154,707
241,Brandon Ingram\ingrabr01,PF,22,NOP,62,62,2104,507,1096,.463,150,384,.391,357,712,.501,.531,313,368,.851,51,329,380,259,61,38,189,179,1477
242,Kyrie Irving\irvinky01,PG,27,BRK,20,20,658,199,416,.478,56,142,.394,143,274,.522,.546,94,102,.922,22,81,103,128,27,10,52,53,548
243,Jonathan Isaac\isaacjo01,PF,22,ORL,34,32,980,156,332,.470,32,94,.340,124,238,.521,.518,60,77,.779,58,173,231,48,53,78,49,83,404
244,Wes Iwundu\iwundwe01,SF,25,ORL,52,21,953,97,233,.416,28,82,.341,69,151,.457,.476,78,97,.804,24,107,131,60,25,13,26,80,300
245,Frank Jackson\jacksfr01,PG,21,NOP,59,2,797,134,331,.405,47,144,.326,87,187,.465,.476,56,75,.747,22,61,83,61,17,4,49,77,371
246,Jaren Jackson Jr.\jacksja02,C,20,MEM,57,57,1622,353,753,.469,145,368,.394,208,385,.540,.565,139,186,.747,55,207,262,78,40,92,99,232,990
247,Josh Jackson\jacksjo02,SF,22,MEM,22,0,381,70,159,.440,23,72,.319,47,87,.540,.513,35,50,.700,11,55,66,35,18,9,28,40,198
248,Justin Jackson\jacksju01,PF,24,DAL,65,3,1045,135,341,.396,48,163,.294,87,178,.489,.466,42,50,.840,27,127,154,52,15,10,14,69,360
249,Reggie Jackson\jacksre01,SG-PG,29,TOT,31,16,743,134,326,.411,57,145,.393,77,181,.425,.498,45,54,.833,17,75,92,126,13,5,51,59,370
249,Reggie Jackson\jacksre01,PG,29,DET,14,10,381,76,198,.384,31,82,.378,45,116,.388,.462,26,33,.788,11,30,41,72,8,1,23,21,209
249,Reggie Jackson\jacksre01,SG,29,LAC,17,6,362,58,128,.453,26,63,.413,32,65,.492,.555,19,21,.905,6,45,51,54,5,4,28,38,161
250,Justin James\jamesju01,SF,23,SAC,36,0,232,35,84,.417,9,29,.310,26,55,.473,.470,10,21,.476,6,26,32,18,6,9,8,17,89
251,LeBron James\jamesle01,PG,35,LAL,67,67,2316,643,1303,.493,148,425,.348,495,878,.564,.550,264,381,.693,66,459,525,684,78,36,261,118,1698
252,Amile Jefferson\jeffeam01,PF,26,ORL,18,0,74,5,14,.357,0,0,,5,14,.357,.357,5,14,.357,10,13,23,4,1,3,3,7,15
253,DaQuan Jeffries\jeffrda01,SG,22,SAC,13,0,141,20,40,.500,5,18,.278,15,22,.682,.563,5,6,.833,3,15,18,7,4,1,2,19,50
254,Ty Jerome\jeromty01,SG,22,PHO,31,0,328,38,113,.336,14,50,.280,24,63,.381,.398,12,16,.750,7,39,46,44,15,3,18,29,102
255,Alize Johnson\johnsal02,PF,23,IND,17,1,118,12,29,.414,3,8,.375,9,21,.429,.466,7,10,.700,16,32,48,7,3,2,7,12,34
256,B.J. Johnson\johnsbj01,SF,24,ORL,10,0,83,9,32,.281,3,9,.333,6,23,.261,.328,9,10,.900,3,12,15,3,3,0,6,3,30
257,Cameron Johnson\johnsca02,PF,23,PHO,57,9,1255,176,405,.435,106,272,.390,70,133,.526,.565,46,57,.807,49,138,187,69,36,20,32,88,504
258,James Johnson\johnsja01,PF-C,32,TOT,32,1,619,103,215,.479,33,91,.363,70,124,.565,.556,31,48,.646,25,93,118,74,25,32,48,80,270
258,James Johnson\johnsja01,PF,32,MIA,18,0,281,39,87,.448,16,45,.356,23,42,.548,.540,8,14,.571,8,44,52,21,6,13,15,34,102
258,James Johnson\johnsja01,C,32,MIN,14,1,338,64,128,.500,17,46,.370,47,82,.573,.566,23,34,.676,17,49,66,53,19,19,33,46,168
259,Keldon Johnson\johnske04,SF,20,SAS,17,1,301,53,89,.596,13,22,.591,40,67,.597,.669,35,44,.795,10,47,57,15,14,2,13,28,154
260,Stanley Johnson\johnsst04,PF,23,TOR,25,0,150,22,59,.373,7,24,.292,15,35,.429,.432,9,16,.563,7,30,37,20,6,4,15,16,60
261,Tyler Johnson\johnsty01,PG-SG,27,TOT,39,7,709,97,250,.388,38,119,.319,59,131,.450,.464,42,50,.840,18,58,76,74,16,9,29,58,274
261,Tyler Johnson\johnsty01,PG,27,PHO,31,3,515,65,171,.380,24,83,.289,41,88,.466,.450,24,32,.750,10,42,52,50,12,8,24,43,178
261,Tyler Johnson\johnsty01,SG,27,BRK,8,4,194,32,79,.405,14,36,.389,18,43,.419,.494,18,18,1.000,8,16,24,24,4,1,5,15,96
262,Nikola Jokić\jokicni01,C,24,DEN,73,73,2336,565,1071,.528,80,255,.314,485,816,.594,.565,246,301,.817,166,545,711,512,85,44,226,222,1456
263,Damian Jones\jonesda03,C,24,ATL,55,27,887,121,178,.680,2,9,.222,119,169,.704,.685,62,84,.738,74,132,206,35,26,40,28,149,306
264,Derrick Jones Jr.\jonesde02,SF,22,MIA,59,16,1375,184,349,.527,37,132,.280,147,217,.677,.580,95,123,.772,66,167,233,62,58,38,30,130,500
265,Tyus Jones\jonesty01,PG,23,MEM,65,6,1232,197,429,.459,47,124,.379,150,305,.492,.514,43,58,.741,9,94,103,285,59,6,55,44,484
266,DeAndre Jordan\jordade01,C,31,BRK,56,6,1234,191,287,.666,0,0,,191,287,.666,.666,83,122,.680,141,420,561,105,18,52,74,114,465
267,Cory Joseph\josepco01,PG,28,SAC,72,26,1759,171,412,.415,56,159,.352,115,253,.455,.483,60,70,.857,44,144,188,251,53,21,80,133,458
268,Mfiondu Kabengele\kabenmf01,C,22,LAC,12,0,64,14,32,.438,9,20,.450,5,12,.417,.578,5,5,1.000,1,10,11,2,2,2,2,9,42
269,Frank Kaminsky\kaminfr01,C,26,PHO,39,13,777,138,307,.450,41,124,.331,97,183,.530,.516,61,90,.678,35,141,176,75,14,10,37,75,378
270,Luke Kennard\kennalu01,SG,23,DET,28,25,922,151,342,.442,73,183,.399,78,159,.491,.548,67,75,.893,9,89,98,115,12,6,43,65,442
271,Stanton Kidd\kiddst01,SG,27,UTA,4,0,15,0,3,.000,0,1,.000,0,2,.000,.000,0,0,,0,3,3,1,0,0,2,3,0
272,Michael Kidd-Gilchrist\kiddgmi01,PF,26,TOT,25,0,281,22,66,.333,5,20,.250,17,46,.370,.371,11,14,.786,14,53,67,14,2,6,16,37,60
272,Michael Kidd-Gilchrist\kiddgmi01,PF,26,CHO,12,0,160,18,53,.340,5,17,.294,13,36,.361,.387,7,9,.778,9,26,35,10,0,3,7,18,48
272,Michael Kidd-Gilchrist\kiddgmi01,PF,26,DAL,13,0,121,4,13,.308,0,3,.000,4,10,.400,.308,4,5,.800,5,27,32,4,2,3,9,19,12
273,Louis King\kinglo02,SF,20,DET,10,0,62,8,21,.381,4,11,.364,4,10,.400,.476,0,3,.000,1,9,10,5,2,0,2,10,20
274,Maxi Kleber\klebima01,PF,28,DAL,74,21,1890,237,514,.461,119,319,.373,118,195,.605,.577,79,93,.849,112,276,388,88,25,83,58,176,672
275,Brandon Knight\knighbr03,SG-PG,28,TOT,25,3,462,59,167,.353,45,131,.344,14,36,.389,.488,20,34,.588,4,37,41,69,10,3,38,40,183
275,Brandon Knight\knighbr03,SG,28,CLE,16,0,241,28,86,.326,19,64,.297,9,22,.409,.436,4,13,.308,3,17,20,31,5,2,16,20,79
275,Brandon Knight\knighbr03,PG,28,DET,9,3,221,31,81,.383,26,67,.388,5,14,.357,.543,16,21,.762,1,20,21,38,5,1,22,20,104
276,Kevin Knox\knoxke01,SF,20,NYK,65,4,1166,144,401,.359,65,199,.327,79,202,.391,.440,66,101,.653,28,156,184,61,23,28,45,106,419
277,John Konchar\konchjo01,SG,23,MEM,19,0,181,24,37,.649,5,10,.500,19,27,.704,.716,1,2,.500,18,29,47,22,7,3,7,7,54
278,Furkan Korkmaz\korkmfu01,SG,22,PHI,72,12,1559,242,563,.430,143,356,.402,99,207,.478,.557,77,102,.755,18,150,168,79,41,16,59,98,704
279,Luke Kornet\kornelu01,C,24,CHI,36,14,559,82,187,.439,31,108,.287,51,79,.646,.521,20,28,.714,22,62,84,32,11,26,14,54,215
280,Kyle Korver\korveky01,SF,38,MIL,58,1,960,126,293,.430,99,237,.418,27,56,.482,.599,35,41,.854,15,107,122,68,26,12,48,78,386
281,Rodions Kurucs\kurucro01,PF,21,BRK,47,9,684,79,177,.446,33,90,.367,46,87,.529,.540,24,38,.632,25,112,137,51,25,5,46,90,215
282,Kyle Kuzma\kuzmaky01,PF,24,LAL,61,9,1526,291,668,.436,86,272,.316,205,396,.518,.500,114,155,.735,52,221,273,80,28,26,91,126,782
283,Skal Labissière\labissk01,C,23,POR,33,1,567,81,147,.551,3,13,.231,78,134,.582,.561,25,33,.758,65,104,169,42,7,31,30,89,190
284,Jeremy Lamb\lambje01,SG,27,IND,46,42,1291,216,479,.451,53,158,.335,163,321,.508,.506,92,110,.836,24,176,200,96,55,22,50,104,577
285,Romeo Langford\langfro01,SG,20,BOS,32,2,370,28,80,.350,5,27,.185,23,53,.434,.381,18,25,.720,15,26,41,13,8,8,11,33,79
286,Zach LaVine\lavinza01,SF,24,CHI,60,60,2085,539,1199,.450,184,484,.380,355,715,.497,.526,268,334,.802,41,248,289,254,88,28,206,131,1530
287,Vic Law\lawvi01,PF,24,ORL,8,0,62,6,18,.333,1,7,.143,5,11,.455,.361,2,6,.333,2,9,11,3,2,0,2,6,15
288,Jake Layman\laymaja01,SF,25,MIN,23,2,505,81,179,.453,24,72,.333,57,107,.533,.520,24,32,.750,17,40,57,15,17,10,24,47,210
289,T.J. Leaf\leaftj01,PF,22,IND,28,1,222,36,86,.419,5,18,.278,31,68,.456,.448,7,16,.438,23,48,71,9,10,4,8,22,84
290,Jalen Lecque\lecquja01,SG,19,PHO,5,0,32,4,10,.400,0,4,.000,4,6,.667,.400,2,2,1.000,0,2,2,2,0,0,2,3,10
291,Courtney Lee\leeco01,SG,34,DAL,24,9,345,40,82,.488,21,47,.447,19,35,.543,.616,6,7,.857,7,25,32,12,18,6,11,33,107
292,Damion Lee\leeda03,SG,27,GSW,49,36,1423,213,511,.417,85,239,.356,128,272,.471,.500,110,126,.873,32,207,239,133,50,6,67,116,621
293,Alex Len\lenal01,C,26,TOT,55,12,970,177,319,.555,16,59,.271,161,260,.619,.580,68,105,.648,100,221,321,50,23,48,55,127,438
293,Alex Len\lenal01,C,26,ATL,40,9,745,142,260,.546,14,56,.250,128,204,.627,.573,51,81,.630,69,161,230,42,20,33,39,93,349
293,Alex Len\lenal01,C,26,SAC,15,3,225,35,59,.593,2,3,.667,33,56,.589,.610,17,24,.708,31,60,91,8,3,15,16,34,89
294,Kawhi Leonard\leonaka01,SF,28,LAC,57,57,1848,532,1133,.470,123,325,.378,409,808,.506,.524,356,402,.886,54,348,402,280,103,33,149,113,1543
295,Meyers Leonard\leoname01,C,27,MIA,51,49,1034,119,234,.509,53,128,.414,66,106,.623,.622,18,28,.643,30,230,260,55,14,15,39,107,309
296,Caris LeVert\leverca01,SG,25,BRK,45,31,1330,311,732,.425,80,220,.364,231,512,.451,.480,140,197,.711,49,140,189,199,53,10,118,81,842
297,Damian Lillard\lillada01,PG,29,POR,66,66,2474,624,1349,.463,270,674,.401,354,675,.524,.563,460,518,.888,33,251,284,530,70,22,194,114,1978
298,Nassir Little\littlna01,PF,19,POR,48,5,573,65,151,.430,14,59,.237,51,92,.554,.477,28,44,.636,31,77,108,22,13,14,15,72,172
299,Kevon Looney\looneke01,C,23,GSW,20,4,262,29,79,.367,1,14,.071,28,65,.431,.373,9,12,.750,28,38,66,20,12,6,12,34,68
300,Brook Lopez\lopezbr01,C,31,MIL,68,67,1817,292,671,.435,102,325,.314,190,346,.549,.511,127,152,.836,58,254,312,99,46,163,70,163,813
301,Robin Lopez\lopezro01,C,31,MIL,66,5,958,147,299,.492,35,105,.333,112,194,.577,.550,28,53,.528,56,105,161,45,10,45,63,96,357
302,Kevin Love\loveke01,PF,31,CLE,56,56,1780,327,727,.450,146,390,.374,181,337,.537,.550,187,219,.854,54,493,547,178,33,19,140,90,987
303,Kyle Lowry\lowryky01,PG,33,TOR,58,58,2098,334,803,.416,164,466,.352,170,337,.504,.518,294,343,.857,32,260,292,433,82,26,178,190,1126
304,Timothé Luwawu-Cabarrot\luwawti01,SF,24,BRK,47,2,853,117,269,.435,62,160,.388,55,109,.505,.550,69,81,.852,29,98,127,29,18,7,37,106,365
305,Trey Lyles\lylestr01,PF,24,SAS,63,53,1271,153,343,.446,65,168,.387,88,175,.503,.541,33,45,.733,71,290,361,69,28,28,39,98,404
306,Daryl Macon\maconda01,PG,24,MIA,4,0,14,1,3,.333,1,2,.500,0,1,.000,.500,0,0,,0,0,0,1,0,0,2,1,3
307,J.P. Macura\macurjp01,SG,24,CLE,1,0,1,0,0,,0,0,,0,0,,,0,0,,0,0,0,0,0,0,0,0,0
308,Josh Magette\magetjo01,PG,30,ORL,8,0,38,5,15,.333,1,4,.250,4,11,.364,.367,1,2,.500,1,5,6,5,3,1,5,4,12
309,Ian Mahinmi\mahinia01,C,33,WAS,38,35,808,104,210,.495,5,26,.192,99,184,.538,.507,70,113,.619,78,140,218,49,31,44,45,114,283
310,Thon Maker\makerth01,C,22,DET,60,14,776,93,193,.482,22,64,.344,71,129,.550,.539,73,110,.664,54,113,167,43,25,39,45,102,281
311,Terance Mann\mannte01,SF,23,LAC,41,6,362,37,79,.468,7,20,.350,30,59,.508,.513,18,27,.667,10,45,55,53,11,5,18,46,99
312,Boban Marjanović\marjabo01,C,31,DAL,44,5,422,121,211,.573,4,17,.235,117,194,.603,.583,43,57,.754,66,131,197,20,8,10,30,56,289
313,Lauri Markkanen\markkla01,PF,22,CHI,50,50,1492,251,591,.425,109,317,.344,142,274,.518,.517,126,153,.824,60,253,313,74,42,23,81,96,737
314,Caleb Martin\martica02,SF,24,CHO,18,1,317,37,84,.440,20,37,.541,17,47,.362,.560,17,21,.810,10,28,38,23,12,7,15,32,111
315,Cody Martin\martico01,SF,24,CHO,48,3,903,89,207,.430,18,77,.234,71,130,.546,.473,42,65,.646,38,120,158,95,39,9,44,78,238
316,Jeremiah Martin\martije02,PG,23,BRK,9,0,99,24,53,.453,5,18,.278,19,35,.543,.500,11,14,.786,1,9,10,18,7,2,4,7,64
317,Kelan Martin\martike03,SF,24,MIN,31,4,495,71,181,.392,25,96,.260,46,85,.541,.461,30,31,.968,12,84,96,23,7,9,20,51,197
318,Frank Mason III\masonfr01,PG,25,MIL,9,0,118,23,51,.451,6,21,.286,17,30,.567,.510,10,17,.588,5,14,19,29,5,1,11,11,62
319,Garrison Mathews\mathega01,SG,23,WAS,18,0,227,24,56,.429,19,46,.413,5,10,.500,.598,31,34,.912,6,18,24,10,8,1,8,32,98
320,Wesley Matthews\matthwe02,SG,33,MIL,67,67,1635,167,422,.396,108,297,.364,59,125,.472,.524,52,68,.765,22,144,166,92,38,9,43,103,494
321,Luc Mbah a Moute\mbahalu01,PF,33,HOU,3,0,25,2,5,.400,0,2,.000,2,3,.667,.400,1,2,.500,1,1,2,0,2,0,1,0,5
322,Patrick McCaw\mccawpa01,SF,24,TOR,37,12,908,67,162,.414,23,71,.324,44,91,.484,.485,13,18,.722,19,67,86,79,39,4,29,60,170
323,CJ McCollum\mccolcj01,SG,28,POR,70,70,2556,611,1356,.451,194,512,.379,417,844,.494,.522,140,185,.757,46,251,297,310,54,42,127,183,1556
324,T.J. McConnell\mccontj01,PG,27,IND,71,3,1326,212,411,.516,5,17,.294,207,394,.525,.522,35,42,.833,38,151,189,355,56,11,100,73,464
325,Jalen McDaniels\mcdanja01,SF,22,CHO,16,0,293,33,70,.471,9,24,.375,24,46,.522,.536,14,17,.824,15,50,65,13,8,3,11,36,89
326,Doug McDermott\mcderdo01,PF,28,IND,69,0,1372,267,547,.488,128,294,.435,139,253,.549,.605,48,58,.828,26,148,174,78,12,5,42,117,710
327,JaVale McGee\mcgeeja01,C,32,LAL,68,68,1130,195,306,.637,3,6,.500,192,300,.640,.642,53,82,.646,125,265,390,37,36,94,55,159,446
328,Rodney McGruder\mcgruro01,SG,28,LAC,56,4,871,72,181,.398,24,89,.270,48,92,.522,.464,19,34,.559,29,122,151,36,26,8,24,74,187
329,Alfonzo McKinnie\mckinal01,SF,27,CLE,40,1,593,73,171,.427,14,65,.215,59,106,.557,.468,22,31,.710,37,76,113,14,23,8,26,72,182
330,Jordan McLaughlin\mclaujo01,PG,23,MIN,30,2,590,87,178,.489,29,76,.382,58,102,.569,.570,26,39,.667,7,42,49,125,34,4,31,31,229
331,Ben McLemore\mclembe01,SF,26,HOU,71,23,1619,242,545,.444,181,452,.400,61,93,.656,.610,50,67,.746,21,136,157,58,45,16,50,155,715
332,Jordan McRae\mcraejo01,SG,28,TOT,37,4,784,149,366,.407,45,126,.357,104,240,.433,.469,83,109,.761,18,106,124,93,21,16,43,73,426
332,Jordan McRae\mcraejo01,SG,28,WAS,29,4,654,133,317,.420,40,106,.377,93,211,.441,.483,64,83,.771,17,87,104,82,19,15,38,61,370
332,Jordan McRae\mcraejo01,SG,28,DEN,4,0,32,2,6,.333,2,4,.500,0,2,.000,.500,3,4,.750,1,4,5,4,2,1,0,2,9
332,Jordan McRae\mcraejo01,SG,28,DET,4,0,98,14,43,.326,3,16,.188,11,27,.407,.360,16,22,.727,0,15,15,7,0,0,5,10,47
333,Nicolò Melli\mellini01,C,29,NOP,60,8,1042,136,323,.421,69,206,.335,67,117,.573,.528,54,73,.740,38,142,180,82,34,23,46,124,395
334,De'Anthony Melton\meltode01,PG,21,MEM,60,8,1167,161,401,.401,40,140,.286,121,261,.464,.451,93,121,.769,43,177,220,175,77,20,84,109,455
335,Chimezie Metu\metuch01,C,22,SAS,18,0,105,24,42,.571,0,2,.000,24,40,.600,.571,10,13,.769,12,21,33,10,3,6,10,7,58
336,Khris Middleton\middlkh01,SF,28,MIL,62,59,1853,471,947,.497,147,354,.415,324,593,.546,.575,208,227,.916,44,338,382,265,53,7,137,142,1297
337,Eric Mika\mikaer01,C,25,SAC,1,0,19,2,3,.667,0,0,,2,3,.667,.667,2,2,1.000,2,5,7,0,0,0,0,5,6
338,C.J. Miles\milescj01,SF,32,WAS,10,0,161,19,59,.322,11,35,.314,8,24,.333,.415,15,20,.750,4,8,12,12,10,4,4,14,64
339,Malcolm Miller\millema01,SF,26,TOR,28,1,162,12,29,.414,8,22,.364,4,7,.571,.552,3,8,.375,2,14,16,11,5,2,4,18,35
340,Patty Mills\millspa02,PG,31,SAS,66,1,1485,258,598,.431,154,403,.382,104,195,.533,.560,97,112,.866,22,86,108,118,53,6,54,105,767
341,Paul Millsap\millspa01,PF,34,DEN,51,48,1240,211,438,.482,54,124,.435,157,314,.500,.543,115,141,.816,98,195,293,83,44,30,70,150,591
342,Shake Milton\miltosh01,SG,23,PHI,40,24,805,134,277,.484,58,135,.430,76,142,.535,.588,51,65,.785,15,73,88,104,20,7,47,92,377
343,Donovan Mitchell\mitchdo01,SG,23,UTA,69,69,2364,602,1342,.449,173,473,.366,429,869,.494,.513,278,322,.863,53,251,304,294,70,14,184,172,1655
344,Naz Mitrou-Long\mitrona01,SG,26,IND,5,0,47,6,17,.353,2,12,.167,4,5,.800,.412,0,0,,0,7,7,8,1,1,3,2,14
345,Adam Mokoka\mokokad01,SF,21,CHI,11,0,112,12,28,.429,6,15,.400,6,13,.462,.536,2,4,.500,7,3,10,4,4,0,2,17,32
346,Malik Monk\monkma01,SG,21,CHO,55,1,1169,212,488,.434,58,204,.284,154,284,.542,.494,82,100,.820,27,130,157,114,25,16,77,74,564
347,Matt Mooney\moonema01,SG,22,CLE,4,0,19,1,4,.250,0,2,.000,1,2,.500,.250,0,0,,0,3,3,1,2,1,0,1,2
348,E'Twaun Moore\mooreet01,SG,30,NOP,56,6,1020,186,437,.426,63,167,.377,123,270,.456,.498,31,45,.689,31,100,131,78,32,11,40,80,466
349,Ja Morant\moranja01,PG,20,MEM,67,67,2074,447,937,.477,60,179,.335,387,758,.511,.509,239,308,.776,51,208,259,488,58,18,220,110,1193
350,Juwan Morgan\morgaju01,PF,22,UTA,21,0,134,15,26,.577,3,8,.375,12,18,.667,.635,3,4,.750,10,19,29,6,1,2,6,19,36
351,Marcus Morris\morrima03,SF-PF,30,TOT,62,62,1936,355,810,.438,142,348,.408,213,462,.461,.526,181,220,.823,59,252,311,86,47,30,97,180,1033
351,Marcus Morris\morrima03,SF,30,NYK,43,43,1387,281,636,.442,116,264,.439,165,372,.444,.533,163,198,.823,48,185,233,59,34,17,73,128,841
351,Marcus Morris\morrima03,PF,30,LAC,19,19,549,74,174,.425,26,84,.310,48,90,.533,.500,18,22,.818,11,67,78,27,13,13,24,52,192
352,Markieff Morris\morrima02,PF,30,TOT,58,17,1187,203,458,.443,88,228,.386,115,230,.500,.539,66,85,.776,40,178,218,77,31,17,76,133,560
352,Markieff Morris\morrima02,PF,30,DET,44,16,988,175,389,.450,75,189,.397,100,200,.500,.546,61,79,.772,24,149,173,69,26,11,70,104,486
352,Markieff Morris\morrima02,PF,30,LAL,14,1,199,28,69,.406,13,39,.333,15,30,.500,.500,5,6,.833,16,29,45,8,5,6,6,29,74
353,Monte Morris\morrimo01,PG,24,DEN,73,12,1636,260,566,.459,65,172,.378,195,394,.495,.517,75,89,.843,24,113,137,255,55,17,53,73,660
354,Johnathan Motley\motlejo01,PF,24,LAC,13,0,41,11,15,.733,1,1,1.000,10,14,.714,.767,5,7,.714,3,7,10,8,3,0,5,6,28
355,Emmanuel Mudiay\mudiaem01,PG,23,UTA,54,2,850,151,327,.462,30,87,.345,121,240,.504,.508,63,83,.759,18,108,126,116,24,10,76,72,395
356,Mychal Mulder\muldemy01,SF,25,GSW,7,3,204,26,67,.388,16,52,.308,10,15,.667,.507,9,12,.750,3,20,23,8,2,1,5,20,77
357,Dejounte Murray\murrade01,PG,23,SAS,66,58,1687,294,637,.462,41,111,.369,253,526,.481,.494,91,114,.798,69,314,383,271,111,17,125,143,720
358,Jamal Murray\murraja01,PG,22,DEN,59,59,1904,408,894,.456,112,324,.346,296,570,.519,.519,163,185,.881,45,191,236,284,67,17,127,102,1091
359,Džanan Musa\musadz01,SF,20,BRK,40,0,487,64,172,.372,19,78,.244,45,94,.479,.427,45,60,.750,21,65,86,43,15,1,36,30,192
360,Mike Muscala\muscami01,C,28,OKC,47,2,572,77,189,.407,54,143,.378,23,46,.500,.550,18,22,.818,16,92,108,40,9,12,17,58,226
361,Svi Mykhailiuk\mykhasv01,SF,22,DET,56,27,1265,166,405,.410,115,285,.404,51,120,.425,.552,57,70,.814,17,87,104,106,41,4,61,87,504
362,Abdel Nader\naderab01,SF,26,OKC,55,6,867,123,263,.468,48,128,.375,75,135,.556,.559,51,66,.773,14,86,100,38,23,20,43,78,345
363,Larry Nance Jr.\nancela02,PF,27,CLE,56,10,1472,229,431,.531,56,159,.352,173,272,.636,.596,50,74,.676,106,303,409,123,56,22,60,91,564
364,Shabazz Napier\napiesh01,PG,28,TOT,56,32,1344,188,456,.412,76,240,.317,112,216,.519,.496,126,153,.824,26,132,158,262,69,11,128,101,578
364,Shabazz Napier\napiesh01,PG,28,MIN,36,22,856,114,283,.403,47,159,.296,67,124,.540,.486,72,88,.818,17,93,110,187,40,7,76,62,347
364,Shabazz Napier\napiesh01,PG,28,WAS,20,10,488,74,173,.428,29,81,.358,45,92,.489,.512,54,65,.831,9,39,48,75,29,4,52,39,231
365,Raul Neto\netora01,PG,27,PHI,54,3,668,101,222,.455,34,88,.386,67,134,.500,.532,39,47,.830,11,50,61,95,24,6,47,50,275
366,Malik Newman\newmama01,SG,22,CLE,1,0,4,0,2,.000,0,1,.000,0,1,.000,.000,2,2,1.000,0,0,0,0,0,0,1,0,2
367,Georges Niang\niangge01,PF,26,UTA,66,1,923,141,322,.438,90,225,.400,51,97,.526,.578,20,24,.833,15,112,127,44,18,5,30,75,392
368,Joakim Noah\noahjo01,C,34,LAC,5,0,50,4,8,.500,0,0,,4,8,.500,.500,6,8,.750,5,11,16,7,1,1,6,9,14
369,Nerlens Noel\noelne01,C,25,OKC,61,7,1127,184,269,.684,1,3,.333,183,266,.688,.686,80,106,.755,91,209,300,57,59,91,66,166,449
370,Zach Norvell\norveza01,SG,22,TOT,5,0,41,3,12,.250,3,8,.375,0,4,.000,.375,1,1,1.000,0,6,6,3,2,0,3,4,10
370,Zach Norvell\norveza01,SG,22,LAL,2,0,5,0,1,.000,0,0,,0,1,.000,.000,0,0,,0,1,1,0,0,0,0,0,0
370,Zach Norvell\norveza01,SG,22,GSW,3,0,36,3,11,.273,3,8,.375,0,3,.000,.409,1,1,1.000,0,5,5,3,2,0,3,4,10
371,Jaylen Nowell\nowelja01,SG,20,MIN,15,0,151,19,53,.358,3,26,.115,16,27,.593,.387,16,17,.941,3,10,13,19,3,1,3,11,57
372,Frank Ntilikina\ntilila01,PG,21,NYK,57,26,1187,131,333,.393,44,137,.321,87,196,.444,.459,51,59,.864,23,98,121,172,54,16,71,142,357
373,Kendrick Nunn\nunnke01,PG,24,MIA,67,67,1962,401,914,.439,137,391,.350,264,523,.505,.514,85,100,.850,21,159,180,220,56,15,114,152,1024
374,Jusuf Nurkić\nurkiju01,C,25,POR,8,8,253,54,109,.495,2,10,.200,52,99,.525,.505,31,35,.886,23,59,82,32,11,16,19,39,141
375,David Nwaba\nwabada01,SF,27,BRK,20,0,268,37,71,.521,12,28,.429,25,43,.581,.606,18,27,.667,8,37,45,8,11,12,8,32,104
376,Royce O'Neale\onealro01,SF,26,UTA,71,62,2049,158,365,.433,92,244,.377,66,121,.545,.559,42,55,.764,27,362,389,180,59,32,61,202,450
377,Kyle O'Quinn\oquinky01,C,29,PHI,29,2,313,42,85,.494,7,27,.259,35,58,.603,.535,11,20,.550,34,82,116,51,7,24,20,37,102
378,Semi Ojeleye\ojelese01,PF,25,BOS,69,6,1011,80,196,.408,48,127,.378,32,69,.464,.531,28,32,.875,26,119,145,37,21,5,19,80,236
379,Jahlil Okafor\okafoja01,C,24,NOP,30,9,467,101,162,.623,1,3,.333,100,159,.629,.627,40,62,.645,48,79,127,37,7,22,38,67,243
380,Elie Okobo\okoboel01,PG,22,PHO,55,3,719,72,181,.398,25,71,.352,47,110,.427,.467,50,71,.704,16,74,90,115,24,4,38,54,219
381,Josh Okogie\okogijo01,SG,21,MIN,62,28,1547,170,398,.427,41,154,.266,129,244,.529,.479,152,191,.796,87,181,268,99,68,26,87,139,533
382,KZ Okpala\okpalkz01,PF,20,MIA,5,0,26,3,5,.600,0,1,.000,3,4,.750,.600,1,2,.500,1,4,5,1,2,1,1,2,7
383,Victor Oladipo\oladivi01,SG,27,IND,19,16,528,97,246,.394,33,104,.317,64,142,.451,.461,48,59,.814,9,66,75,56,17,4,47,36,275
384,Kelly Olynyk\olynyke01,C,28,MIA,67,9,1300,184,398,.462,95,234,.406,89,164,.543,.582,86,100,.860,44,261,305,116,45,23,71,173,549
385,Miye Oni\onimi01,SF,22,UTA,10,1,109,12,32,.375,7,19,.368,5,13,.385,.484,4,5,.800,5,12,17,4,4,2,4,9,35
386,Cedi Osman\osmande01,SF,24,CLE,65,65,1910,266,609,.437,123,321,.383,143,288,.497,.538,63,94,.670,39,192,231,154,54,16,91,160,718
387,Kelly Oubre Jr.\oubreke01,SF,24,PHO,56,55,1933,373,826,.452,108,307,.352,265,519,.511,.517,192,246,.780,67,294,361,85,71,40,83,192,1046
388,Tariq Owens\owensta01,PF,24,PHO,3,0,15,1,5,.200,0,2,.000,1,3,.333,.200,2,2,1.000,2,1,3,0,1,0,0,1,4
389,Jeremy Pargo\pargoje01,PG,33,GSW,3,0,44,11,22,.500,3,7,.429,8,15,.533,.568,0,1,.000,1,2,3,8,1,0,4,8,25
390,Jabari Parker\parkeja01,PF,24,TOT,38,23,917,219,429,.510,32,119,.269,187,310,.603,.548,61,81,.753,61,153,214,68,45,16,64,99,531
390,Jabari Parker\parkeja01,PF,24,ATL,32,23,837,198,393,.504,31,115,.270,167,278,.601,.543,53,72,.736,54,137,191,58,42,15,60,93,480
390,Jabari Parker\parkeja01,PF,24,SAC,6,0,80,21,36,.583,1,4,.250,20,32,.625,.597,8,9,.889,7,16,23,10,3,1,4,6,51
391,Chandler Parsons\parsoch01,PF,31,ATL,5,0,54,5,18,.278,4,14,.286,1,4,.250,.389,0,0,,1,6,7,3,4,1,3,3,14
392,Eric Paschall\pascher01,PF,23,GSW,60,26,1654,318,640,.497,37,129,.287,281,511,.550,.526,164,212,.774,82,193,275,127,32,13,94,125,837
393,Anžejs Pasečņiks\pasecan01,C,24,WAS,27,0,437,61,116,.526,0,3,.000,61,113,.540,.526,34,58,.586,42,65,107,18,9,12,24,75,156
394,Patrick Patterson\pattepa01,PF,30,LAC,59,18,776,95,233,.408,67,172,.390,28,61,.459,.552,35,43,.814,35,116,151,41,7,3,21,54,292
395,Justin Patton\pattoju01,C,22,OKC,5,0,24,4,10,.400,1,4,.250,3,6,.500,.450,0,0,,1,4,5,2,0,0,2,4,9
396,Chris Paul\paulch01,PG,34,OKC,70,70,2208,434,887,.489,111,304,.365,323,583,.554,.552,253,279,.907,26,323,349,472,111,11,161,158,1232
397,Cameron Payne\payneca01,SG,25,PHO,8,0,183,33,68,.485,15,29,.517,18,39,.462,.596,6,7,.857,4,27,31,24,8,2,11,20,87
398,Elfrid Payton\paytoel01,PG,25,NYK,45,36,1246,193,440,.439,14,69,.203,179,371,.482,.455,49,86,.570,52,160,212,323,70,17,96,89,449
399,Gary Payton II\paytoga02,SF,27,WAS,29,17,432,48,116,.414,13,46,.283,35,70,.500,.470,4,8,.500,26,54,80,48,33,7,20,54,113
400,Norvel Pelle\pelleno01,C,26,PHI,24,0,232,25,48,.521,0,1,.000,25,47,.532,.521,7,14,.500,20,52,72,8,3,31,18,55,57
401,Theo Pinson\pinsoth01,SG,24,BRK,33,0,365,45,155,.290,15,80,.188,30,75,.400,.339,15,16,.938,10,44,54,56,17,4,33,35,120
402,Mason Plumlee\plumlma01,C,29,DEN,61,1,1057,177,288,.615,0,5,.000,177,283,.625,.615,83,155,.535,98,219,317,154,33,38,82,143,437
403,Jakob Poeltl\poeltja01,C,24,SAS,66,18,1171,166,266,.624,0,0,,166,266,.624,.624,40,86,.465,131,244,375,116,37,95,54,126,372
404,Vincent Poirier\poirivi01,C,26,BOS,22,0,130,17,36,.472,1,2,.500,16,34,.471,.486,6,7,.857,13,30,43,8,2,9,8,25,41
405,Shamorie Ponds\pondssh01,PG,21,TOR,4,0,11,3,5,.600,1,2,.500,2,3,.667,.700,2,2,1.000,0,1,1,2,0,1,0,2,9
406,Jordan Poole\poolejo01,SG,20,GSW,57,14,1274,167,502,.333,74,265,.279,93,237,.392,.406,95,119,.798,9,109,118,134,35,10,74,94,503
407,Kevin Porter Jr.\porteke02,SF,19,CLE,50,3,1162,186,421,.442,53,158,.335,133,263,.506,.505,73,101,.723,22,140,162,109,46,14,93,135,498
408,Michael Porter Jr.\portemi01,SF,21,DEN,55,8,903,195,383,.509,62,147,.422,133,236,.564,.590,60,72,.833,66,193,259,46,27,25,49,100,512
409,Otto Porter Jr.\porteot01,SF,26,CHI,14,9,331,62,140,.443,24,62,.387,38,78,.487,.529,19,27,.704,13,35,48,25,15,6,11,31,167
410,Bobby Portis\portibo01,PF,24,NYK,66,5,1393,265,589,.450,67,187,.358,198,402,.493,.507,71,93,.763,80,258,338,98,32,18,73,110,668
411,Kristaps Porziņģis\porzikr01,C,24,DAL,57,57,1814,398,932,.427,142,403,.352,256,529,.484,.503,226,283,.799,100,440,540,102,41,115,92,185,1164
412,Dwight Powell\poweldw01,C,28,DAL,40,37,1061,146,229,.638,10,39,.256,136,190,.716,.659,74,111,.667,75,152,227,59,34,22,36,102,376
413,Norman Powell\powelno01,SG,26,TOR,52,26,1479,296,598,.495,109,273,.399,187,325,.575,.586,129,153,.843,26,164,190,91,60,21,77,108,830
414,Taurean Prince\princta02,PF,25,BRK,64,61,1857,278,739,.376,146,431,.339,132,308,.429,.475,71,89,.798,50,331,381,116,57,25,127,159,773
415,Chasson Randle\randlch01,PG,26,GSW,3,0,40,0,4,.000,0,2,.000,0,2,.000,.000,5,6,.833,0,2,2,5,2,0,0,3,5
416,Julius Randle\randlju01,PF,25,NYK,64,64,2080,463,1006,.460,64,231,.277,399,775,.515,.492,258,352,.733,151,471,622,198,51,22,193,178,1248
417,Josh Reaves\reavejo02,SF,22,DAL,4,0,28,3,9,.333,0,2,.000,3,7,.429,.333,2,2,1.000,1,2,3,3,0,0,0,5,8
418,Cam Reddish\reddica01,SF,20,ATL,58,34,1551,213,554,.384,83,250,.332,130,304,.428,.459,101,126,.802,35,181,216,87,62,28,96,132,610
419,J.J. Redick\redicjj01,SG,35,NOP,60,36,1581,286,631,.453,180,397,.453,106,234,.453,.596,165,185,.892,10,141,151,119,20,10,75,96,917
420,Naz Reid\reidna01,C,20,MIN,30,11,495,100,243,.412,32,97,.330,68,146,.466,.477,37,53,.698,34,90,124,35,19,22,22,83,269
421,Josh Richardson\richajo01,SG,26,PHI,55,53,1693,278,646,.430,85,249,.341,193,397,.486,.496,114,141,.809,41,133,174,162,52,36,104,136,755
422,Austin Rivers\riverau01,SG,27,HOU,68,4,1594,211,501,.421,96,270,.356,115,231,.498,.517,78,111,.703,27,148,175,113,49,10,50,129,596
423,Andre Roberson\roberan03,SF,28,OKC,7,0,87,8,29,.276,3,14,.214,5,15,.333,.328,1,2,.500,7,20,27,4,1,3,2,13,20
424,Duncan Robinson\robindu01,SG,25,MIA,73,68,2166,323,687,.470,270,606,.446,53,81,.654,.667,67,72,.931,10,222,232,102,35,19,70,193,983
425,Glenn Robinson III\robingl02,SF,26,TOT,62,52,1786,288,592,.486,77,197,.391,211,395,.534,.552,74,86,.860,81,189,270,96,54,16,55,100,727
425,Glenn Robinson III\robingl02,SF,26,GSW,48,48,1516,244,507,.481,68,170,.400,176,337,.522,.548,63,74,.851,66,160,226,85,45,14,50,82,619
425,Glenn Robinson III\robingl02,SF,26,PHI,14,4,270,44,85,.518,9,27,.333,35,58,.603,.571,11,12,.917,15,29,44,11,9,2,5,18,108
426,Jerome Robinson\robinje01,SG,22,TOT,63,6,979,115,310,.371,49,153,.320,66,157,.420,.450,40,57,.702,13,116,129,87,28,17,49,112,319
426,Jerome Robinson\robinje01,SG,22,LAC,42,1,476,46,136,.338,19,67,.284,27,69,.391,.408,11,19,.579,5,55,60,46,13,8,26,55,122
426,Jerome Robinson\robinje01,SG,22,WAS,21,5,503,69,174,.397,30,86,.349,39,88,.443,.483,29,38,.763,8,61,69,41,15,9,23,57,197
427,Justin Robinson\robinju01,PG,22,WAS,9,0,49,5,12,.417,3,5,.600,2,7,.286,.542,0,0,,1,4,5,7,0,1,3,2,13
428,Mitchell Robinson\robinmi01,C,21,NYK,61,7,1412,253,341,.742,0,0,,253,341,.742,.742,84,148,.568,186,242,428,36,52,119,37,194,590
429,Isaiah Roby\robyis01,PF,21,OKC,3,0,11,0,1,.000,0,0,,0,1,.000,.000,0,0,,0,2,2,0,0,0,1,1,0
430,Rajon Rondo\rondora01,PG,33,LAL,48,3,984,137,328,.418,41,125,.328,96,203,.473,.480,27,41,.659,23,119,142,240,40,2,91,58,342
431,Derrick Rose\rosede01,PG,31,DET,50,15,1298,369,753,.490,45,147,.306,324,606,.535,.520,121,139,.871,27,94,121,278,40,16,126,49,904
432,Terrence Ross\rosste01,SG,28,ORL,69,0,1889,341,846,.403,177,504,.351,164,342,.480,.508,157,184,.853,13,209,222,82,77,24,70,109,1016
433,Terry Rozier\roziete01,PG,25,CHO,63,63,2164,398,941,.423,172,423,.407,226,518,.436,.514,166,190,.874,50,226,276,259,61,10,141,126,1134
434,Ricky Rubio\rubiori01,PG,29,PHO,65,65,2016,287,692,.415,78,216,.361,209,476,.439,.471,195,226,.863,46,258,304,570,94,11,173,167,847
435,D'Angelo Russell\russeda01,PG,23,TOT,45,45,1452,360,846,.426,158,431,.367,202,415,.487,.519,161,199,.809,17,160,177,285,48,13,147,86,1039
435,D'Angelo Russell\russeda01,PG,23,GSW,33,33,1060,273,635,.430,120,321,.374,153,314,.487,.524,113,144,.785,14,108,122,206,31,9,101,64,779
435,D'Angelo Russell\russeda01,PG,23,MIN,12,12,392,87,211,.412,38,110,.345,49,101,.485,.502,48,55,.873,3,52,55,79,17,4,46,22,260
436,Domantas Sabonis\sabondo01,PF,23,IND,62,62,2159,458,848,.540,17,67,.254,441,781,.565,.550,214,296,.723,189,582,771,310,47,30,170,195,1147
437,Luka Šamanić\samanlu01,PF,20,SAS,3,1,48,5,16,.313,3,8,.375,2,8,.250,.406,3,4,.750,1,9,10,6,0,2,2,6,16
438,JaKarr Sampson\sampsja02,PF,26,IND,34,12,471,68,115,.591,2,13,.154,66,102,.647,.600,18,27,.667,20,68,88,21,16,12,15,64,156
439,Dario Šarić\saricda01,PF,25,PHO,66,51,1632,256,538,.476,84,235,.357,172,303,.568,.554,108,128,.844,100,306,406,123,37,16,88,156,704
440,Tomáš Satoranský\satorto01,SG,28,CHI,65,64,1878,237,551,.430,64,199,.322,173,352,.491,.488,106,121,.876,76,178,254,354,80,7,130,135,644
441,Admiral Schofield\schofad01,PF,22,WAS,33,2,368,35,92,.380,19,61,.311,16,31,.516,.484,10,15,.667,7,40,47,15,8,4,7,50,99
442,Dennis Schröder\schrode01,PG,26,OKC,65,2,1999,453,965,.469,125,325,.385,328,640,.513,.534,198,236,.839,19,217,236,262,45,14,166,146,1229
443,Mike Scott\scottmi01,PF,31,PHI,68,11,1207,149,350,.426,80,217,.369,69,133,.519,.540,30,37,.811,65,183,248,56,21,5,26,96,408
444,Thabo Sefolosha\sefolth01,PF,35,HOU,41,0,436,37,91,.407,15,54,.278,22,37,.595,.489,3,8,.375,21,72,93,25,24,12,15,43,92
445,Collin Sexton\sextoco01,PG,21,CLE,65,65,2143,513,1086,.472,97,255,.380,416,831,.501,.517,226,267,.846,61,143,204,192,65,7,158,142,1349
446,Landry Shamet\shamela01,SG,22,LAC,53,30,1452,158,391,.404,111,296,.375,47,95,.495,.546,65,76,.855,6,94,100,99,20,10,42,142,492
447,Marial Shayok\shayoma01,SG,24,PHI,4,0,28,3,12,.250,2,6,.333,1,6,.167,.333,3,4,.750,1,6,7,1,0,1,3,4,11
448,Iman Shumpert\shumpim01,SF,29,BRK,13,0,241,21,64,.328,8,33,.242,13,31,.419,.391,4,7,.571,9,25,34,12,12,2,10,21,54
449,Pascal Siakam\siakapa01,PF,25,TOR,60,60,2110,500,1104,.453,131,365,.359,369,739,.499,.512,240,303,.792,64,375,439,207,61,53,148,170,1371
450,Chris Silva\silvach01,PF,23,MIA,44,0,346,48,78,.615,0,3,.000,48,75,.640,.615,37,55,.673,60,66,126,23,9,21,32,85,133
451,Ben Simmons\simmobe01,PG,23,PHI,57,57,2017,375,647,.580,2,7,.286,373,640,.583,.581,185,298,.621,113,331,444,455,119,33,200,186,937
452,Anfernee Simons\simonan01,SG,20,POR,70,4,1449,214,536,.399,75,226,.332,139,310,.448,.469,76,92,.826,25,127,152,97,26,10,61,135,579
453,Alen Smailagić\smailal01,C,19,GSW,14,0,139,20,40,.500,3,13,.231,17,27,.630,.538,16,19,.842,10,17,27,13,3,4,11,14,59
454,Marcus Smart\smartma01,SG,25,BOS,60,40,1919,256,682,.375,137,395,.347,119,287,.415,.476,127,152,.836,42,183,225,291,101,29,103,162,776
455,Dennis Smith Jr.\smithde03,PG,22,NYK,34,3,537,72,211,.341,16,54,.296,56,157,.357,.379,27,53,.509,21,57,78,98,28,8,58,65,187
456,Ish Smith\smithis01,PG,31,WAS,68,23,1787,308,689,.447,62,169,.367,246,520,.473,.492,62,86,.721,30,189,219,334,59,30,95,106,740
457,J.R. Smith\smithjr01,SG,34,LAL,6,0,79,7,22,.318,1,11,.091,6,11,.545,.341,2,2,1.000,0,5,5,3,1,0,4,5,17
458,Zhaire Smith\smithzh01,SF,20,PHI,7,0,32,3,11,.273,0,3,.000,3,8,.375,.273,2,4,.500,0,2,2,2,3,0,2,4,8
459,Tony Snell\snellto01,SF,28,DET,59,57,1641,170,382,.445,102,254,.402,68,128,.531,.579,32,32,1.000,9,102,111,127,32,15,31,101,474
460,Omari Spellman\spellom01,C,22,GSW,49,3,886,127,295,.431,43,110,.391,84,185,.454,.503,73,92,.793,77,142,219,47,33,24,54,63,370
461,Max Strus\strusma01,SF,23,CHI,2,0,6,2,3,.667,0,1,.000,2,2,1.000,.667,1,1,1.000,1,0,1,0,0,0,0,1,5
462,Edmond Sumner\sumneed01,SG,24,IND,31,3,447,61,142,.430,14,53,.264,47,89,.528,.479,16,29,.552,11,35,46,55,15,9,22,44,152
463,Caleb Swanigan\swanica01,PF-C,22,TOT,27,1,288,28,47,.596,0,2,.000,28,45,.622,.596,9,17,.529,27,73,100,31,3,7,37,62,65
463,Caleb Swanigan\swanica01,C,22,SAC,7,0,23,2,4,.500,0,0,,2,4,.500,.500,1,2,.500,2,5,7,2,1,2,6,8,5
463,Caleb Swanigan\swanica01,PF,22,POR,20,1,265,26,43,.605,0,2,.000,26,41,.634,.605,8,15,.533,25,68,93,29,2,5,31,54,60
464,Jayson Tatum\tatumja01,PF,21,BOS,66,66,2265,552,1226,.450,189,469,.403,363,757,.480,.527,254,313,.812,64,396,460,200,93,57,155,136,1547
465,Jeff Teague\teaguje01,PG,31,TOT,59,17,1464,213,489,.436,43,117,.368,170,372,.457,.480,172,197,.873,27,115,142,308,44,19,116,106,641
465,Jeff Teague\teaguje01,PG,31,MIN,34,13,945,145,324,.448,33,87,.379,112,237,.473,.498,125,144,.868,15,73,88,208,25,13,76,70,448
465,Jeff Teague\teaguje01,PG,31,ATL,25,4,519,68,165,.412,10,30,.333,58,135,.430,.442,47,53,.887,12,42,54,100,19,6,40,36,193
466,Garrett Temple\templga01,SG,33,BRK,62,35,1730,222,587,.378,127,386,.329,95,201,.473,.486,70,87,.805,29,189,218,156,49,29,62,108,641
467,Daniel Theis\theisda01,C,27,BOS,65,64,1566,241,426,.566,32,96,.333,209,330,.633,.603,87,114,.763,140,286,426,111,37,84,54,219,601
468,Isaiah Thomas\thomais02,PG,30,WAS,40,37,925,174,426,.408,78,189,.413,96,237,.405,.500,62,76,.816,11,57,68,146,13,6,77,77,488
469,Khyri Thomas\thomakh01,SG,23,DET,8,0,61,5,17,.294,5,14,.357,0,3,.000,.441,2,4,.500,1,0,1,3,3,0,3,9,17
470,Lance Thomas\thomala01,PF,31,BRK,7,4,98,8,23,.348,4,13,.308,4,10,.400,.435,4,4,1.000,2,11,13,6,0,0,6,11,24
471,Matt Thomas\thomama02,SG,25,TOR,41,1,440,73,150,.487,47,99,.475,26,51,.510,.643,9,12,.750,9,52,61,22,10,1,16,38,202
472,Tristan Thompson\thomptr01,PF,28,CLE,57,51,1721,288,562,.512,9,23,.391,279,539,.518,.520,99,161,.615,226,351,577,120,33,50,103,124,684
473,Sindarius Thornwell\thornsi01,SF,25,NOP,2,0,35,6,11,.545,2,4,.500,4,7,.571,.636,2,4,.500,0,4,4,4,1,1,2,2,16
474,Matisse Thybulle\thybuma01,SG,22,PHI,65,14,1287,112,265,.423,56,157,.357,56,108,.519,.528,25,41,.610,44,63,107,79,94,47,51,141,305
475,Anthony Tolliver\tollian01,PF,34,TOT,55,13,872,65,182,.357,49,145,.338,16,37,.432,.492,21,29,.724,34,120,154,42,19,11,34,74,200
475,Anthony Tolliver\tollian01,PF,34,POR,33,9,554,43,117,.368,30,89,.337,13,28,.464,.496,13,19,.684,27,83,110,29,8,9,21,54,129
475,Anthony Tolliver\tollian01,PF,34,SAC,9,0,82,3,17,.176,2,15,.133,1,2,.500,.235,1,2,.500,2,9,11,3,4,1,4,6,9
475,Anthony Tolliver\tollian01,PF,34,MEM,13,4,236,19,48,.396,17,41,.415,2,7,.286,.573,7,8,.875,5,28,33,10,7,1,9,14,62
476,Juan Toscano-Anderson\toscaju01,SG,26,GSW,13,6,272,29,63,.460,8,23,.348,21,40,.525,.524,3,5,.600,9,43,52,26,13,5,16,30,69
477,Karl-Anthony Towns\townska01,C,24,MIN,35,35,1187,316,622,.508,114,277,.412,202,345,.586,.600,180,226,.796,95,283,378,153,33,42,110,117,926
478,Gary Trent Jr.\trentga02,SF,21,POR,61,8,1332,196,441,.444,112,268,.418,84,173,.486,.571,37,45,.822,25,75,100,61,48,16,21,90,541
479,Allonzo Trier\trieral01,SG,24,NYK,24,1,291,51,106,.481,19,53,.358,32,53,.604,.571,34,43,.791,6,23,29,28,3,4,22,29,155
480,P.J. Tucker\tuckepj01,PF,34,HOU,72,72,2467,177,426,.415,107,299,.358,70,127,.551,.541,39,48,.813,112,364,476,115,77,36,72,229,500
481,Rayjon Tucker\tuckera01,SG,22,UTA,20,0,161,20,43,.465,3,17,.176,17,26,.654,.500,19,23,.826,3,17,20,5,1,1,8,10,62
482,Evan Turner\turneev01,SG,31,ATL,19,0,251,25,67,.373,0,5,.000,25,62,.403,.373,12,14,.857,8,30,38,38,9,8,26,20,62
483,Myles Turner\turnemy01,C,23,IND,62,62,1826,268,587,.457,86,250,.344,182,337,.540,.530,127,169,.751,86,321,407,72,46,132,85,166,749
484,Jarrod Uthoff\uthofja01,PF,26,TOT,7,0,53,7,18,.389,3,9,.333,4,9,.444,.472,2,2,1.000,2,4,6,0,1,0,0,2,19
484,Jarrod Uthoff\uthofja01,PF,26,MEM,4,0,14,1,7,.143,0,4,.000,1,3,.333,.143,2,2,1.000,1,0,1,0,1,0,0,1,4
484,Jarrod Uthoff\uthofja01,PF,26,WAS,3,0,39,6,11,.545,3,5,.600,3,6,.500,.682,0,0,,1,4,5,0,0,0,0,1,15
485,Jonas Valančiūnas\valanjo01,C,27,MEM,70,70,1845,432,739,.585,32,91,.352,400,648,.617,.606,148,200,.740,213,575,788,131,30,76,127,185,1044
486,Denzel Valentine\valende01,SF,26,CHI,36,5,488,97,237,.409,46,137,.336,51,100,.510,.506,6,8,.750,9,65,74,43,26,6,26,51,246
487,Jarred Vanderbilt\vandeja01,PF,20,TOT,11,0,46,5,8,.625,0,1,.000,5,7,.714,.625,2,2,1.000,3,6,9,2,3,1,7,6,12
487,Jarred Vanderbilt\vandeja01,PF,20,DEN,9,0,41,5,7,.714,0,0,,5,7,.714,.714,0,0,,3,5,8,2,3,1,7,6,10
487,Jarred Vanderbilt\vandeja01,PF,20,MIN,2,0,5,0,1,.000,0,1,.000,0,0,,.000,2,2,1.000,0,1,1,0,0,0,0,0,2
488,Fred VanVleet\vanvlfr01,SG,25,TOR,54,54,1928,319,773,.413,146,374,.390,173,399,.434,.507,168,198,.848,18,185,203,357,100,17,121,132,952
489,Gabe Vincent\vincega01,PG,23,MIA,9,0,83,8,37,.216,6,27,.222,2,10,.200,.297,0,0,,0,5,5,6,5,0,1,6,22
490,Noah Vonleh\vonleno01,C,24,TOT,36,1,377,52,92,.565,3,15,.200,49,77,.636,.582,25,32,.781,37,87,124,28,11,6,21,40,132
490,Noah Vonleh\vonleno01,C,24,MIN,29,1,347,47,86,.547,2,14,.143,45,72,.625,.558,23,28,.821,34,82,116,26,11,6,19,36,119
490,Noah Vonleh\vonleno01,C,24,DEN,7,0,30,5,6,.833,1,1,1.000,4,5,.800,.917,2,4,.500,3,5,8,2,0,0,2,4,13
491,Nikola Vučević\vucevni01,C,29,ORL,62,62,1998,493,1033,.477,98,289,.339,395,744,.531,.525,131,167,.784,140,533,673,222,54,47,88,135,1215
492,Dean Wade\wadede01,PF,23,CLE,12,0,71,9,13,.692,2,4,.500,7,9,.778,.769,0,1,.000,3,16,19,2,2,4,3,8,20
493,Moritz Wagner\wagnemo01,C,22,WAS,45,5,835,145,266,.545,25,80,.313,120,186,.645,.592,78,95,.821,56,163,219,56,28,19,66,152,393
494,Dion Waiters\waitedi01,SG,28,TOT,10,0,207,41,99,.414,15,47,.319,26,52,.500,.490,14,17,.824,2,22,24,20,4,6,16,21,111
494,Dion Waiters\waitedi01,SG,28,MIA,3,0,42,10,26,.385,8,17,.471,2,9,.222,.538,0,1,.000,0,11,11,3,0,2,3,5,28
494,Dion Waiters\waitedi01,SG,28,LAL,7,0,165,31,73,.425,7,30,.233,24,43,.558,.473,14,16,.875,2,11,13,17,4,4,13,16,83
495,Kemba Walker\walkeke02,PG,29,BOS,56,56,1742,378,889,.425,180,473,.381,198,416,.476,.526,209,242,.864,36,181,217,268,48,28,117,91,1145
496,Lonnie Walker IV\walkelo01,SG,21,SAS,61,12,988,152,357,.426,41,101,.406,111,256,.434,.483,44,61,.721,23,116,139,68,32,14,44,78,389
497,Tyrone Wallace\wallaty01,SG,25,ATL,14,0,160,14,44,.318,1,15,.067,13,29,.448,.330,11,17,.647,3,19,22,13,7,1,10,19,40
498,Derrick Walton\waltode01,PG,24,TOT,26,1,248,18,39,.462,10,24,.417,8,15,.533,.590,7,9,.778,2,14,16,27,7,0,5,21,53
498,Derrick Walton\waltode01,PG,24,LAC,23,1,222,17,36,.472,9,21,.429,8,15,.533,.597,7,9,.778,2,13,15,22,4,0,4,19,50
498,Derrick Walton\waltode01,PG,24,DET,3,0,26,1,3,.333,1,3,.333,0,0,,.500,0,0,,0,1,1,5,3,0,1,2,3
499,Brad Wanamaker\wanambr01,PG,30,BOS,71,1,1369,162,362,.448,37,102,.363,125,260,.481,.499,126,136,.926,22,122,144,179,61,14,76,133,487
500,T.J. Warren\warretj01,SF,26,IND,67,67,2202,534,997,.536,91,226,.403,443,771,.575,.581,167,204,.819,68,212,280,99,78,34,84,187,1326
501,P.J. Washington\washipj01,PF,21,CHO,58,57,1759,268,589,.455,86,230,.374,182,359,.507,.528,88,136,.647,58,258,316,123,51,44,93,158,710
502,Yuta Watanabe\watanyu01,SF,25,MEM,18,0,105,15,34,.441,3,8,.375,12,26,.462,.485,3,8,.375,7,13,20,5,5,1,2,9,36
503,Tremont Waters\watertr01,PG,22,BOS,11,1,119,14,49,.286,4,24,.167,10,25,.400,.327,8,8,1.000,0,12,12,16,10,2,15,13,40
504,Paul Watson\watsopa01,SF,25,TOT,10,0,87,10,26,.385,4,12,.333,6,14,.429,.462,7,9,.778,2,15,17,8,4,1,3,5,31
504,Paul Watson\watsopa01,SF,25,ATL,2,0,17,0,7,.000,0,3,.000,0,4,.000,.000,0,0,,0,2,2,3,1,0,0,1,0
504,Paul Watson\watsopa01,SF,25,TOR,8,0,70,10,19,.526,4,9,.444,6,10,.600,.632,7,9,.778,2,13,15,5,3,1,3,4,31
505,Quinndary Weatherspoon\weathqu01,SG,23,SAS,11,0,78,5,17,.294,1,5,.200,4,12,.333,.324,1,2,.500,1,6,7,11,3,1,5,8,12
506,Russell Westbrook\westbru01,PG,31,HOU,57,57,2049,604,1281,.472,55,213,.258,549,1068,.514,.493,290,380,.763,100,351,451,401,93,20,255,200,1553
507,Coby White\whiteco01,PG,19,CHI,65,1,1674,312,792,.394,133,376,.354,179,416,.430,.478,102,129,.791,28,202,230,175,49,6,109,117,859
508,Derrick White\whitede01,SG,25,SAS,68,20,1677,253,552,.458,79,216,.366,174,336,.518,.530,180,211,.853,35,188,223,241,44,59,89,152,765
509,Hassan Whiteside\whiteha01,C,30,POR,67,61,2008,436,702,.621,4,7,.571,432,695,.622,.624,164,239,.686,258,647,905,78,26,196,120,196,1040
510,Andrew Wiggins\wiggian01,SF,24,TOT,54,54,1858,437,978,.447,111,334,.332,326,644,.506,.504,190,268,.709,66,208,274,198,45,53,132,127,1175
510,Andrew Wiggins\wiggian01,SF,24,MIN,42,42,1455,351,790,.444,91,275,.331,260,515,.505,.502,149,207,.720,48,171,219,155,29,36,107,101,942
510,Andrew Wiggins\wiggian01,SF,24,GSW,12,12,403,86,188,.457,20,59,.339,66,129,.512,.511,41,61,.672,18,37,55,43,16,17,25,26,233
511,Grant Williams\willigr01,PF,21,BOS,69,5,1043,87,211,.412,24,96,.250,63,115,.548,.469,39,54,.722,59,119,178,68,30,36,50,163,237
512,Johnathan Williams\willijo04,PF,24,WAS,15,6,180,19,34,.559,0,2,.000,19,32,.594,.559,7,13,.538,24,40,64,8,1,8,5,16,45
513,Kenrich Williams\willike04,PF,25,NOP,39,18,832,51,147,.347,25,97,.258,26,50,.520,.432,9,26,.346,51,135,186,57,27,21,22,88,136
514,Lou Williams\willilo02,PG,33,LAC,65,8,1864,391,936,.418,111,315,.352,280,621,.451,.477,292,339,.861,31,170,201,365,43,12,182,80,1185
515,Marvin Williams\willima02,PF,33,TOT,58,1,1129,119,267,.446,56,156,.359,63,111,.568,.551,49,57,.860,30,153,183,60,36,30,33,103,343
515,Marvin Williams\willima02,PF,33,CHO,41,1,808,94,210,.448,44,117,.376,50,93,.538,.552,43,50,.860,15,94,109,41,26,22,25,71,275
515,Marvin Williams\willima02,PF,33,MIL,17,0,321,25,57,.439,12,39,.308,13,18,.722,.544,6,7,.857,15,59,74,19,10,8,8,32,68
516,Robert Williams\williro04,C,22,BOS,29,1,388,64,88,.727,0,0,,64,88,.727,.727,22,34,.647,40,88,128,27,22,35,21,51,150
517,Nigel Williams-Goss\willini01,PG,25,UTA,10,0,50,5,16,.313,2,7,.286,3,9,.333,.375,2,2,1.000,2,4,6,6,3,1,3,6,14
518,Zion Williamson\willizi01,PF,19,NOP,24,24,668,210,360,.583,6,14,.429,204,346,.590,.592,114,178,.640,64,86,150,50,16,9,59,42,540
519,D.J. Wilson\wilsodj01,PF,23,MIL,37,1,363,52,132,.394,18,73,.247,34,59,.576,.462,11,18,.611,12,80,92,25,3,5,19,33,133
520,Justise Winslow\winslju01,SG,23,MIA,11,5,352,50,129,.388,6,27,.222,44,102,.431,.411,18,27,.667,16,57,73,44,7,5,24,38,124
521,Christian Wood\woodch01,PF,24,DET,62,12,1325,288,508,.567,54,140,.386,234,368,.636,.620,180,242,.744,104,286,390,60,34,54,84,98,810
522,Delon Wright\wrighde01,PG,27,DAL,73,5,1570,190,411,.462,47,127,.370,143,284,.504,.519,77,100,.770,70,210,280,244,85,22,73,93,504
523,Justin Wright-Foreman\wrighju02,PG,22,UTA,4,0,45,7,20,.350,2,10,.200,5,10,.500,.400,3,4,.750,0,5,5,7,2,0,3,5,19
524,Thaddeus Young\youngth01,PF,31,CHI,64,16,1591,269,601,.448,79,222,.356,190,379,.501,.513,42,72,.583,94,221,315,117,92,23,102,134,659
525,Trae Young\youngtr01,PG,21,ATL,60,60,2120,546,1249,.437,205,568,.361,341,681,.501,.519,481,559,.860,32,223,255,560,65,8,289,104,1778
526,Cody Zeller\zelleco01,C,27,CHO,58,39,1341,251,479,.524,18,75,.240,233,404,.577,.543,122,179,.682,160,251,411,88,40,25,75,140,642
527,Tyler Zeller\zellety01,C,30,SAS,2,0,4,1,4,.250,0,0,,1,4,.250,.250,0,0,,3,1,4,0,0,0,0,0,2
528,Ante Žižić\zizican01,C,23,CLE,22,0,221,41,72,.569,0,0,,41,72,.569,.569,14,19,.737,18,48,66,6,7,5,10,27,96
529,Ivica Zubac\zubaciv01,C,22,LAC,72,70,1326,236,385,.613,0,2,.000,236,383,.616,.613,124,166,.747,197,346,543,82,16,66,61,168,596