Rk,Player,Pos,Age,Tm,G,GS,MP,FG,FGA,FG%,3P,3PA,3P%,2P,2PA,2P%,eFG%,FT,FTA,FT%,ORB,DRB,TRB,AST,STL,BLK,TOV,PF,PTS
1,Precious Achiuwa\achiupr01,PF,21,MIA,61,4,737,124,228,.544,0,1,.000,124,227,.546,.544,56,110,.509,73,135,208,29,20,28,43,91,304
2,Jaylen Adams\adamsja01,PG,24,MIL,7,0,18,1,8,.125,0,2,.000,1,6,.167,.125,0,0,,0,3,3,2,0,0,0,1,2
3,Steven Adams\adamsst01,C,27,NOP,58,58,1605,189,308,.614,0,3,.000,189,305,.620,.614,60,135,.444,213,301,514,111,54,38,78,113,438
4,Bam Adebayo\adebaba01,C,23,MIA,64,64,2143,456,800,.570,2,8,.250,454,792,.573,.571,283,354,.799,142,431,573,346,75,66,169,145,1197
5,LaMarcus Aldridge\aldrila01,C,35,TOT,26,23,674,140,296,.473,31,80,.388,109,216,.505,.525,41,47,.872,19,99,118,49,11,29,27,47,352
5,LaMarcus Aldridge\aldrila01,C,35,SAS,21,18,544,115,248,.464,27,75,.360,88,173,.509,.518,31,37,.838,17,77,94,36,8,18,20,36,288
5,LaMarcus Aldridge\aldrila01,C,35,BRK,5,5,130,25,48,.521,4,5,.800,21,43,.488,.563,10,10,1.000,2,22,24,13,3,11,7,11,64
6,Ty-Shon Alexander\alexaty01,SG,22,PHO,15,0,47,3,12,.250,2,9,.222,1,3,.333,.333,1,2,.500,2,8,10,6,0,1,3,2,9
7,Nickeil Alexander-Walker\alexani01,SG,22,NOP,46,13,1007,192,458,.419,76,219,.347,116,239,.485,.502,48,66,.727,13,131,144,102,47,22,69,88,508
8,Grayson Allen\allengr01,SG,25,MEM,50,38,1259,173,414,.418,107,274,.391,66,140,.471,.547,79,91,.868,19,141,160,108,46,8,48,71,532
9,Jarrett Allen\allenja01,C,22,TOT,63,45,1864,298,482,.618,6,19,.316,292,463,.631,.624,204,290,.703,196,435,631,106,32,90,100,96,806
9,Jarrett Allen\allenja01,C,22,BRK,12,5,320,44,65,.677,0,0,,44,65,.677,.677,46,61,.754,38,87,125,20,7,19,22,21,134
9,Jarrett Allen\allenja01,C,22,CLE,51,40,1544,254,417,.609,6,19,.316,248,398,.623,.616,158,229,.690,158,348,506,86,25,71,78,75,672
10,Al-Farouq Aminu\aminual01,PF,30,TOT,23,14,434,38,99,.384,8,37,.216,30,62,.484,.424,18,22,.818,22,88,110,31,19,9,28,29,102
10,Al-Farouq Aminu\aminual01,PF,30,ORL,17,14,367,36,89,.404,7,31,.226,29,58,.500,.444,14,17,.824,20,71,91,29,17,9,25,22,93
10,Al-Farouq Aminu\aminual01,PF,30,CHI,6,0,67,2,10,.200,1,6,.167,1,4,.250,.250,4,5,.800,2,17,19,2,2,0,3,7,9
11,Kyle Anderson\anderky01,PF,27,MEM,69,69,1887,308,658,.468,94,261,.360,214,397,.539,.540,144,184,.783,52,344,396,250,84,57,86,120,854
12,Giannis Antetokounmpo\antetgi01,PF,26,MIL,61,61,2013,626,1100,.569,67,221,.303,559,879,.636,.600,398,581,.685,97,574,671,357,72,73,207,168,1717
13,Kostas Antetokounmpo\antetko01,PF,23,LAL,15,0,56,3,10,.300,0,0,,3,10,.300,.300,6,13,.462,4,15,19,1,2,4,11,8,12
14,Thanasis Antetokounmpo\antetth01,SF,28,MIL,57,3,551,67,137,.489,7,29,.241,60,108,.556,.515,25,49,.510,54,70,124,46,22,10,43,74,166
15,Carmelo Anthony\anthoca01,PF,36,POR,69,3,1690,327,777,.421,133,325,.409,194,452,.429,.506,137,154,.890,32,182,214,104,46,38,61,144,924
16,Cole Anthony\anthoco01,PG,20,ORL,47,34,1273,219,552,.397,58,172,.337,161,380,.424,.449,109,131,.832,38,183,221,192,30,18,106,98,605
17,OG Anunoby\anunoog01,SF,23,TOR,43,43,1433,249,519,.480,104,261,.398,145,258,.562,.580,80,102,.784,54,183,237,94,66,32,75,114,682
18,Ryan Arcidiacono\arcidry01,PG,26,CHI,44,0,450,49,117,.419,25,67,.373,24,50,.480,.526,13,20,.650,5,62,67,56,9,0,10,47,136
19,Trevor Ariza\arizatr01,SF,35,MIA,30,27,841,99,241,.411,50,143,.350,49,98,.500,.515,34,44,.773,27,117,144,55,31,18,21,55,282
20,D.J. Augustin\augusdj01,PG,33,TOT,57,12,1129,135,343,.394,83,217,.382,52,126,.413,.515,85,94,.904,20,74,94,188,28,1,65,56,438
20,D.J. Augustin\augusdj01,PG,33,MIL,37,6,713,71,192,.370,49,129,.380,22,63,.349,.497,36,40,.900,11,39,50,110,20,1,34,33,227
20,D.J. Augustin\augusdj01,PG,33,HOU,20,6,416,64,151,.424,34,88,.386,30,63,.476,.536,49,54,.907,9,35,44,78,8,0,31,23,211
21,Deni Avdija\avdijde01,SF,20,WAS,54,32,1257,130,312,.417,53,168,.315,77,144,.535,.502,29,45,.644,22,240,262,63,32,15,33,140,342
22,Deandre Ayton\aytonde01,C,22,PHO,69,69,2115,430,687,.626,4,20,.200,426,667,.639,.629,133,173,.769,228,499,727,99,41,81,103,196,997
23,Udoka Azubuike\azubuud01,C,21,UTA,15,0,57,4,9,.444,0,0,,4,9,.444,.444,8,10,.800,4,9,13,0,1,4,3,9,16
24,Dwayne Bacon\bacondw01,SG,25,ORL,72,50,1853,292,726,.402,59,207,.285,233,519,.449,.443,145,176,.824,31,193,224,93,45,5,46,103,788
25,Marvin Bagley III\baglema01,PF,21,SAC,43,42,1112,247,490,.504,37,108,.343,210,382,.550,.542,77,134,.575,106,212,318,43,21,21,59,100,608
26,LaMelo Ball\ballla01,PG,19,CHO,51,31,1469,293,672,.436,92,261,.352,201,411,.489,.504,125,165,.758,63,239,302,313,81,18,145,136,803
27,Lonzo Ball\balllo01,PG,23,NOP,55,55,1747,290,700,.414,172,455,.378,118,245,.482,.537,50,64,.781,33,230,263,316,82,31,123,103,802
28,Mo Bamba\bambamo01,C,22,ORL,46,5,725,142,301,.472,38,118,.322,104,183,.568,.535,45,66,.682,76,189,265,35,14,58,36,87,367
29,Desmond Bane\banede01,SG,22,MEM,68,17,1519,234,499,.469,117,271,.432,117,228,.513,.586,40,49,.816,31,179,210,118,41,16,59,125,625
30,Harrison Barnes\barneha02,PF,28,SAC,58,58,2102,319,642,.497,100,256,.391,219,386,.567,.575,195,235,.830,64,321,385,201,43,11,93,75,933
31,RJ Barrett\barrerj01,SG,20,NYK,72,72,2511,467,1060,.441,124,309,.401,343,751,.457,.499,206,276,.746,68,346,414,217,53,20,139,188,1264
32,Will Barton\bartowi01,SF,30,DEN,56,52,1736,259,608,.426,98,257,.381,161,351,.459,.507,95,121,.785,39,187,226,181,50,23,96,95,711
33,Keita Bates-Diop\bateske01,SF,25,SAS,30,0,245,30,67,.448,5,17,.294,25,50,.500,.485,14,21,.667,9,40,49,12,11,5,7,11,79
34,Nicolas Batum\batumni01,SF,32,LAC,67,38,1835,191,412,.464,110,272,.404,81,140,.579,.597,48,58,.828,50,266,316,148,69,37,53,102,540
35,Aron Baynes\baynear01,C,34,TOR,53,31,980,134,304,.441,27,103,.262,107,201,.532,.485,29,41,.707,87,186,273,47,17,23,46,119,324
36,Kent Bazemore\bazemke01,SF,31,GSW,67,18,1333,176,392,.449,75,184,.408,101,208,.486,.545,54,78,.692,26,203,229,108,69,33,82,158,481
37,Darius Bazley\bazleda01,PF,20,OKC,55,55,1714,273,690,.396,83,286,.290,190,404,.470,.456,125,178,.702,51,345,396,99,29,25,122,60,754
38,Bradley Beal\bealbr01,SG,27,WAS,60,60,2147,670,1382,.485,130,373,.349,540,1009,.535,.532,408,459,.889,72,211,283,265,69,22,187,140,1878
39,Malik Beasley\beaslma01,SG,24,MIN,37,36,1214,264,600,.440,128,321,.399,136,279,.487,.547,68,80,.850,28,134,162,88,30,7,60,62,724
40,Jordan Bell\belljo01,C,26,TOT,6,1,82,7,22,.318,0,2,.000,7,20,.350,.318,1,2,.500,7,17,24,7,3,5,4,7,15
40,Jordan Bell\belljo01,C,26,WAS,5,1,67,7,20,.350,0,2,.000,7,18,.389,.350,0,0,,6,13,19,5,3,3,3,5,14
40,Jordan Bell\belljo01,C,26,GSW,1,0,15,0,2,.000,0,0,,0,2,.000,.000,1,2,.500,1,4,5,2,0,2,1,2,1
41,DeAndre' Bembry\bembrde01,SF,26,TOR,51,12,972,117,228,.513,14,53,.264,103,175,.589,.544,45,66,.682,33,113,146,107,53,18,71,87,293
42,Dāvis Bertāns\bertada01,PF,28,WAS,57,7,1464,193,478,.404,169,428,.395,24,50,.480,.581,100,115,.870,18,150,168,49,33,13,33,136,655
43,Patrick Beverley\beverpa01,PG,32,LAC,37,34,832,93,220,.423,56,141,.397,37,79,.468,.550,36,45,.800,29,90,119,76,29,28,34,108,278
44,Saddiq Bey\beysa01,SF,21,DET,70,53,1909,279,691,.404,175,460,.380,104,231,.450,.530,124,147,.844,43,275,318,95,52,14,60,110,857
45,Tyler Bey\beyty01,SF,22,DAL,18,0,71,7,22,.318,1,4,.250,6,18,.333,.341,3,5,.600,8,11,19,3,0,1,3,6,18
46,Khem Birch\birchkh01,C,28,TOT,67,22,1529,189,380,.497,13,52,.250,176,328,.537,.514,91,129,.705,174,213,387,89,48,50,44,113,482
46,Khem Birch\birchkh01,C,28,ORL,48,5,952,94,209,.450,4,21,.190,90,188,.479,.459,63,85,.741,117,126,243,53,32,28,23,67,255
46,Khem Birch\birchkh01,C,28,TOR,19,17,577,95,171,.556,9,31,.290,86,140,.614,.582,28,44,.636,57,87,144,36,16,22,21,46,227
47,Goga Bitadze\bitadgo01,C,21,IND,45,3,561,83,194,.428,20,79,.253,63,115,.548,.479,45,61,.738,60,90,150,37,9,60,17,94,231
48,Bismack Biyombo\biyombi01,C,28,CHO,66,36,1349,142,242,.587,0,1,.000,142,241,.589,.587,47,105,.448,137,210,347,81,17,74,71,141,331
49,Nemanja Bjelica\bjeline01,PF,32,TOT,37,3,595,89,196,.454,27,85,.318,62,111,.559,.523,37,51,.725,29,98,127,69,15,5,33,68,242
49,Nemanja Bjelica\bjeline01,PF,32,SAC,26,1,439,69,150,.460,17,58,.293,52,92,.565,.517,32,42,.762,24,76,100,49,8,2,28,48,187
49,Nemanja Bjelica\bjeline01,PF,32,MIA,11,2,156,20,46,.435,10,27,.370,10,19,.526,.543,5,9,.556,5,22,27,20,7,3,5,20,55
50,Eric Bledsoe\bledser01,SG,31,NOP,71,70,2111,307,730,.421,121,355,.341,186,375,.496,.503,134,195,.687,29,215,244,268,55,24,114,112,869
51,Keljin Blevins\blevike01,SF,25,POR,17,0,75,5,20,.250,2,8,.250,3,12,.250,.300,0,0,,3,7,10,4,2,0,5,8,12
52,Bogdan Bogdanović\bogdabo01,SG,28,ATL,44,27,1305,267,565,.473,146,333,.438,121,232,.522,.602,40,44,.909,20,140,160,147,49,13,54,99,720
53,Bojan Bogdanović\bogdabo02,SF,31,UTA,72,72,2216,406,925,.439,180,461,.390,226,464,.487,.536,233,265,.879,40,241,281,136,45,4,128,115,1225
54,Bol Bol\bolbo01,PF,21,DEN,32,2,160,25,58,.431,9,24,.375,16,34,.471,.509,10,15,.667,0,24,24,7,3,10,13,14,69
55,Marques Bolden\boldema01,C,22,CLE,6,0,29,1,3,.333,0,0,,1,3,.333,.333,5,8,.625,3,3,6,0,2,2,2,0,7
56,Jordan Bone\bonejo01,PG,23,ORL,14,0,196,23,54,.426,10,32,.313,13,22,.591,.519,0,0,,4,20,24,18,2,0,3,11,56
57,Isaac Bonga\bongais01,SF,21,WAS,40,8,432,30,81,.370,13,47,.277,17,34,.500,.451,5,8,.625,18,48,66,23,11,9,22,63,78
58,Devin Booker\bookede01,SG,24,PHO,67,67,2270,623,1287,.484,126,371,.340,497,916,.543,.533,340,392,.867,34,247,281,289,53,16,207,181,1712
59,Chris Boucher\bouchch01,C,28,TOR,60,14,1453,288,560,.514,90,235,.383,198,325,.609,.595,152,193,.788,117,287,404,63,35,111,46,166,818
60,Brian Bowen\bowenbr02,SF,22,IND,6,0,15,1,4,.250,0,1,.000,1,3,.333,.250,1,1,1.000,0,3,3,0,0,0,0,1,3
61,Avery Bradley\bradlav01,SG,30,TOT,27,6,602,64,171,.374,33,101,.327,31,70,.443,.471,12,15,.800,8,49,57,46,21,3,28,55,173
61,Avery Bradley\bradlav01,SG,30,MIA,10,1,211,31,66,.470,16,38,.421,15,28,.536,.591,7,9,.778,2,16,18,14,7,1,9,26,85
61,Avery Bradley\bradlav01,SG,30,HOU,17,5,391,33,105,.314,17,63,.270,16,42,.381,.395,5,6,.833,6,33,39,32,14,2,19,29,88
62,Tony Bradley\bradlto01,C,23,TOT,42,8,684,131,197,.665,0,3,.000,131,194,.675,.665,38,55,.691,85,154,239,37,15,30,33,61,300
62,Tony Bradley\bradlto01,C,23,PHI,20,8,287,51,75,.680,0,1,.000,51,74,.689,.680,7,11,.636,39,65,104,17,6,13,6,28,109
62,Tony Bradley\bradlto01,C,23,OKC,22,0,397,80,122,.656,0,2,.000,80,120,.667,.656,31,44,.705,46,89,135,20,9,17,27,33,191
63,Jarrell Brantley\brantja01,PF,24,UTA,28,0,138,25,52,.481,12,28,.429,13,24,.542,.596,2,2,1.000,9,18,27,15,7,2,8,17,64
64,Ignas Brazdeikis\brazdig01,SF,22,TOT,13,0,249,35,83,.422,11,28,.393,24,55,.436,.488,10,14,.714,11,34,45,17,4,3,12,22,91
64,Ignas Brazdeikis\brazdig01,SF,22,NYK,4,0,7,0,1,.000,0,0,,0,1,.000,.000,2,2,1.000,1,1,2,1,0,0,1,0,2
64,Ignas Brazdeikis\brazdig01,SF,22,PHI,1,0,8,0,3,.000,0,1,.000,0,2,.000,.000,0,0,,0,2,2,0,0,0,0,0,0
64,Ignas Brazdeikis\brazdig01,SF,22,ORL,8,0,234,35,79,.443,11,27,.407,24,52,.462,.513,8,12,.667,10,31,41,16,4,3,11,22,89
65,Mikal Bridges\bridgmi01,SF,24,PHO,72,72,2348,363,669,.543,134,315,.425,229,354,.647,.643,110,131,.840,76,233,309,152,76,63,57,116,970
66,Miles Bridges\bridgmi02,PF,22,CHO,66,19,1932,313,622,.503,116,290,.400,197,332,.593,.596,98,113,.867,81,316,397,147,44,52,106,143,840
67,Amida Brimah\brimaam01,C,26,IND,5,0,29,5,8,.625,0,0,,5,8,.625,.625,3,3,1.000,2,6,8,1,0,5,4,4,13
68,Oshae Brissett\brissos01,SF,22,IND,21,16,519,73,151,.483,33,78,.423,40,73,.548,.593,50,65,.769,29,86,115,18,19,20,10,32,229
69,Malcolm Brogdon\brogdma01,PG,28,IND,56,56,1930,444,980,.453,145,374,.388,299,606,.493,.527,153,177,.864,58,236,294,329,49,15,115,110,1186
70,Armoni Brooks\brookar01,SG,22,HOU,20,5,520,78,192,.406,60,157,.382,18,35,.514,.563,7,12,.583,10,58,68,30,12,5,22,34,223
71,Dillon Brooks\brookdi01,SF,25,MEM,67,67,1997,432,1031,.419,128,372,.344,304,659,.461,.481,159,195,.815,53,143,196,157,78,26,119,237,1151
72,Bruce Brown\brownbr01,PG,24,BRK,65,37,1451,235,423,.556,17,59,.288,218,364,.599,.576,86,117,.735,111,238,349,104,58,28,54,145,573
73,Charlie Brown Jr.\brownch02,SG,23,OKC,9,1,152,13,43,.302,5,21,.238,8,22,.364,.360,9,10,.900,3,14,17,9,4,2,6,19,40
74,Jaylen Brown\brownja02,SG,24,BOS,58,58,1999,538,1111,.484,163,411,.397,375,700,.536,.558,191,250,.764,71,276,347,195,72,32,158,168,1430
75,Moses Brown\brownmo01,C,21,OKC,43,32,920,146,268,.545,0,0,,146,268,.545,.545,78,126,.619,154,229,383,10,31,47,43,93,370
76,Sterling Brown\brownst02,SG,25,HOU,51,14,1229,150,335,.448,91,215,.423,59,120,.492,.584,25,31,.806,38,186,224,72,38,12,41,97,416
77,Troy Brown Jr.\browntr01,SF,21,TOT,34,0,524,62,144,.431,22,70,.314,40,74,.541,.507,15,21,.714,20,85,105,29,10,6,21,49,161
77,Troy Brown Jr.\browntr01,SF,21,WAS,21,0,287,33,89,.371,14,46,.304,19,43,.442,.449,10,15,.667,11,50,61,19,3,4,16,29,90
77,Troy Brown Jr.\browntr01,SF,21,CHI,13,0,237,29,55,.527,8,24,.333,21,31,.677,.600,5,6,.833,9,35,44,10,7,2,5,20,71
78,Jalen Brunson\brunsja01,PG,24,DAL,68,12,1697,328,627,.523,81,200,.405,247,427,.578,.588,120,151,.795,27,204,231,239,35,1,80,109,857
79,Elijah Bryant\bryanel01,SG,25,MIL,1,0,32,6,13,.462,1,5,.200,5,8,.625,.500,3,3,1.000,2,4,6,3,0,1,4,4,16
80,Thomas Bryant\bryanth01,C,23,WAS,10,10,271,59,91,.648,9,21,.429,50,70,.714,.698,16,24,.667,18,43,61,15,4,8,11,31,143
81,Reggie Bullock\bullore01,SF,29,NYK,65,64,1949,248,561,.442,163,398,.410,85,163,.521,.587,50,55,.909,16,207,223,99,52,11,45,146,709
82,Trey Burke\burketr01,PG,28,DAL,62,1,911,151,353,.428,58,164,.354,93,189,.492,.510,51,57,.895,10,44,54,81,36,7,33,64,411
83,Alec Burks\burksal01,SG,29,NYK,49,5,1255,210,500,.420,102,246,.415,108,254,.425,.522,101,118,.856,21,206,227,107,31,14,49,102,623
84,Jimmy Butler\butleji01,SF,31,MIA,52,52,1745,366,736,.497,25,102,.245,341,634,.538,.514,359,416,.863,94,265,359,369,108,18,109,71,1116
85,Bruno Caboclo\cabocbr01,PF,25,HOU,6,0,36,8,17,.471,0,5,.000,8,12,.667,.471,1,2,.500,3,11,14,1,0,2,4,6,17
86,Devontae Cacok\cacokde01,PF,24,LAL,20,1,98,17,29,.586,0,0,,17,29,.586,.586,5,11,.455,12,20,32,1,5,4,5,8,39
87,Kentavious Caldwell-Pope\caldwke01,SG,27,LAL,67,67,1902,218,506,.431,120,293,.410,98,213,.460,.549,97,112,.866,27,152,179,127,62,26,66,114,653
88,Facundo Campazzo\campafa01,PG,29,DEN,65,19,1425,120,315,.381,76,216,.352,44,99,.444,.502,80,91,.879,22,112,134,232,79,14,73,132,396
89,Vlatko Čančar\cancavl01,PF,23,DEN,41,1,281,33,72,.458,9,33,.273,24,39,.615,.521,10,13,.769,11,39,50,14,11,2,14,18,85
90,Devin Cannady\cannade01,PG,24,ORL,8,0,74,11,28,.393,6,16,.375,5,12,.417,.500,6,7,.857,0,5,5,1,5,1,2,9,34
91,Clint Capela\capelca01,C,26,ATL,63,63,1898,413,695,.594,0,0,,413,695,.594,.594,130,227,.573,297,606,903,49,44,129,73,145,956
92,Vernon Carey Jr.\careyve01,C,19,CHO,19,4,115,18,36,.500,1,7,.143,17,29,.586,.514,9,11,.818,6,21,27,2,1,5,5,13,46
93,Jevon Carter\carteje01,PG,25,PHO,60,1,717,94,223,.422,56,151,.371,38,72,.528,.547,4,7,.571,16,76,92,71,29,9,16,56,248
94,Wendell Carter Jr.\cartewe01,C,21,TOT,54,44,1375,230,457,.503,15,51,.294,215,406,.530,.520,131,179,.732,132,311,443,104,35,42,78,146,606
94,Wendell Carter Jr.\cartewe01,C,21,CHI,32,25,792,129,252,.512,8,22,.364,121,230,.526,.528,82,111,.739,70,180,250,69,18,24,49,96,348
94,Wendell Carter Jr.\cartewe01,C,21,ORL,22,19,583,101,205,.493,7,29,.241,94,176,.534,.510,49,68,.721,62,131,193,35,17,18,29,50,258
95,Michael Carter-Williams\cartemi01,SG,29,ORL,31,25,800,105,270,.389,15,61,.246,90,209,.431,.417,49,80,.613,39,100,139,129,25,17,69,81,274
96,Alex Caruso\carusal01,PG,26,LAL,58,6,1216,133,305,.436,55,137,.401,78,168,.464,.526,49,76,.645,31,139,170,160,64,15,76,108,370
97,Willie Cauley-Stein\caulewi01,C,27,DAL,53,16,906,115,182,.632,1,11,.091,114,171,.667,.635,49,78,.628,66,170,236,35,21,43,29,129,280
98,Chris Chiozza\chiozch01,PG,25,BRK,22,1,232,31,88,.352,13,42,.310,18,46,.391,.426,13,17,.765,3,21,24,65,7,6,16,19,88
99,Marquese Chriss\chrisma01,PF,23,GSW,2,0,27,5,14,.357,1,5,.200,4,9,.444,.393,2,4,.500,3,10,13,2,0,2,2,3,13
100,Gary Clark\clarkga01,PF-SF,26,TOT,39,11,654,40,132,.303,31,108,.287,9,24,.375,.420,8,10,.800,33,82,115,31,13,7,17,35,119
100,Gary Clark\clarkga01,SF,26,ORL,35,11,637,40,131,.305,31,108,.287,9,23,.391,.424,8,10,.800,33,79,112,30,12,7,17,34,119
100,Gary Clark\clarkga01,SF,26,DEN,2,0,4,0,0,,0,0,,0,0,,,0,0,,0,1,1,0,0,0,0,0,0
100,Gary Clark\clarkga01,PF,26,PHI,2,0,13,0,1,.000,0,0,,0,1,.000,.000,0,0,,0,2,2,1,1,0,0,1,0
101,Brandon Clarke\clarkbr01,PF,24,MEM,59,16,1415,256,495,.517,20,77,.260,236,418,.565,.537,78,113,.690,97,231,328,95,60,51,33,84,610
102,Jordan Clarkson\clarkjo01,SG,28,UTA,68,1,1818,457,1075,.425,208,599,.347,249,476,.523,.522,129,144,.896,47,227,274,168,61,10,115,110,1251
103,Nic Claxton\claxtni01,C,21,BRK,32,1,594,90,145,.621,1,5,.200,89,140,.636,.624,31,64,.484,43,123,166,28,23,40,18,68,212
104,Amir Coffey\coffeam01,SG,23,LAC,44,1,394,45,103,.437,23,56,.411,22,47,.468,.549,27,38,.711,10,34,44,22,10,0,15,30,140
105,John Collins\collijo01,PF,23,ATL,63,63,1848,429,771,.556,83,208,.399,346,563,.615,.610,170,204,.833,118,349,467,78,34,63,84,193,1111
106,Mike Conley\conlemi01,PG,33,UTA,51,51,1498,284,640,.444,138,335,.412,146,305,.479,.552,121,142,.852,36,141,177,305,70,9,99,98,827
107,Pat Connaughton\connapa01,SG,28,MIL,69,4,1575,168,387,.434,101,272,.371,67,115,.583,.565,31,40,.775,63,269,332,81,49,23,33,99,468
108,Quinn Cook\cookqu01,PG,27,TOT,23,0,157,29,68,.426,11,26,.423,18,42,.429,.507,7,8,.875,2,15,17,18,4,1,7,10,76
108,Quinn Cook\cookqu01,PG,27,LAL,16,0,62,12,26,.462,5,13,.385,7,13,.538,.558,4,5,.800,0,5,5,5,1,1,3,2,33
108,Quinn Cook\cookqu01,PG,27,CLE,7,0,95,17,42,.405,6,13,.462,11,29,.379,.476,3,3,1.000,2,10,12,13,3,0,4,8,43
109,Tyler Cook\cookty01,SF-PF,23,TOT,32,1,438,69,103,.670,1,2,.500,68,101,.673,.675,17,35,.486,28,67,95,17,8,2,21,35,156
109,Tyler Cook\cookty01,PF,23,BRK,4,0,17,1,3,.333,0,0,,1,3,.333,.333,0,0,,1,1,2,2,0,0,1,2,2
109,Tyler Cook\cookty01,SF,23,DET,28,1,421,68,100,.680,1,2,.500,67,98,.684,.685,17,35,.486,27,66,93,15,8,2,20,33,154
110,DeMarcus Cousins\couside01,C,30,TOT,41,11,713,130,305,.426,47,135,.348,83,170,.488,.503,59,81,.728,53,210,263,76,34,24,64,107,366
110,DeMarcus Cousins\couside01,C,30,HOU,25,11,506,79,210,.376,39,116,.336,40,94,.426,.469,44,59,.746,30,161,191,60,21,18,39,74,241
110,DeMarcus Cousins\couside01,C,30,LAC,16,0,207,51,95,.537,8,19,.421,43,76,.566,.579,15,22,.682,23,49,72,16,13,6,25,33,125
111,Robert Covington\covinro01,PF,30,POR,70,70,2243,204,509,.401,135,356,.379,69,153,.451,.533,50,62,.806,61,405,466,117,101,84,64,195,593
112,Torrey Craig\craigto01,SF,30,TOT,50,8,803,109,227,.480,39,106,.368,70,121,.579,.566,17,22,.773,57,140,197,49,28,26,25,83,274
112,Torrey Craig\craigto01,SF,30,MIL,18,0,201,18,46,.391,8,22,.364,10,24,.417,.478,1,2,.500,13,30,43,16,9,7,5,24,45
112,Torrey Craig\craigto01,SF,30,PHO,32,8,602,91,181,.503,31,84,.369,60,97,.619,.588,16,20,.800,44,110,154,33,19,19,20,59,229
113,Jae Crowder\crowdja01,PF,30,PHO,60,42,1648,199,492,.404,148,380,.389,51,112,.455,.555,57,75,.760,32,250,282,127,48,27,55,125,603
114,Jarrett Culver\culveja01,SG,21,MIN,34,7,499,69,168,.411,13,53,.245,56,115,.487,.449,29,48,.604,34,70,104,24,17,9,28,58,180
115,Seth Curry\curryse01,SG,30,PHI,57,57,1638,258,552,.467,126,280,.450,132,272,.485,.582,69,77,.896,10,126,136,155,44,8,65,96,711
116,Stephen Curry\curryst01,PG,32,GSW,63,63,2152,658,1365,.482,337,801,.421,321,564,.569,.605,362,395,.916,29,316,345,363,77,8,213,119,2015
117,Nate Darling\darlina01,SG,22,CHO,7,0,26,2,7,.286,2,7,.286,0,0,,.429,3,3,1.000,1,0,1,1,0,1,1,1,9
118,Anthony Davis\davisan02,PF,27,LAL,36,36,1162,301,613,.491,26,100,.260,275,513,.536,.512,158,214,.738,62,224,286,110,45,59,74,60,786
119,Ed Davis\davised01,C,31,MIN,23,7,299,19,44,.432,0,0,,19,44,.432,.432,10,12,.833,46,69,115,21,13,13,7,56,48
120,Terence Davis\daviste02,SG,23,TOT,61,4,1074,195,456,.428,98,267,.367,97,189,.513,.535,45,55,.818,20,134,154,83,44,14,63,97,533
120,Terence Davis\daviste02,SG,23,TOR,34,4,493,87,210,.414,44,122,.361,43,88,.489,.519,16,18,.889,9,57,66,37,17,7,29,48,234
120,Terence Davis\daviste02,SG,23,SAC,27,0,581,108,246,.439,54,145,.372,54,101,.535,.549,29,37,.784,11,77,88,46,27,7,34,49,299
121,Gabriel Deck\deckga01,PF,25,OKC,10,0,212,32,67,.478,2,15,.133,30,52,.577,.493,18,22,.818,16,24,40,24,8,0,6,9,84
122,Dewayne Dedmon\dedmode01,C,31,MIA,16,0,210,46,65,.708,1,5,.200,45,60,.750,.715,20,27,.741,28,58,86,12,9,6,13,36,113
123,Matthew Dellavedova\dellama01,PG,30,CLE,13,1,224,14,56,.250,4,25,.160,10,31,.323,.286,4,4,1.000,6,18,24,58,4,1,6,21,36
124,DeMar DeRozan\derozde01,PF,31,SAS,61,61,2056,455,920,.495,19,74,.257,436,846,.515,.505,387,440,.880,40,219,259,422,56,15,119,128,1316
125,Mamadi Diakite\diakima01,PF,24,MIL,14,1,141,16,40,.400,1,8,.125,15,32,.469,.413,11,14,.786,8,26,34,8,7,6,3,16,44
126,Hamidou Diallo\diallha01,SG-SF,22,TOT,52,9,1226,224,470,.477,28,82,.341,196,388,.505,.506,128,200,.640,59,213,272,101,41,24,76,134,604
126,Hamidou Diallo\diallha01,SG,22,OKC,32,5,761,143,297,.481,12,41,.293,131,256,.512,.502,83,132,.629,37,128,165,77,31,12,49,83,381
126,Hamidou Diallo\diallha01,SF,22,DET,20,4,465,81,173,.468,16,41,.390,65,132,.492,.514,45,68,.662,22,85,107,24,10,12,27,51,223
127,Gorgui Dieng\dienggo01,C,31,TOT,38,1,552,85,163,.521,30,70,.429,55,93,.591,.613,58,67,.866,40,100,140,48,26,16,32,56,258
127,Gorgui Dieng\dienggo01,C,31,MEM,22,1,371,56,108,.519,23,48,.479,33,60,.550,.625,38,43,.884,28,70,98,29,17,14,22,38,173
127,Gorgui Dieng\dienggo01,C,31,SAS,16,0,181,29,55,.527,7,22,.318,22,33,.667,.591,20,24,.833,12,30,42,19,9,2,10,18,85
128,Spencer Dinwiddie\dinwisp01,SG,27,BRK,3,3,64,6,16,.375,2,7,.286,4,9,.444,.438,6,6,1.000,0,13,13,9,2,1,5,4,20
129,Donte DiVincenzo\divindo01,SG,24,MIL,66,66,1814,253,603,.420,131,346,.379,122,257,.475,.528,51,71,.718,81,299,380,203,72,15,91,112,688
130,Luka Dončić\doncilu01,PG,21,DAL,66,66,2262,647,1351,.479,192,548,.350,455,803,.567,.550,344,471,.730,54,473,527,567,64,36,281,152,1830
131,Luguentz Dort\dortlu01,SG,21,OKC,52,52,1543,247,639,.387,113,329,.343,134,310,.432,.475,122,164,.744,38,151,189,88,45,19,79,134,729
132,Damyean Dotson\dotsoda01,SG,26,CLE,46,7,907,119,293,.406,46,159,.289,73,134,.545,.485,24,36,.667,5,88,93,91,16,4,42,42,308
133,Devon Dotson\dotsode01,PG,21,CHI,11,0,50,11,21,.524,1,7,.143,10,14,.714,.548,0,0,,2,3,5,7,4,0,0,3,23
134,Sekou Doumbouya\doumbse01,PF,20,DET,56,11,869,107,282,.379,26,115,.226,81,167,.485,.426,45,64,.703,39,104,143,47,24,9,44,94,285
135,PJ Dozier\doziepj01,SG,24,DEN,50,6,1088,148,355,.417,47,149,.315,101,206,.490,.483,42,66,.636,35,147,182,92,31,22,46,86,385
136,Goran Dragić\dragigo01,PG,34,MIA,50,11,1337,240,555,.432,91,244,.373,149,311,.479,.514,101,122,.828,25,144,169,219,33,8,118,113,672
137,Andre Drummond\drumman01,C,27,TOT,46,46,1242,282,572,.493,0,8,.000,282,564,.500,.493,123,205,.600,166,385,551,94,63,49,124,149,687
137,Andre Drummond\drumman01,C,27,CLE,25,25,722,180,380,.474,0,8,.000,180,372,.484,.474,77,129,.597,101,236,337,64,40,29,81,69,437
137,Andre Drummond\drumman01,C,27,LAL,21,21,520,102,192,.531,0,0,,102,192,.531,.531,46,76,.605,65,149,214,30,23,20,43,80,250
138,Jared Dudley\dudleja01,PF,35,LAL,12,0,81,2,9,.222,2,6,.333,0,3,.000,.333,0,0,,4,17,21,5,1,1,2,7,6
139,Kris Dunn\dunnkr01,PG,26,ATL,4,0,45,1,12,.083,0,2,.000,1,10,.100,.083,3,4,.750,0,6,6,2,2,2,3,10,5
140,Kevin Durant\duranke01,PF,32,BRK,35,32,1157,324,603,.537,85,189,.450,239,414,.577,.608,210,238,.882,13,234,247,195,25,45,120,70,943
141,Anthony Edwards\edwaran01,SG,19,MIN,72,55,2314,505,1211,.417,171,520,.329,334,691,.483,.488,211,272,.776,59,277,336,211,82,36,160,129,1392
142,Carsen Edwards\edwarca01,SG,22,BOS,31,1,276,47,111,.423,18,63,.286,29,48,.604,.505,11,13,.846,3,23,26,14,7,1,7,25,123
143,CJ Elleby\ellebcj01,SF,20,POR,30,0,192,25,66,.379,7,34,.206,18,32,.563,.432,11,15,.733,11,21,32,10,6,3,5,27,68
144,Henry Ellenson\ellenhe01,PF,24,TOR,2,0,38,5,14,.357,2,9,.222,3,5,.600,.429,3,4,.750,3,9,12,5,0,0,0,7,15
145,Wayne Ellington\ellinwa01,SG,33,DET,46,31,1012,149,338,.441,116,275,.422,33,63,.524,.612,28,35,.800,12,73,85,67,18,9,33,59,442
146,Joel Embiid\embiijo01,C,26,PHI,51,51,1585,461,899,.513,58,154,.377,403,745,.541,.545,471,548,.859,113,426,539,145,50,69,159,123,1451
147,James Ennis III\ennisja01,SF,30,ORL,41,37,986,115,243,.473,45,104,.433,70,139,.504,.566,70,87,.805,43,123,166,62,32,7,36,84,345
148,Drew Eubanks\eubandr01,C,23,SAS,54,3,755,116,205,.566,2,2,1.000,114,203,.562,.571,77,106,.726,74,167,241,42,18,49,45,88,311
149,Dante Exum\exumda01,SG,25,CLE,6,3,116,10,26,.385,2,11,.182,8,15,.533,.423,1,2,.500,2,15,17,13,4,2,7,9,23
150,Tacko Fall\fallta01,C,25,BOS,19,0,136,21,29,.724,0,0,,21,29,.724,.724,5,15,.333,16,36,52,3,1,20,6,22,47
151,Derrick Favors\favorde01,C,29,UTA,68,0,1039,155,243,.638,0,2,.000,155,241,.643,.638,59,80,.738,138,238,376,44,32,68,36,143,369
152,Cristiano Felício\feliccr01,C,28,CHI,18,0,84,7,13,.538,0,2,.000,7,11,.636,.538,9,16,.563,10,16,26,9,4,0,4,10,23
153,Terrance Ferguson\fergute01,SG,22,PHI,13,0,49,1,7,.143,0,5,.000,1,2,.500,.143,0,0,,0,1,1,2,1,0,4,7,2
154,Bruno Fernando\fernabr01,C,22,ATL,33,0,226,18,44,.409,0,2,.000,18,42,.429,.409,15,22,.682,16,62,78,10,4,3,21,23,51
155,Yogi Ferrell\ferreyo01,PG,27,TOT,10,0,136,20,57,.351,9,28,.321,11,29,.379,.430,7,9,.778,5,14,19,22,7,3,3,11,56
155,Yogi Ferrell\ferreyo01,PG,27,CLE,2,0,40,8,21,.381,3,9,.333,5,12,.417,.452,0,2,.000,3,4,7,5,3,1,3,4,19
155,Yogi Ferrell\ferreyo01,PG,27,LAC,8,0,96,12,36,.333,6,19,.316,6,17,.353,.417,7,7,1.000,2,10,12,17,4,2,0,7,37
156,Dorian Finney-Smith\finnedo01,PF,27,DAL,60,60,1921,220,466,.472,119,302,.394,101,164,.616,.600,31,41,.756,98,228,326,102,52,25,48,138,590
157,Malik Fitts\fittsma01,PF,23,LAC,3,0,11,1,3,.333,1,2,.500,0,1,.000,.500,0,0,,0,3,3,0,0,0,0,3,3
158,Malachi Flynn\flynnma01,PG,22,TOR,47,14,928,127,340,.374,54,168,.321,73,172,.424,.453,45,56,.804,10,106,116,137,38,7,43,68,353
159,Bryn Forbes\forbebr01,SG,27,MIL,70,10,1354,250,529,.473,154,341,.452,96,188,.511,.618,47,61,.770,11,101,112,45,24,1,44,77,701
160,Trent Forrest\forretr01,PG,22,UTA,30,0,302,32,71,.451,5,26,.192,27,45,.600,.486,19,19,1.000,11,33,44,45,9,4,21,22,88
161,Evan Fournier\fournev01,SF-SG,28,TOT,42,36,1259,247,541,.457,117,283,.413,130,258,.504,.565,108,137,.788,10,118,128,144,47,19,73,96,719
161,Evan Fournier\fournev01,SF,28,ORL,26,26,787,170,369,.461,73,188,.388,97,181,.536,.560,98,123,.797,5,70,75,95,27,9,54,55,511
161,Evan Fournier\fournev01,SG,28,BOS,16,10,472,77,172,.448,44,95,.463,33,77,.429,.576,10,14,.714,5,48,53,49,20,10,19,41,208
162,De'Aaron Fox\foxde01,PG,23,SAC,58,58,2036,529,1110,.477,103,320,.322,426,790,.539,.523,300,417,.719,33,170,203,417,87,27,174,170,1461
163,Robert Franks\frankro01,PF,24,ORL,7,0,101,13,28,.464,5,15,.333,8,13,.615,.554,12,13,.923,6,8,14,5,3,3,2,8,43
164,Tim Frazier\fraziti01,PG,30,MEM,5,0,62,3,20,.150,0,8,.000,3,12,.250,.150,2,6,.333,0,8,8,16,2,1,4,7,8
165,Enes Freedom\kanteen01,C,28,POR,72,35,1758,339,561,.604,1,4,.250,338,557,.607,.605,127,164,.774,284,511,795,84,33,48,78,168,806
166,Markelle Fultz\fultzma01,PG,22,ORL,8,8,215,41,104,.394,4,16,.250,37,88,.420,.413,17,19,.895,5,20,25,43,8,2,18,18,103
167,Wenyen Gabriel\gabriwe01,PF,23,NOP,21,0,241,24,60,.400,13,32,.406,11,28,.393,.508,11,17,.647,20,34,54,11,9,8,15,32,72
168,Daniel Gafford\gaffoda01,PF-C,22,TOT,54,11,791,154,225,.684,0,0,,154,225,.684,.684,72,108,.667,94,137,231,29,26,75,41,98,380
168,Daniel Gafford\gaffoda01,PF,22,CHI,31,11,383,60,87,.690,0,0,,60,87,.690,.690,27,41,.659,44,59,103,17,11,34,22,54,147
168,Daniel Gafford\gaffoda01,C,22,WAS,23,0,408,94,138,.681,0,0,,94,138,.681,.681,45,67,.672,50,78,128,12,15,41,19,44,233
169,Danilo Gallinari\gallida01,PF,32,ATL,51,4,1222,206,475,.434,103,254,.406,103,221,.466,.542,161,174,.925,17,194,211,76,30,10,43,105,676
170,Langston Galloway\gallola01,SG,29,PHO,40,0,438,66,147,.449,36,85,.424,30,62,.484,.571,22,23,.957,7,35,42,26,8,0,13,25,190
171,Darius Garland\garlada01,PG,21,CLE,54,50,1790,362,802,.451,105,266,.395,257,536,.479,.517,112,132,.848,23,106,129,329,66,6,164,110,941
172,Marc Gasol\gasolma01,C,36,LAL,52,42,993,88,194,.454,50,122,.410,38,72,.528,.582,36,50,.720,38,177,215,109,26,58,53,115,262
173,Rudy Gay\gayru01,PF,34,SAS,63,1,1358,264,628,.420,106,278,.381,158,350,.451,.505,82,102,.804,42,261,303,88,45,40,65,115,716
174,Paul George\georgpa01,SF,30,LAC,54,54,1821,445,953,.467,171,416,.411,274,537,.510,.557,198,228,.868,45,314,359,280,62,24,179,132,1259
175,Taj Gibson\gibsota01,C,35,NYK,45,3,936,99,158,.627,3,15,.200,96,143,.671,.636,40,55,.727,99,151,250,36,31,49,22,99,241
176,Harry Giles\gilesha01,C,22,POR,38,0,348,42,97,.433,8,23,.348,34,74,.459,.474,16,27,.593,31,102,133,29,8,13,20,54,108
177,Shai Gilgeous-Alexander\gilgesh01,SG,22,OKC,35,35,1180,287,565,.508,71,170,.418,216,395,.547,.571,185,229,.808,19,147,166,207,27,23,106,70,830
178,Anthony Gill\gillan01,PF,28,WAS,26,4,218,30,60,.500,7,24,.292,23,36,.639,.558,13,16,.813,16,35,51,11,10,4,8,27,80
179,Freddie Gillespie\gillefr01,PF,23,TOR,20,2,392,44,84,.524,0,0,,44,84,.524,.524,23,33,.697,42,55,97,9,13,20,12,43,111
180,Rudy Gobert\goberru01,C,28,UTA,71,71,2187,391,579,.675,0,4,.000,391,575,.680,.675,233,374,.623,240,720,960,89,40,190,118,163,1015
181,Brandon Goodwin\goodwbr01,PG,25,ATL,47,5,620,84,223,.377,32,103,.311,52,120,.433,.448,28,43,.651,8,61,69,95,17,0,36,41,228
182,Aaron Gordon\gordoaa01,PF,25,TOT,50,50,1384,231,499,.463,59,176,.335,172,323,.533,.522,97,149,.651,77,207,284,161,33,34,97,89,618
182,Aaron Gordon\gordoaa01,PF,25,ORL,25,25,736,128,293,.437,42,112,.375,86,181,.475,.509,66,105,.629,39,127,166,105,16,20,67,49,364
182,Aaron Gordon\gordoaa01,PF,25,DEN,25,25,648,103,206,.500,17,64,.266,86,142,.606,.541,31,44,.705,38,80,118,56,17,14,30,40,254
183,Eric Gordon\gordoer01,SG,32,HOU,27,13,789,159,367,.433,69,210,.329,90,157,.573,.527,94,114,.825,8,50,58,71,14,13,51,44,481
184,Devonte' Graham\grahade01,PG,25,CHO,55,44,1659,252,669,.377,179,477,.375,73,192,.380,.510,133,158,.842,22,126,148,295,48,6,84,77,816
185,Jerami Grant\grantje01,SF,26,DET,54,54,1829,400,932,.429,115,329,.350,285,603,.473,.491,290,343,.845,35,215,250,152,35,58,109,125,1205
186,Danny Green\greenda02,SF,33,PHI,69,69,1934,224,544,.412,175,432,.405,49,112,.438,.573,31,40,.775,55,205,260,118,92,56,67,125,654
187,Draymond Green\greendr01,PF,30,GSW,63,63,1982,170,380,.447,34,126,.270,136,254,.535,.492,70,88,.795,55,394,449,558,105,52,188,194,444
188,JaMychal Green\greenja01,PF,30,DEN,58,5,1120,173,374,.463,79,198,.399,94,176,.534,.568,46,57,.807,85,192,277,53,26,22,53,144,471
189,Javonte Green\greenja02,SF-SG,27,TOT,41,2,473,53,102,.520,10,30,.333,43,72,.597,.569,30,40,.750,26,45,71,17,28,6,19,45,146
189,Javonte Green\greenja02,SF,27,BOS,25,2,345,39,71,.549,7,22,.318,32,49,.653,.599,20,30,.667,20,32,52,11,18,2,13,32,105
189,Javonte Green\greenja02,SG,27,CHI,16,0,128,14,31,.452,3,8,.375,11,23,.478,.500,10,10,1.000,6,13,19,6,10,4,6,13,41
190,Jeff Green\greenje02,C,34,BRK,68,38,1835,261,530,.492,103,250,.412,158,280,.564,.590,125,161,.776,34,229,263,108,36,27,54,122,750
191,Josh Green\greenjo02,SG,20,DAL,39,5,445,42,93,.452,4,25,.160,38,68,.559,.473,13,23,.565,28,50,78,28,16,3,17,35,101
192,Blake Griffin\griffbl01,PF,31,TOT,46,30,1186,174,411,.423,70,205,.341,104,206,.505,.509,87,117,.744,35,190,225,140,32,15,62,111,505
192,Blake Griffin\griffbl01,PF,31,DET,20,20,626,81,222,.365,39,124,.315,42,98,.429,.453,44,62,.710,7,97,104,77,14,2,32,42,245
192,Blake Griffin\griffbl01,PF,31,BRK,26,10,560,93,189,.492,31,81,.383,62,108,.574,.574,43,55,.782,28,93,121,63,18,13,30,69,260
193,Kyle Guy\guyky01,PG,23,SAC,31,0,235,29,88,.330,13,46,.283,16,42,.381,.403,16,20,.800,5,30,35,32,6,0,11,20,87
194,Rui Hachimura\hachiru01,PF,22,WAS,57,57,1797,310,648,.478,45,137,.328,265,511,.519,.513,124,161,.770,49,263,312,82,44,7,68,120,789
195,Ashton Hagans\haganas01,PG,21,MIN,2,0,4,0,0,,0,0,,0,0,,,0,0,,0,0,0,0,0,0,1,0,0
196,Tyrese Haliburton\halibty01,PG,20,SAC,58,20,1746,292,619,.472,121,296,.409,171,323,.529,.569,48,56,.857,39,134,173,309,77,28,92,83,753
197,Donta Hall\halldo01,PF,23,ORL,13,0,179,25,35,.714,0,0,,25,35,.714,.714,23,34,.676,24,38,62,11,5,10,8,18,73
198,Josh Hall\halljo01,SF,20,OKC,21,1,336,30,99,.303,4,37,.108,26,62,.419,.323,22,44,.500,6,53,59,28,4,1,25,37,86
199,R.J. Hampton\hamptrj01,SG-PG,19,TOT,51,1,888,136,313,.435,27,87,.310,109,226,.482,.478,55,82,.671,29,150,179,87,21,10,53,61,354
199,R.J. Hampton\hamptrj01,PG,19,DEN,25,0,233,25,60,.417,5,18,.278,20,42,.476,.458,9,12,.750,10,40,50,14,5,2,11,22,64
199,R.J. Hampton\hamptrj01,SG,19,ORL,26,1,655,111,253,.439,22,69,.319,89,184,.484,.482,46,70,.657,19,110,129,73,16,8,42,39,290
200,Tim Hardaway Jr.\hardati02,SG,28,DAL,70,31,1985,407,911,.447,207,529,.391,200,382,.524,.560,142,174,.816,20,209,229,126,31,11,64,111,1163
201,James Harden\hardeja01,PG-SG,31,TOT,44,43,1609,342,734,.466,121,334,.362,221,400,.553,.548,278,323,.861,35,313,348,475,53,33,177,99,1083
201,James Harden\hardeja01,SG,31,HOU,8,8,290,60,135,.444,25,72,.347,35,63,.556,.537,53,60,.883,5,36,41,83,7,6,34,14,198
201,James Harden\hardeja01,PG,31,BRK,36,35,1319,282,599,.471,96,262,.366,186,337,.552,.551,225,263,.856,30,277,307,392,46,27,143,85,885
202,Maurice Harkless\harklma01,PF-SF,27,TOT,37,23,772,69,165,.418,23,84,.274,46,81,.568,.488,33,43,.767,13,76,89,44,30,20,22,86,194
202,Maurice Harkless\harklma01,SF,27,MIA,11,3,124,5,13,.385,5,11,.455,0,2,.000,.577,0,2,.000,2,11,13,7,2,4,3,14,15
202,Maurice Harkless\harklma01,PF,27,SAC,26,20,648,64,152,.421,18,73,.247,46,79,.582,.480,33,41,.805,11,65,76,37,28,16,19,72,179
203,Jared Harper\harpeja01,PG,23,NYK,8,0,16,0,4,.000,0,1,.000,0,3,.000,.000,3,4,.750,0,2,2,1,0,0,3,1,3
204,Montrezl Harrell\harremo01,C,27,LAL,69,1,1580,375,603,.622,0,10,.000,375,593,.632,.622,181,256,.707,158,270,428,73,46,49,74,128,931
205,Gary Harris\harriga01,SG,26,TOT,39,38,1080,138,345,.400,48,141,.340,90,204,.441,.470,64,78,.821,21,58,79,78,28,11,37,71,388
205,Gary Harris\harriga01,SG,26,DEN,19,19,581,69,156,.442,24,75,.320,45,81,.556,.519,22,30,.733,13,34,47,32,17,4,14,37,184
205,Gary Harris\harriga01,SG,26,ORL,20,19,499,69,189,.365,24,66,.364,45,123,.366,.429,42,48,.875,8,24,32,46,11,7,23,34,204
206,Jalen Harris\harrija01,SG,22,TOR,13,2,172,36,72,.500,17,36,.472,19,36,.528,.618,7,9,.778,3,15,18,17,8,0,14,15,96
207,Joe Harris\harrijo01,SF,29,BRK,69,65,2141,357,707,.505,211,444,.475,146,263,.555,.654,49,63,.778,43,205,248,130,46,14,62,141,974
208,Tobias Harris\harrito02,PF,28,PHI,62,62,2014,473,924,.512,82,208,.394,391,716,.546,.556,182,204,.892,62,357,419,220,55,51,107,119,1210
209,Shaquille Harrison\harrish01,SG,27,TOT,34,0,333,26,78,.333,3,16,.188,23,62,.371,.353,18,22,.818,7,41,48,25,17,5,11,33,73
209,Shaquille Harrison\harrish01,SG,27,UTA,17,0,56,6,20,.300,0,2,.000,6,18,.333,.300,5,6,.833,3,6,9,9,2,0,5,3,17
209,Shaquille Harrison\harrish01,SG,27,DEN,17,0,277,20,58,.345,3,14,.214,17,44,.386,.371,13,16,.813,4,35,39,16,15,5,6,30,56
210,Josh Hart\hartjo01,SF,25,NOP,47,4,1349,151,344,.439,63,193,.326,88,151,.583,.531,69,89,.775,53,324,377,109,38,12,49,111,434
211,Isaiah Hartenstein\harteis01,C,22,TOT,46,2,559,94,171,.550,2,6,.333,92,165,.558,.556,46,71,.648,65,116,181,55,19,39,44,104,236
211,Isaiah Hartenstein\harteis01,C,22,DEN,30,0,272,41,80,.513,0,0,,41,80,.513,.513,22,36,.611,40,45,85,15,11,20,21,59,104
211,Isaiah Hartenstein\harteis01,C,22,CLE,16,2,287,53,91,.582,2,6,.333,51,85,.600,.593,24,35,.686,25,71,96,40,8,19,23,45,132
212,Udonis Haslem\hasleud01,C,40,MIA,1,0,3,2,2,1.000,0,0,,2,2,1.000,1.000,0,0,,0,1,1,0,0,0,0,0,4
213,Jaxson Hayes\hayesja02,C,20,NOP,60,3,964,175,280,.625,6,14,.429,169,266,.635,.636,93,120,.775,92,165,257,35,25,38,39,101,449
214,Killian Hayes\hayeski01,PG,19,DET,26,18,670,71,201,.353,20,72,.278,51,129,.395,.403,14,17,.824,6,63,69,138,27,10,83,57,176
215,Gordon Hayward\haywago01,SF,30,CHO,44,44,1496,311,658,.473,85,205,.415,226,453,.499,.537,156,185,.843,37,221,258,181,52,14,91,74,863
216,Juancho Hernangómez\hernaju01,PF,25,MIN,52,6,900,130,299,.435,55,168,.327,75,131,.573,.527,60,97,.619,45,160,205,35,19,7,27,52,375
217,Willy Hernangómez\hernawi01,C,26,NOP,47,12,846,151,268,.563,1,10,.100,150,258,.581,.565,62,93,.667,117,217,334,50,22,23,34,68,365
218,Tyler Herro\herroty01,SG,21,MIA,54,15,1635,307,699,.439,107,297,.360,200,402,.498,.516,94,117,.803,25,243,268,184,35,17,101,71,815
219,Buddy Hield\hieldbu01,SG,28,SAC,71,71,2433,403,992,.406,282,721,.391,121,271,.446,.548,88,104,.846,29,305,334,257,63,30,130,175,1176
220,George Hill\hillge01,PG,34,TOT,30,17,672,95,197,.482,31,80,.388,64,117,.547,.561,40,50,.800,16,45,61,73,23,5,31,31,261
220,George Hill\hillge01,PG,34,OKC,14,14,369,61,120,.508,22,57,.386,39,63,.619,.600,21,25,.840,8,21,29,43,12,2,12,12,165
220,George Hill\hillge01,PG,34,PHI,16,3,303,34,77,.442,9,23,.391,25,54,.463,.500,19,25,.760,8,24,32,30,11,3,19,19,96
221,Solomon Hill\hillso01,PF,29,ATL,71,16,1513,107,298,.359,68,212,.321,39,86,.453,.473,35,46,.761,42,172,214,75,50,11,42,116,317
222,Nate Hinton\hintona01,SG,21,DAL,21,0,93,15,42,.357,4,19,.211,11,23,.478,.405,7,10,.700,1,8,9,8,7,2,5,8,41
223,Jaylen Hoard\hoardja01,SF,21,OKC,19,0,320,44,88,.500,0,11,.000,44,77,.571,.500,28,41,.683,21,44,65,24,13,5,17,19,116
224,Aaron Holiday\holidaa01,PG,24,IND,66,8,1176,170,436,.390,67,182,.368,103,254,.406,.467,68,83,.819,15,74,89,123,46,13,66,94,475
225,Jrue Holiday\holidjr01,PG,30,MIL,59,56,1907,414,823,.503,111,283,.392,303,540,.561,.570,107,136,.787,73,195,268,357,96,37,127,98,1046
226,Justin Holiday\holidju01,SG,31,IND,72,52,2183,258,625,.413,173,453,.382,85,172,.494,.551,67,85,.788,32,224,256,119,74,41,54,135,756
227,Rondae Hollis-Jefferson\holliro01,PF,26,POR,11,1,107,9,18,.500,0,1,.000,9,17,.529,.500,9,16,.563,11,15,26,13,2,4,2,15,27
228,Richaun Holmes\holmeri01,C,27,SAC,61,61,1782,366,575,.637,2,11,.182,364,564,.645,.638,135,170,.794,144,360,504,101,39,96,75,213,869
229,Rodney Hood\hoodro01,SF,28,TOT,55,5,942,94,260,.362,34,113,.301,60,147,.408,.427,24,28,.857,23,80,103,53,24,7,36,74,246
229,Rodney Hood\hoodro01,SF,28,POR,38,5,726,73,201,.363,25,84,.298,48,117,.410,.425,9,12,.750,18,55,73,47,20,4,31,59,180
229,Rodney Hood\hoodro01,SF,28,TOR,17,0,216,21,59,.356,9,29,.310,12,30,.400,.432,15,16,.938,5,25,30,6,4,3,5,15,66
230,Al Horford\horfoal01,C,34,OKC,28,28,782,162,360,.450,56,152,.368,106,208,.510,.528,18,22,.818,29,159,188,94,25,26,29,48,398
231,Talen Horton-Tucker\hortota01,SG,20,LAL,65,4,1304,224,489,.458,37,131,.282,187,358,.522,.496,100,129,.775,25,144,169,181,63,21,105,127,585
232,Danuel House Jr.\houseda01,SF,27,HOU,36,23,932,110,272,.404,54,156,.346,56,116,.483,.504,41,63,.651,18,114,132,69,20,16,36,67,315
233,Dwight Howard\howardw01,C,35,PHI,69,6,1196,178,303,.587,5,20,.250,173,283,.611,.596,121,210,.576,190,390,580,61,30,62,112,200,482
234,Markus Howard\howarma02,SG,21,DEN,37,1,205,40,106,.377,18,65,.277,22,41,.537,.462,7,9,.778,1,20,21,18,4,1,18,23,105
235,Kevin Huerter\huertke01,SG,22,ATL,69,49,2126,316,731,.432,140,386,.363,176,345,.510,.528,50,64,.781,38,193,231,241,82,18,79,165,822
236,Elijah Hughes\hugheel01,SF,22,UTA,18,0,64,10,30,.333,8,23,.348,2,7,.286,.467,3,4,.750,1,8,9,6,1,1,6,1,31
237,De'Andre Hunter\huntede01,SF,23,ATL,23,19,678,120,248,.484,31,95,.326,89,153,.582,.546,73,85,.859,17,93,110,44,19,12,29,59,344
238,Chandler Hutchison\hutchch01,SF,24,TOT,25,1,346,39,103,.379,8,22,.364,31,81,.383,.417,21,25,.840,6,72,78,17,12,5,20,33,107
238,Chandler Hutchison\hutchch01,SF,24,CHI,7,0,64,5,18,.278,1,3,.333,4,15,.267,.306,2,2,1.000,1,19,20,4,1,0,5,9,13
238,Chandler Hutchison\hutchch01,SF,24,WAS,18,1,282,34,85,.400,7,19,.368,27,66,.409,.441,19,23,.826,5,53,58,13,11,5,15,24,94
239,Serge Ibaka\ibakase01,C,31,LAC,41,39,955,186,365,.510,39,115,.339,147,250,.588,.563,43,53,.811,73,202,275,74,9,47,44,76,454
240,Andre Iguodala\iguodan01,SF,37,MIA,63,5,1339,95,248,.383,60,182,.330,35,66,.530,.504,25,38,.658,38,183,221,142,57,35,67,90,275
241,Ersan İlyasova\ilyaser01,PF,33,UTA,17,1,148,21,54,.389,18,41,.439,3,13,.231,.556,5,5,1.000,7,22,29,4,10,3,8,29,65
242,Joe Ingles\inglejo01,SF,33,UTA,67,30,1867,275,562,.489,183,406,.451,92,156,.590,.652,76,90,.844,27,217,244,318,45,12,117,120,809
243,Brandon Ingram\ingrabr01,SF,23,NOP,61,61,2093,513,1101,.466,143,375,.381,370,726,.510,.531,281,320,.878,34,265,299,296,42,36,154,124,1450
244,Kyrie Irving\irvinky01,PG,28,BRK,54,54,1886,549,1086,.506,152,378,.402,397,708,.561,.576,201,218,.922,52,205,257,324,76,37,130,140,1451
245,Wes Iwundu\iwundwe01,SF,26,TOT,41,4,539,34,102,.333,5,41,.122,29,61,.475,.358,26,31,.839,15,75,90,18,15,4,19,49,99
245,Wes Iwundu\iwundwe01,SF,26,DAL,23,3,288,17,52,.327,3,23,.130,14,29,.483,.356,12,14,.857,6,38,44,10,9,3,6,26,49
245,Wes Iwundu\iwundwe01,SF,26,NOP,18,1,251,17,50,.340,2,18,.111,15,32,.469,.360,14,17,.824,9,37,46,8,6,1,13,23,50
246,Frank Jackson\jacksfr01,PG,22,DET,40,6,738,134,293,.457,61,150,.407,73,143,.510,.561,61,75,.813,15,71,86,36,15,1,34,53,390
247,Jaren Jackson Jr.\jacksja02,C,21,MEM,11,4,258,53,125,.424,17,60,.283,36,65,.554,.492,35,42,.833,17,45,62,12,12,18,15,42,158
248,Josh Jackson\jacksjo02,SG,23,DET,62,25,1560,296,707,.419,77,257,.300,219,450,.487,.473,159,218,.729,57,197,254,143,53,47,142,178,828
249,Justin Jackson\jacksju01,SF,25,TOT,34,3,577,89,221,.403,36,117,.308,53,104,.510,.484,31,37,.838,16,61,77,52,15,2,32,32,245
249,Justin Jackson\jacksju01,SF,25,OKC,33,3,544,86,212,.406,34,111,.306,52,101,.515,.486,30,35,.857,14,57,71,51,15,2,31,31,236
249,Justin Jackson\jacksju01,SF,25,MIL,1,0,33,3,9,.333,2,6,.333,1,3,.333,.444,1,2,.500,2,4,6,1,0,0,1,1,9
250,Reggie Jackson\jacksre01,SG,30,LAC,67,43,1544,263,585,.450,122,282,.433,141,303,.465,.554,67,82,.817,24,168,192,205,41,7,74,127,715
251,Justin James\jamesju01,SF,24,SAC,36,0,310,52,111,.468,14,38,.368,38,73,.521,.532,21,36,.583,9,21,30,22,8,3,15,23,139
252,LeBron James\jamesle01,PG,36,LAL,45,45,1504,422,823,.513,104,285,.365,318,538,.591,.576,178,255,.698,29,317,346,350,48,25,168,70,1126
253,Mike James\jamesmi02,PG,30,BRK,13,1,236,34,92,.370,11,31,.355,23,61,.377,.429,21,27,.778,3,29,32,54,6,1,20,10,100
254,DaQuan Jeffries\jeffrda01,SG,23,TOT,31,5,493,50,120,.417,20,67,.299,30,53,.566,.500,7,8,.875,19,52,71,22,15,10,14,48,127
254,DaQuan Jeffries\jeffrda01,SG,23,SAC,18,2,232,24,57,.421,9,28,.321,15,29,.517,.500,6,7,.857,9,20,29,6,7,4,8,23,63
254,DaQuan Jeffries\jeffrda01,SG,23,HOU,13,3,261,26,63,.413,11,39,.282,15,24,.625,.500,1,1,1.000,10,32,42,16,8,6,6,25,64
255,Ty Jerome\jeromty01,SG,23,OKC,33,1,788,128,287,.446,71,168,.423,57,119,.479,.570,26,34,.765,10,81,91,120,20,6,47,61,353
256,Isaiah Joe\joeis01,SG,21,PHI,41,1,383,48,133,.361,39,106,.368,9,27,.333,.508,18,24,.750,6,30,36,20,12,4,11,34,153
257,Alize Johnson\johnsal02,PF,24,BRK,18,0,189,40,68,.588,1,6,.167,39,62,.629,.596,13,13,1.000,27,63,90,14,5,5,9,16,94
258,Cameron Johnson\johnsca02,PF,24,PHO,60,11,1437,203,483,.420,117,335,.349,86,148,.581,.541,50,59,.847,33,166,199,86,37,16,40,85,573
259,James Johnson\johnsja01,PF,33,TOT,51,12,1043,146,327,.446,31,120,.258,115,207,.556,.494,45,76,.592,32,145,177,98,42,42,55,120,368
259,James Johnson\johnsja01,PF,33,DAL,29,1,504,67,145,.462,15,60,.250,52,85,.612,.514,17,29,.586,14,72,86,50,24,23,27,59,166
259,James Johnson\johnsja01,PF,33,NOP,22,11,539,79,182,.434,16,60,.267,63,122,.516,.478,28,47,.596,18,73,91,48,18,19,28,61,202
260,Keldon Johnson\johnske04,SF,21,SAS,69,67,1968,338,705,.479,60,181,.331,278,524,.531,.522,145,196,.740,93,319,412,121,40,24,78,142,881
261,Stanley Johnson\johnsst04,PF,24,TOR,61,13,1006,89,233,.382,45,137,.328,44,96,.458,.479,44,55,.800,29,124,153,89,52,18,54,116,267
262,Tyler Johnson\johnsty01,SG,28,BRK,39,3,684,72,183,.393,48,132,.364,24,51,.471,.525,18,21,.857,6,71,77,47,14,0,17,43,210
263,Nikola Jokić\jokicni01,C,25,DEN,72,72,2488,732,1293,.566,92,237,.388,640,1056,.606,.602,342,394,.868,205,575,780,599,95,48,222,192,1898
264,Damian Jones\jonesda03,C,25,TOT,39,10,547,70,103,.680,1,5,.200,69,98,.704,.684,42,58,.724,36,85,121,29,11,29,26,77,183
264,Damian Jones\jonesda03,C,25,PHO,14,0,94,8,16,.500,0,1,.000,8,15,.533,.500,6,11,.545,7,11,18,4,1,5,6,19,22
264,Damian Jones\jonesda03,C,25,LAL,8,6,112,16,17,.941,0,0,,16,17,.941,.941,11,12,.917,8,18,26,1,1,7,5,22,43
264,Damian Jones\jonesda03,C,25,SAC,17,4,341,46,70,.657,1,4,.250,45,66,.682,.664,25,35,.714,21,56,77,24,9,17,15,36,118
265,Derrick Jones Jr.\jonesde02,SF,23,POR,58,43,1318,147,304,.484,43,136,.316,104,168,.619,.554,59,91,.648,77,128,205,47,37,54,32,127,396
266,Mason Jones\jonesma05,SG,22,TOT,32,1,334,52,123,.423,24,66,.364,28,57,.491,.520,40,64,.625,7,48,55,42,7,1,29,24,168
266,Mason Jones\jonesma05,SG,22,HOU,26,1,307,47,114,.412,23,64,.359,24,50,.480,.513,35,57,.614,4,47,51,39,6,1,28,22,152
266,Mason Jones\jonesma05,SG,22,PHI,6,0,27,5,9,.556,1,2,.500,4,7,.571,.611,5,7,.714,3,1,4,3,1,0,1,2,16
267,Tre Jones\jonestr01,PG,21,SAS,37,1,269,37,78,.474,3,5,.600,34,73,.466,.494,17,19,.895,8,13,21,39,8,0,13,13,94
268,Tyus Jones\jonesty01,PG,24,MEM,70,9,1222,178,413,.431,45,140,.321,133,273,.487,.485,41,45,.911,21,119,140,259,64,6,48,31,442
269,DeAndre Jordan\jordade01,C,32,BRK,57,43,1246,190,249,.763,0,1,.000,190,248,.766,.763,46,92,.500,117,310,427,93,17,65,85,116,426
270,Cory Joseph\josepco01,PG,29,TOT,63,13,1446,200,426,.469,45,132,.341,155,294,.527,.522,72,88,.818,35,124,159,213,61,18,79,139,517
270,Cory Joseph\josepco01,PG,29,SAC,44,2,944,111,250,.444,31,94,.330,80,156,.513,.506,36,47,.766,25,74,99,108,39,9,44,98,289
270,Cory Joseph\josepco01,PG,29,DET,19,11,502,89,176,.506,14,38,.368,75,138,.543,.545,36,41,.878,10,50,60,105,22,9,35,41,228
271,Mfiondu Kabengele\kabenmf01,PF,23,TOT,39,0,280,33,89,.371,13,50,.260,20,39,.513,.444,16,20,.800,12,48,60,17,8,13,15,36,95
271,Mfiondu Kabengele\kabenmf01,PF,23,LAC,23,0,94,9,32,.281,4,18,.222,5,14,.357,.344,5,6,.833,1,13,14,5,2,3,6,18,27
271,Mfiondu Kabengele\kabenmf01,PF,23,CLE,16,0,186,24,57,.421,9,32,.281,15,25,.600,.500,11,14,.786,11,35,46,12,6,10,9,18,68
272,Frank Kaminsky\kaminfr01,C,27,PHO,47,13,715,121,257,.471,31,85,.365,90,172,.523,.531,37,60,.617,36,152,188,79,14,17,22,70,310
273,Luke Kennard\kennalu01,SG,24,LAC,63,17,1232,197,414,.476,100,224,.446,97,190,.511,.597,26,31,.839,15,146,161,104,23,9,48,91,520
274,Louis King\kinglo02,SF,21,SAC,6,1,85,17,34,.500,4,11,.364,13,23,.565,.559,6,6,1.000,5,13,18,9,7,3,4,9,44
275,Maxi Kleber\klebima01,PF,29,DAL,50,40,1341,116,275,.422,87,212,.410,29,63,.460,.580,34,37,.919,47,213,260,68,24,35,30,105,353
276,Nathan Knight\knighna01,PF,23,ATL,33,0,279,37,100,.370,6,33,.182,31,67,.463,.400,44,55,.800,27,45,72,8,9,10,15,22,124
277,Kevin Knox\knoxke01,SF,21,NYK,42,0,464,56,143,.392,35,89,.393,21,54,.389,.514,16,20,.800,10,51,61,19,12,6,17,37,163
278,John Konchar\konchjo01,SG,24,MEM,43,0,575,69,138,.500,21,56,.375,48,82,.585,.576,25,30,.833,35,93,128,47,30,9,18,40,184
279,Furkan Korkmaz\korkmfu01,SG,23,PHI,55,11,1062,170,424,.401,101,269,.375,69,155,.445,.520,60,82,.732,17,96,113,82,49,9,46,64,501
280,Luke Kornet\kornelu01,C-PF,25,TOT,31,2,348,44,101,.436,15,59,.254,29,42,.690,.510,3,6,.500,14,53,67,24,4,32,7,20,106
280,Luke Kornet\kornelu01,PF,25,CHI,13,0,94,9,27,.333,6,23,.261,3,4,.750,.444,2,4,.500,1,14,15,4,2,7,1,1,26
280,Luke Kornet\kornelu01,C,25,BOS,18,2,254,35,74,.473,9,36,.250,26,38,.684,.534,1,2,.500,13,39,52,20,2,25,6,19,80
281,Rodions Kurucs\kurucro01,SF-PF,22,TOT,21,0,125,11,32,.344,6,21,.286,5,11,.455,.438,3,4,.750,5,18,23,10,9,4,13,16,31
281,Rodions Kurucs\kurucro01,PF,22,BRK,5,0,16,1,3,.333,1,2,.500,0,1,.000,.500,0,0,,0,3,3,2,0,0,0,1,3
281,Rodions Kurucs\kurucro01,SF,22,HOU,11,0,75,5,21,.238,2,15,.133,3,6,.500,.286,1,2,.500,2,9,11,4,6,4,9,7,13
281,Rodions Kurucs\kurucro01,SF,22,MIL,5,0,34,5,8,.625,3,4,.750,2,4,.500,.813,2,2,1.000,3,6,9,4,3,0,4,8,15
282,Kyle Kuzma\kuzmaky01,SF,25,LAL,68,32,1954,335,757,.443,137,380,.361,198,377,.525,.533,67,97,.691,108,309,417,127,35,41,113,121,874
283,Anthony Lamb\lamban01,SF,23,HOU,24,3,415,46,118,.390,23,71,.324,23,47,.489,.487,18,21,.857,27,43,70,23,6,5,19,34,133
284,Jeremy Lamb\lambje01,SG,28,IND,36,8,765,120,276,.435,52,128,.406,68,148,.459,.529,71,75,.947,25,106,131,53,34,23,22,72,363
285,Romeo Langford\langfro01,SG,21,BOS,18,4,283,21,59,.356,5,18,.278,16,41,.390,.398,9,12,.750,12,23,35,13,6,5,10,24,56
286,Zach LaVine\lavinza01,SG,25,CHI,58,58,2034,569,1123,.507,200,477,.419,369,646,.571,.596,253,298,.849,36,253,289,282,46,27,203,138,1591
287,Jake Layman\laymaja01,SF,26,MIN,45,11,627,91,184,.495,23,78,.295,68,106,.642,.557,26,37,.703,13,54,67,28,29,19,26,44,231
288,T.J. Leaf\leaftj01,PF,23,POR,7,0,35,5,10,.500,0,0,,5,10,.500,.500,2,2,1.000,0,5,5,1,2,1,2,1,12
289,Jalen Lecque\lecquja01,PG,20,IND,4,0,12,1,9,.111,0,1,.000,1,8,.125,.111,3,3,1.000,2,3,5,2,0,0,0,0,5
290,Damion Lee\leeda03,SG,28,GSW,57,1,1079,128,274,.467,77,194,.397,51,80,.638,.608,40,44,.909,22,158,180,73,38,8,30,89,373
291,Saben Lee\leesa01,PG,21,DET,48,7,781,99,210,.471,8,23,.348,91,187,.487,.490,61,89,.685,20,77,97,174,32,13,55,76,267
292,Alex Len\lenal01,C,27,TOT,64,42,979,171,278,.615,8,25,.320,163,253,.644,.629,73,116,.629,78,182,260,49,20,64,55,127,423
292,Alex Len\lenal01,C,27,TOR,7,2,76,5,10,.500,3,6,.500,2,4,.500,.650,3,6,.500,0,11,11,3,1,6,8,10,16
292,Alex Len\lenal01,C,27,WAS,57,40,903,166,268,.619,5,19,.263,161,249,.647,.629,70,110,.636,78,171,249,46,19,58,47,117,407
293,Kawhi Leonard\leonaka01,SF,29,LAC,52,52,1773,465,908,.512,101,254,.398,364,654,.557,.568,261,295,.885,55,282,337,269,81,21,105,82,1292
294,Meyers Leonard\leoname01,C,28,MIA,3,2,29,3,7,.429,3,7,.429,0,0,,.643,1,2,.500,0,7,7,2,0,0,2,5,10
295,Caris LeVert\leverca01,SG,26,TOT,47,39,1486,359,814,.441,84,258,.326,275,556,.495,.493,146,180,.811,33,181,214,245,66,30,102,105,948
295,Caris LeVert\leverca01,SG,26,BRK,12,4,334,87,200,.435,22,63,.349,65,137,.474,.490,26,34,.765,10,42,52,72,13,6,26,20,222
295,Caris LeVert\leverca01,SG,26,IND,35,35,1152,272,614,.443,62,195,.318,210,419,.501,.493,120,146,.822,23,139,162,173,53,24,76,85,726
296,Kira Lewis Jr.\lewiski01,PG,19,NOP,54,0,904,130,337,.386,40,120,.333,90,217,.415,.445,43,51,.843,12,59,71,124,38,10,34,88,343
297,Damian Lillard\lillada01,PG,30,POR,67,67,2398,602,1334,.451,275,704,.391,327,630,.519,.554,449,484,.928,32,251,283,505,62,17,203,102,1928
298,Nassir Little\littlna01,PF,20,POR,48,2,640,78,167,.467,28,80,.350,50,87,.575,.551,36,45,.800,32,96,128,23,5,13,18,51,220
299,Kevon Looney\looneke01,C,24,GSW,61,34,1161,108,197,.548,4,17,.235,104,180,.578,.558,31,48,.646,117,205,322,119,21,22,37,136,251
300,Brook Lopez\lopezbr01,C,32,MIL,70,70,1902,322,640,.503,95,281,.338,227,359,.632,.577,120,142,.845,104,243,347,50,40,103,64,149,859
301,Robin Lopez\lopezro01,C,32,WAS,71,9,1354,269,425,.633,5,18,.278,264,407,.649,.639,99,137,.723,141,131,272,55,15,44,75,109,642
302,Didi Louzada\louzama01,SF,21,NOP,3,0,56,3,13,.231,2,8,.250,1,5,.200,.308,0,0,,1,2,3,3,2,0,3,5,8
303,Kevin Love\loveke01,PF,32,CLE,25,25,622,103,252,.409,57,156,.365,46,96,.479,.522,42,51,.824,17,169,186,63,16,2,38,26,305
304,Kyle Lowry\lowryky01,PG,34,TOR,46,46,1601,260,596,.436,131,331,.396,129,265,.487,.546,140,160,.875,35,212,247,338,45,14,126,143,791
305,Timothé Luwawu-Cabarrot\luwawti01,SF,25,BRK,58,7,1050,130,356,.365,75,239,.314,55,117,.470,.471,35,43,.814,28,101,129,69,33,6,43,99,370
306,Trey Lyles\lylestr01,PF,25,SAS,23,9,358,43,90,.478,14,40,.350,29,50,.580,.556,15,23,.652,9,77,86,14,6,1,6,13,115
307,Will Magnay\magnawi01,C,22,NOP,1,0,3,0,1,.000,0,1,.000,0,0,,.000,0,0,,0,0,0,0,0,0,1,1,0
308,Thon Maker\makerth01,C,23,CLE,8,0,76,10,18,.556,0,2,.000,10,16,.625,.556,10,11,.909,8,10,18,4,2,4,3,7,30
309,Théo Maledon\maledth01,PG,19,OKC,65,49,1778,226,614,.368,105,313,.335,121,301,.402,.454,101,135,.748,25,186,211,227,56,11,141,126,658
310,Karim Mané\maneka01,PG,20,ORL,10,0,88,3,13,.231,1,2,.500,2,11,.182,.269,4,5,.800,1,13,14,4,0,2,3,10,11
311,Terance Mann\mannte01,SG,24,LAC,67,10,1263,178,350,.509,38,91,.418,140,259,.541,.563,78,94,.830,56,186,242,104,29,13,40,126,472
312,Nico Mannion\mannini01,PG,19,GSW,30,1,364,39,114,.342,22,60,.367,17,54,.315,.439,23,28,.821,6,40,46,70,16,1,31,29,123
313,Boban Marjanović\marjabo01,C,32,DAL,33,3,271,62,122,.508,1,8,.125,61,114,.535,.512,31,38,.816,47,81,128,10,2,6,12,29,156
314,Lauri Markkanen\markkla01,PF,23,CHI,51,26,1317,250,521,.480,119,296,.402,131,225,.582,.594,76,92,.826,35,233,268,45,26,15,52,75,695
315,Naji Marshall\marshna01,SF,23,NOP,32,10,700,82,209,.392,29,83,.349,53,126,.421,.462,53,75,.707,15,133,148,88,26,10,38,58,246
316,Caleb Martin\martica02,SF,25,CHO,53,3,818,96,256,.375,31,125,.248,65,131,.496,.436,41,64,.641,31,110,141,67,37,12,33,62,264
317,Cody Martin\martico01,SF,25,CHO,52,10,849,83,188,.441,16,58,.276,67,130,.515,.484,25,43,.581,52,109,161,86,37,12,40,52,207
318,Jeremiah Martin\martije02,PG,24,CLE,9,0,75,9,33,.273,3,12,.250,6,21,.286,.318,1,5,.200,2,5,7,4,5,2,6,1,22
319,Kelan Martin\martike03,SF,25,IND,35,0,322,62,138,.449,24,60,.400,38,78,.487,.536,9,10,.900,18,60,78,17,10,10,16,35,157
320,Kenyon Martin Jr.\martike04,SF,20,HOU,45,8,1068,162,318,.509,35,96,.365,127,222,.572,.564,60,84,.714,73,169,242,48,30,41,38,89,419
321,Frank Mason III\masonfr01,PG,26,ORL,4,1,79,9,24,.375,2,5,.400,7,19,.368,.417,5,7,.714,3,9,12,12,0,0,5,7,25
322,Garrison Mathews\mathega01,SG,24,WAS,64,24,1038,97,237,.409,76,198,.384,21,39,.538,.570,84,95,.884,16,71,87,26,29,7,10,106,354
323,Dakota Mathias\mathida01,SG,25,PHI,8,2,123,19,48,.396,8,26,.308,11,22,.500,.479,2,6,.333,1,6,7,13,1,3,1,7,48
324,Wesley Matthews\matthwe02,SG,34,LAL,58,10,1130,89,252,.353,66,197,.335,23,55,.418,.484,35,41,.854,20,73,93,54,38,17,26,80,279
325,Tyrese Maxey\maxeyty01,SG,20,PHI,61,8,935,198,429,.462,31,103,.301,167,326,.512,.498,61,70,.871,11,93,104,120,26,13,41,79,488
326,Skylar Mays\mayssk01,SG,23,ATL,33,0,269,44,98,.449,14,40,.350,30,58,.517,.520,22,25,.880,10,25,35,30,14,2,9,15,124
327,Patrick McCaw\mccawpa01,SF,25,TOR,5,0,33,1,1,1.000,0,0,,1,1,1.000,1.000,3,3,1.000,1,2,3,4,2,0,0,6,5
328,CJ McCollum\mccolcj01,SG,29,POR,47,47,1600,405,884,.458,169,420,.402,236,464,.509,.554,108,133,.812,30,155,185,223,44,21,65,87,1087
329,T.J. McConnell\mccontj01,PG,28,IND,69,3,1796,274,490,.559,15,48,.313,259,442,.586,.574,33,48,.688,55,201,256,456,128,23,135,113,596
330,Jaden McDaniels\mcdanja02,PF,20,MIN,63,27,1511,164,367,.447,72,198,.364,92,169,.544,.545,27,45,.600,52,180,232,71,35,60,47,172,427
331,Jalen McDaniels\mcdanja01,SF,23,CHO,47,18,904,133,284,.468,35,105,.333,98,179,.547,.530,45,64,.703,45,124,169,53,28,19,45,95,346
332,Doug McDermott\mcderdo01,PF,29,IND,66,29,1619,354,665,.532,111,286,.388,243,379,.641,.616,80,98,.816,60,161,221,85,20,6,53,117,899
333,Sean McDermott\mcderse01,SF,24,MEM,18,0,158,13,33,.394,5,22,.227,8,11,.727,.470,8,8,1.000,6,13,19,4,2,3,4,8,39
334,JaVale McGee\mcgeeja01,C,33,TOT,46,2,678,144,282,.511,5,24,.208,139,258,.539,.520,44,67,.657,77,162,239,39,19,54,60,121,337
334,JaVale McGee\mcgeeja01,C,33,CLE,33,1,503,112,215,.521,5,20,.250,107,195,.549,.533,36,55,.655,54,116,170,33,16,40,45,80,265
334,JaVale McGee\mcgeeja01,C,33,DEN,13,1,175,32,67,.478,0,4,.000,32,63,.508,.478,8,12,.667,23,46,69,6,3,14,15,41,72
335,Rodney McGruder\mcgruro01,SG,29,DET,16,2,194,37,70,.529,11,24,.458,26,46,.565,.607,6,8,.750,8,14,22,16,8,1,7,12,91
336,Alfonzo McKinnie\mckinal01,SF,28,LAL,39,0,258,48,93,.516,16,39,.410,32,54,.593,.602,10,18,.556,22,32,54,6,7,0,5,26,122
337,Jordan McLaughlin\mclaujo01,PG,24,MIN,51,2,938,100,242,.413,33,92,.359,67,150,.447,.481,23,30,.767,21,87,108,193,51,6,51,44,256
338,Ben McLemore\mclembe01,SG,27,TOT,53,5,905,135,365,.370,97,280,.346,38,85,.447,.503,39,53,.736,15,85,100,39,23,9,42,88,406
338,Ben McLemore\mclembe01,SG,27,HOU,32,4,537,80,224,.357,55,166,.331,25,58,.431,.480,23,32,.719,11,55,66,28,20,3,28,51,238
338,Ben McLemore\mclembe01,SG,27,LAL,21,1,368,55,141,.390,42,114,.368,13,27,.481,.539,16,21,.762,4,30,34,11,3,6,14,37,168
339,Nicolò Melli\mellini01,PF,30,TOT,45,4,566,46,141,.326,23,85,.271,23,56,.411,.408,19,25,.760,29,93,122,44,14,3,12,58,134
339,Nicolò Melli\mellini01,PF,30,NOP,22,0,241,15,59,.254,7,37,.189,8,22,.364,.314,6,7,.857,12,45,57,25,9,1,7,28,43
339,Nicolò Melli\mellini01,PF,30,DAL,23,4,325,31,82,.378,16,48,.333,15,34,.441,.476,13,18,.722,17,48,65,19,5,2,5,30,91
340,De'Anthony Melton\meltode01,PG,22,MEM,52,1,1045,172,393,.438,87,211,.412,85,182,.467,.548,41,51,.804,30,131,161,132,60,31,66,85,472
341,Sam Merrill\merrisa01,SG,24,MIL,30,2,233,32,72,.444,21,47,.447,11,25,.440,.590,4,4,1.000,6,24,30,21,8,1,10,17,89
342,Chimezie Metu\metuch01,C,23,SAC,36,6,488,91,179,.508,13,37,.351,78,142,.549,.545,31,43,.721,31,81,112,28,14,18,29,59,226
343,Khris Middleton\middlkh01,SF,29,MIL,68,68,2269,511,1074,.476,151,365,.414,360,709,.508,.546,212,236,.898,54,352,406,370,74,9,178,160,1385
344,Darius Miller\milleda01,SF,30,OKC,18,0,197,22,48,.458,17,42,.405,5,6,.833,.635,12,12,1.000,2,22,24,21,13,5,8,13,73
345,Patty Mills\millspa02,PG,32,SAS,68,1,1685,252,611,.412,161,429,.375,91,182,.500,.544,71,78,.910,18,98,116,162,42,3,66,81,736
346,Paul Millsap\millspa01,PF,35,DEN,56,36,1162,191,401,.476,49,143,.343,142,258,.550,.537,71,98,.724,76,186,262,98,51,36,51,111,502
347,Shake Milton\miltosh01,SG,24,PHI,63,4,1461,300,667,.450,71,203,.350,229,464,.494,.503,146,176,.830,33,115,148,193,39,18,103,130,817
348,Donovan Mitchell\mitchdo01,PG,24,UTA,53,53,1771,478,1091,.438,178,461,.386,300,630,.476,.520,267,316,.845,50,185,235,277,52,15,147,117,1401
349,Adam Mokoka\mokokad01,SG,22,CHI,14,0,56,7,19,.368,1,10,.100,6,9,.667,.395,0,1,.000,1,4,5,5,2,1,5,5,15
350,Malik Monk\monkma01,SG,22,CHO,42,0,878,173,399,.434,85,212,.401,88,187,.471,.540,59,72,.819,14,87,101,87,19,4,55,47,490
351,E'Twaun Moore\mooreet01,SG,31,PHO,27,1,389,55,121,.455,11,35,.314,44,86,.512,.500,12,14,.857,14,31,45,40,15,5,23,32,133
352,Ja Morant\moranja01,PG,21,MEM,63,63,2053,430,957,.449,73,241,.303,357,716,.499,.487,271,372,.728,59,193,252,465,57,13,203,87,1204
353,Juwan Morgan\morgaju01,PF,23,UTA,29,0,147,14,30,.467,4,13,.308,10,17,.588,.533,3,7,.429,9,19,28,9,4,1,4,21,35
354,Marcus Morris\morrima03,PF,31,LAC,57,29,1502,276,584,.473,140,296,.473,136,288,.472,.592,73,89,.820,35,199,234,58,34,15,57,117,765
355,Markieff Morris\morrima02,PF,31,LAL,61,27,1200,153,378,.405,65,209,.311,88,169,.521,.491,36,50,.720,48,218,266,73,22,19,54,105,407
356,Monte Morris\morrimo01,PG,25,DEN,47,13,1196,186,387,.481,51,134,.381,135,253,.534,.547,58,73,.795,11,85,96,150,34,13,34,48,481
357,Mychal Mulder\muldemy01,PG,26,GSW,60,6,766,119,265,.449,85,214,.397,34,51,.667,.609,14,22,.636,8,52,60,26,12,12,16,56,337
358,Dejounte Murray\murrade01,PG,24,SAS,67,67,2139,441,974,.453,63,199,.317,378,775,.488,.485,106,134,.791,58,415,473,363,101,7,117,135,1051
359,Jamal Murray\murraja01,PG,23,DEN,48,48,1704,378,792,.477,129,316,.408,249,476,.523,.559,133,153,.869,37,157,194,231,64,13,108,95,1018
360,Mike Muscala\muscami01,C,29,OKC,35,0,645,119,267,.446,68,184,.370,51,83,.614,.573,33,36,.917,19,113,132,28,8,11,21,54,339
361,Svi Mykhailiuk\mykhasv01,SF-SG,23,TOT,66,14,1324,208,506,.411,105,314,.334,103,192,.536,.515,38,50,.760,24,139,163,110,51,12,88,63,559
361,Svi Mykhailiuk\mykhasv01,SF,23,DET,36,5,634,84,223,.377,57,171,.333,27,52,.519,.504,24,30,.800,11,63,74,57,27,6,39,33,249
361,Svi Mykhailiuk\mykhasv01,SG,23,OKC,30,9,690,124,283,.438,48,143,.336,76,140,.543,.523,14,20,.700,13,76,89,53,24,6,49,30,310
362,Abdel Nader\naderab01,SF,27,PHO,24,0,355,57,116,.491,18,43,.419,39,73,.534,.569,28,37,.757,7,55,62,19,10,9,19,34,160
363,Larry Nance Jr.\nancela02,PF,28,CLE,35,27,1091,128,272,.471,41,114,.360,87,158,.551,.546,30,49,.612,54,181,235,107,61,17,55,72,327
364,Aaron Nesmith\nesmiaa01,SF,21,BOS,46,1,669,78,178,.438,40,108,.370,38,70,.543,.551,22,28,.786,28,99,127,23,15,9,23,87,218
365,Raul Neto\netora01,PG,28,WAS,64,22,1403,209,447,.468,64,164,.390,145,283,.512,.539,75,85,.882,28,128,156,146,73,6,53,109,557
366,Georges Niang\niangge01,PF,27,UTA,72,10,1154,177,405,.437,124,292,.425,53,113,.469,.590,22,23,.957,28,148,176,59,25,8,51,116,500
367,Zeke Nnaji\nnajize01,PF,20,DEN,42,1,397,50,104,.481,24,59,.407,26,45,.578,.596,12,15,.800,14,51,65,10,8,4,7,29,136
368,Nerlens Noel\noelne01,C,26,NYK,64,41,1547,137,223,.614,0,3,.000,137,220,.623,.614,50,70,.714,142,266,408,46,70,141,65,176,324
369,Jaylen Nowell\nowelja01,SG,21,MIN,42,0,759,142,335,.424,50,150,.333,92,185,.497,.499,45,55,.818,19,76,95,62,22,12,28,72,379
370,Frank Ntilikina\ntilila01,PG,22,NYK,33,4,322,29,79,.367,23,48,.479,6,31,.194,.513,8,18,.444,6,25,31,19,18,4,11,45,89
371,Kendrick Nunn\nunnke01,PG,25,MIA,56,44,1650,319,658,.485,122,320,.381,197,338,.583,.578,56,60,.933,21,158,179,148,52,14,80,108,816
372,James Nunnally\nunnaja01,SF,30,NOP,9,0,48,5,13,.385,4,12,.333,1,1,1.000,.538,1,2,.500,2,7,9,3,0,0,2,1,15
373,Jusuf Nurkić\nurkiju01,C,26,POR,37,37,880,171,333,.514,12,30,.400,159,303,.525,.532,70,113,.619,86,246,332,125,38,39,73,103,424
374,David Nwaba\nwabada01,SF,28,HOU,30,9,679,106,218,.486,17,63,.270,89,155,.574,.525,47,68,.691,40,78,118,31,30,21,17,60,276
375,Jordan Nwora\nworajo01,SF,22,MIL,30,2,274,62,135,.459,28,62,.452,34,73,.466,.563,19,25,.760,9,51,60,7,16,7,24,22,171
376,Royce O'Neale\onealro01,SF,27,UTA,71,71,2241,175,394,.444,107,278,.385,68,116,.586,.580,39,46,.848,88,397,485,181,57,32,83,182,496
377,Semi Ojeleye\ojelese01,PF,26,BOS,56,15,950,89,221,.403,58,158,.367,31,63,.492,.534,24,32,.750,31,116,147,37,17,0,21,56,260
378,Jahlil Okafor\okafoja01,C,25,DET,27,2,347,63,102,.618,2,9,.222,61,93,.656,.627,17,24,.708,23,43,66,13,6,5,21,39,145
379,Chuma Okeke\okekech01,PF,22,ORL,45,19,1133,135,324,.417,49,141,.348,86,183,.470,.492,30,40,.750,42,139,181,101,48,22,38,48,349
380,Josh Okogie\okogijo01,SG,22,MIN,59,37,1197,102,254,.402,29,108,.269,73,146,.500,.459,83,108,.769,63,93,156,63,54,28,43,123,316
381,Onyeka Okongwu\okongon01,C,20,ATL,50,4,601,96,149,.644,0,3,.000,96,146,.658,.644,36,57,.632,62,101,163,18,23,33,29,100,228
382,Isaac Okoro\okorois01,SG,20,CLE,67,67,2173,235,559,.420,62,214,.290,173,345,.501,.476,114,157,.726,68,138,206,128,62,24,86,185,646
383,KZ Okpala\okpalkz01,PF,21,MIA,37,9,447,36,96,.375,12,50,.240,24,46,.522,.438,8,15,.533,21,47,68,19,10,11,15,59,92
384,Victor Oladipo\oladivi01,SG,28,TOT,33,33,1080,235,576,.408,78,239,.326,157,337,.466,.476,104,138,.754,12,148,160,151,46,14,83,81,652
384,Victor Oladipo\oladivi01,SG,28,IND,9,9,300,64,152,.421,25,69,.362,39,83,.470,.503,27,37,.730,1,50,51,38,15,2,18,23,180
384,Victor Oladipo\oladivi01,SG,28,HOU,20,20,669,155,381,.407,49,153,.320,106,228,.465,.471,65,83,.783,8,87,95,99,24,10,51,45,424
384,Victor Oladipo\oladivi01,SG,28,MIA,4,4,111,16,43,.372,4,17,.235,12,26,.462,.419,12,18,.667,3,11,14,14,7,2,14,13,48
385,Cameron Oliver\oliveca01,SF,24,HOU,4,0,87,19,33,.576,4,13,.308,15,20,.750,.636,1,4,.250,5,16,21,5,2,4,3,11,43
386,Kelly Olynyk\olynyke01,C-PF,29,TOT,70,62,1997,337,697,.484,126,368,.342,211,329,.641,.574,145,175,.829,87,402,489,203,79,42,126,207,945
386,Kelly Olynyk\olynyke01,C,29,MIA,43,38,1157,162,376,.431,77,243,.317,85,133,.639,.533,31,40,.775,44,217,261,91,40,26,55,123,432
386,Kelly Olynyk\olynyke01,PF,29,HOU,27,24,840,175,321,.545,49,125,.392,126,196,.643,.621,114,135,.844,43,185,228,112,39,16,71,84,513
387,Miye Oni\onimi01,SG,23,UTA,54,0,519,35,99,.354,30,88,.341,5,11,.455,.505,5,6,.833,23,61,84,28,11,8,16,61,105
388,Cedi Osman\osmande01,SF,25,CLE,59,26,1510,219,586,.374,99,324,.306,120,262,.458,.458,76,95,.800,38,163,201,174,53,9,80,119,613
389,Daniel Oturu\oturuda01,C,21,LAC,30,0,161,22,52,.423,1,5,.200,21,47,.447,.433,9,12,.750,21,27,48,10,4,7,9,24,54
390,Kelly Oubre Jr.\oubreke01,SF,25,GSW,55,50,1687,318,724,.439,90,285,.316,228,439,.519,.501,123,177,.695,82,247,329,73,57,42,70,121,849
391,Jabari Parker\parkeja01,PF,25,TOT,13,0,165,30,55,.545,2,11,.182,28,44,.636,.564,10,13,.769,10,32,42,11,1,5,10,13,72
391,Jabari Parker\parkeja01,PF,25,SAC,3,0,27,4,7,.571,0,1,.000,4,6,.667,.571,0,0,,1,5,6,1,0,1,3,4,8
391,Jabari Parker\parkeja01,PF,25,BOS,10,0,138,26,48,.542,2,10,.200,24,38,.632,.563,10,13,.769,9,27,36,10,1,4,7,9,64
392,Eric Paschall\pascher01,PF,24,GSW,40,2,695,148,298,.497,18,54,.333,130,244,.533,.527,67,94,.713,28,100,128,51,12,7,43,68,381
393,Anžejs Pasečņiks\pasecan01,C,25,WAS,1,0,6,0,1,.000,0,1,.000,0,0,,.000,0,0,,1,0,1,1,0,0,5,2,0
394,Patrick Patterson\pattepa01,PF,31,LAC,38,5,582,72,165,.436,40,112,.357,32,53,.604,.558,13,17,.765,19,56,75,29,14,8,11,45,197
395,Justin Patton\pattoju01,C,23,HOU,13,6,247,29,70,.414,9,34,.265,20,36,.556,.479,3,4,.750,14,35,49,14,12,14,4,34,70
396,Chris Paul\paulch01,PG,35,PHO,70,70,2199,439,879,.499,102,258,.395,337,621,.543,.557,169,181,.934,25,287,312,622,99,19,156,166,1149
397,Cameron Payne\payneca01,PG,26,PHO,60,1,1079,191,395,.484,73,166,.440,118,229,.515,.576,50,56,.893,16,128,144,217,36,16,60,97,505
398,Elfrid Payton\paytoel01,PG,26,NYK,63,63,1484,269,622,.432,28,98,.286,241,524,.460,.455,73,107,.682,64,152,216,203,47,9,103,116,639
399,Gary Payton II\paytoga02,PG,28,GSW,10,0,40,10,13,.769,2,4,.500,8,9,.889,.846,3,4,.750,2,9,11,1,6,1,1,8,25
400,Norvel Pelle\pelleno01,C,27,TOT,13,0,84,8,15,.533,0,0,,8,15,.533,.533,4,6,.667,6,13,19,2,1,9,3,14,20
400,Norvel Pelle\pelleno01,C,27,BRK,3,0,28,3,7,.429,0,0,,3,7,.429,.429,0,0,,3,4,7,0,0,3,3,9,6
400,Norvel Pelle\pelleno01,C,27,SAC,1,0,4,0,1,.000,0,0,,0,1,.000,.000,3,4,.750,1,0,1,1,0,0,0,1,3
400,Norvel Pelle\pelleno01,C,27,NYK,9,0,52,5,7,.714,0,0,,5,7,.714,.714,1,2,.500,2,9,11,1,1,6,0,4,11
401,Reggie Perry\perryre01,PF,20,BRK,26,0,211,32,78,.410,4,21,.190,28,57,.491,.436,10,13,.769,27,46,73,14,6,6,15,40,78
402,Theo Pinson\pinsoth01,SG,25,NYK,17,0,34,1,9,.111,0,8,.000,1,1,1.000,.111,0,0,,0,5,5,1,0,0,1,4,2
403,Mason Plumlee\plumlma01,C,30,DET,56,56,1499,234,381,.614,0,7,.000,234,374,.626,.614,113,169,.669,145,374,519,202,43,50,105,186,581
404,Jakob Poeltl\poeltja01,C,25,SAS,69,51,1845,265,430,.616,0,0,,265,430,.616,.616,63,124,.508,219,328,547,134,47,123,83,172,593
405,Vincent Poirier\poirivi01,C,27,PHI,10,0,39,3,12,.250,0,1,.000,3,11,.273,.250,2,6,.333,6,8,14,2,0,3,4,8,8
406,Aleksej Pokusevski\pokusal01,PF,19,OKC,45,28,1090,139,408,.341,58,207,.280,81,201,.403,.412,31,42,.738,30,182,212,97,20,42,99,58,367
407,Jordan Poole\poolejo01,SG,21,GSW,51,7,988,205,474,.432,97,276,.351,108,198,.545,.535,105,119,.882,15,77,92,99,26,9,51,86,612
408,Jontay Porter\portejo01,PF,21,MEM,11,0,54,8,15,.533,3,8,.375,5,7,.714,.633,3,5,.600,4,10,14,1,3,1,7,12,22
409,Kevin Porter Jr.\porteke02,SG,20,HOU,26,23,835,156,367,.425,50,161,.311,106,206,.515,.493,69,94,.734,20,79,99,164,19,8,91,61,431
410,Michael Porter Jr.\portemi01,SF,22,DEN,61,54,1912,443,817,.542,170,382,.445,273,435,.628,.646,106,134,.791,91,354,445,70,40,54,77,126,1162
411,Otto Porter Jr.\porteot01,SF-PF,27,TOT,28,6,606,98,227,.432,39,104,.375,59,123,.480,.518,36,42,.857,28,124,152,55,16,4,25,41,271
411,Otto Porter Jr.\porteot01,SF,27,CHI,25,6,540,89,202,.441,38,95,.400,51,107,.477,.535,31,37,.838,28,110,138,50,12,4,25,37,247
411,Otto Porter Jr.\porteot01,PF,27,ORL,3,0,66,9,25,.360,1,9,.111,8,16,.500,.380,5,5,1.000,0,14,14,5,4,0,0,4,24
412,Bobby Portis\portibo01,C,25,MIL,66,7,1372,313,598,.523,74,157,.471,239,441,.542,.585,54,73,.740,124,342,466,71,52,26,56,115,754
413,Kristaps Porziņģis\porzikr01,C,25,DAL,43,43,1327,325,683,.476,97,258,.376,228,425,.536,.547,118,138,.855,82,299,381,68,20,58,51,115,865
414,Dwight Powell\poweldw01,C,29,DAL,58,19,966,120,194,.619,5,21,.238,115,173,.665,.631,97,124,.782,80,154,234,63,36,30,40,135,342
415,Norman Powell\powelno01,SG-SF,27,TOT,69,58,2205,438,918,.477,171,416,.411,267,502,.532,.570,236,271,.871,42,173,215,129,82,18,119,160,1283
415,Norman Powell\powelno01,SG,27,TOR,42,31,1277,282,566,.498,118,269,.439,164,297,.552,.602,141,163,.865,19,107,126,77,47,8,77,98,823
415,Norman Powell\powelno01,SF,27,POR,27,27,928,156,352,.443,53,147,.361,103,205,.502,.518,95,108,.880,23,66,89,52,35,10,42,62,460
416,Taurean Prince\princta02,PF,26,TOT,41,10,905,131,327,.401,62,155,.400,69,172,.401,.495,65,76,.855,19,123,142,76,28,23,47,75,389
416,Taurean Prince\princta02,PF,26,BRK,12,4,218,30,74,.405,13,37,.351,17,37,.459,.493,24,27,.889,2,32,34,7,8,8,11,21,97
416,Taurean Prince\princta02,PF,26,CLE,29,6,687,101,253,.399,49,118,.415,52,135,.385,.496,41,49,.837,17,91,108,69,20,15,36,54,292
417,Payton Pritchard\pritcpa01,SG,23,BOS,66,4,1268,184,418,.440,102,248,.411,82,170,.482,.562,40,45,.889,33,125,158,120,37,9,53,104,510
418,Immanuel Quickley\quickim01,PG,21,NYK,64,3,1243,229,580,.395,118,303,.389,111,277,.401,.497,155,174,.891,25,112,137,127,30,12,58,114,731
419,Jahmi'us Ramsey\ramseja01,SG,19,SAC,13,0,94,15,38,.395,5,19,.263,10,19,.526,.461,5,5,1.000,2,8,10,6,4,1,3,8,40
420,Chasson Randle\randlch01,PG,27,ORL,41,5,837,92,237,.388,44,130,.338,48,107,.449,.481,38,48,.792,7,75,82,74,22,5,46,64,266
421,Julius Randle\randlju01,PF,26,NYK,71,71,2667,602,1321,.456,160,389,.411,442,932,.474,.516,348,429,.811,84,639,723,427,64,18,241,225,1712
422,Cam Reddish\reddica01,SF,21,ATL,26,21,750,96,263,.365,33,126,.262,63,137,.460,.428,67,82,.817,22,82,104,35,33,9,34,68,292
423,J.J. Redick\redicjj01,SG,36,TOT,44,0,723,106,267,.397,66,178,.371,40,89,.449,.521,49,52,.942,4,60,64,51,11,3,36,50,327
423,J.J. Redick\redicjj01,SG,36,NOP,31,0,576,87,214,.407,51,140,.364,36,74,.486,.526,45,47,.957,3,49,52,40,9,2,25,37,270
423,J.J. Redick\redicjj01,SG,36,DAL,13,0,147,19,53,.358,15,38,.395,4,15,.267,.500,4,5,.800,1,11,12,11,2,1,11,13,57
424,Paul Reed\reedpa01,PF,21,PHI,26,0,177,42,78,.538,0,6,.000,42,72,.583,.538,4,8,.500,30,31,61,12,10,13,12,29,88
425,Naz Reid\reidna01,C,21,MIN,70,15,1347,304,581,.523,61,174,.351,243,407,.597,.576,115,166,.693,82,240,322,72,34,76,69,179,784
426,Cameron Reynolds\reynoca01,SF,25,TOT,5,0,40,6,18,.333,3,12,.250,3,6,.500,.417,0,0,,2,3,5,2,0,0,0,2,15
426,Cameron Reynolds\reynoca01,SF,25,SAS,3,0,6,1,2,.500,0,0,,1,2,.500,.500,0,0,,0,0,0,0,0,0,0,0,2
426,Cameron Reynolds\reynoca01,SF,25,HOU,2,0,34,5,16,.313,3,12,.250,2,4,.500,.406,0,0,,2,3,5,2,0,0,0,2,13
427,Nick Richards\richani01,PF,23,CHO,18,0,63,4,9,.444,0,1,.000,4,8,.500,.444,7,11,.636,4,7,11,2,0,0,3,7,15
428,Josh Richardson\richajo01,SG,27,DAL,59,56,1790,264,618,.427,88,267,.330,176,351,.501,.498,99,108,.917,51,144,195,153,61,24,79,130,715
429,Grant Riller\rillegr01,PG,23,CHO,7,0,27,8,12,.667,2,4,.500,6,8,.750,.750,0,0,,0,1,1,3,1,0,1,0,18
430,Austin Rivers\riverau01,SG,28,TOT,36,7,845,104,245,.424,55,149,.369,49,96,.510,.537,22,31,.710,8,74,82,81,30,2,36,64,285
430,Austin Rivers\riverau01,SG,28,NYK,21,2,442,58,135,.430,28,77,.364,30,58,.517,.533,10,14,.714,5,42,47,42,12,0,22,32,154
430,Austin Rivers\riverau01,SG,28,DEN,15,5,403,46,110,.418,27,72,.375,19,38,.500,.541,12,17,.706,3,32,35,39,18,2,14,32,131
431,Andre Roberson\roberan03,SG,29,BRK,5,0,63,2,14,.143,1,8,.125,1,6,.167,.179,1,2,.500,7,8,15,4,3,1,2,4,6
432,Duncan Robinson\robindu01,SF,26,MIA,72,72,2262,315,717,.439,250,613,.408,65,104,.625,.614,62,75,.827,7,243,250,127,43,20,81,181,942
433,Glenn Robinson III\robingl02,SF,27,SAC,23,2,369,42,99,.424,16,44,.364,26,55,.473,.505,21,23,.913,11,34,45,20,4,3,11,23,121
434,Jerome Robinson\robinje01,SG,23,WAS,17,6,305,28,95,.295,11,42,.262,17,53,.321,.353,16,20,.800,4,34,38,25,12,6,19,31,83
435,Justin Robinson\robinju01,PG,23,OKC,9,0,88,7,21,.333,4,14,.286,3,7,.429,.429,3,5,.600,1,6,7,9,3,0,2,10,21
436,Mitchell Robinson\robinmi01,C,22,NYK,31,29,853,115,176,.653,0,0,,115,176,.653,.653,26,53,.491,113,139,252,17,35,45,26,86,256
437,Isaiah Roby\robyis01,PF,22,OKC,61,34,1425,207,429,.483,32,109,.294,175,320,.547,.520,87,117,.744,89,252,341,107,52,37,113,162,533
438,Rajon Rondo\rondora01,PG,34,TOT,45,3,770,95,215,.442,36,89,.404,59,126,.468,.526,16,17,.941,18,92,110,199,37,4,79,53,242
438,Rajon Rondo\rondora01,PG,34,ATL,27,2,402,44,110,.400,17,45,.378,27,65,.415,.477,1,2,.500,4,51,55,95,19,2,39,25,106
438,Rajon Rondo\rondora01,PG,34,LAC,18,1,368,51,105,.486,19,44,.432,32,61,.525,.576,15,15,1.000,14,41,55,104,18,2,40,28,136
439,Derrick Rose\rosede01,PG,32,TOT,50,3,1279,287,611,.470,50,129,.388,237,482,.492,.511,110,127,.866,20,110,130,209,49,19,78,56,734
439,Derrick Rose\rosede01,PG,32,DET,15,0,342,79,184,.429,13,39,.333,66,145,.455,.465,42,50,.840,6,23,29,63,18,4,29,17,213
439,Derrick Rose\rosede01,PG,32,NYK,35,3,937,208,427,.487,37,90,.411,171,337,.507,.530,68,77,.883,14,87,101,146,31,15,49,39,521
440,Terrence Ross\rosste01,SG,29,ORL,46,2,1347,254,616,.412,89,264,.337,165,352,.469,.485,120,138,.870,15,143,158,108,47,21,74,88,717
441,Terry Rozier\roziete01,SG,26,CHO,69,69,2383,510,1134,.450,222,571,.389,288,563,.512,.548,165,202,.817,47,255,302,293,87,26,128,119,1407
442,Ricky Rubio\rubiori01,PG,30,MIN,68,51,1772,193,498,.388,66,214,.308,127,284,.447,.454,130,150,.867,28,195,223,433,98,4,111,139,582
443,D'Angelo Russell\russeda01,PG,24,MIN,42,26,1196,281,652,.431,120,310,.387,161,342,.471,.523,114,149,.765,16,95,111,244,45,18,112,68,796
444,Domantas Sabonis\sabondo01,PF,24,IND,62,62,2231,484,904,.535,52,162,.321,432,742,.582,.564,240,328,.732,150,592,742,415,76,33,213,203,1260
445,Luka Šamanić\samanlu01,PF,21,SAS,33,4,308,47,105,.448,12,43,.279,35,62,.565,.505,16,29,.552,16,52,68,15,8,8,20,43,122
446,JaKarr Sampson\sampsja02,PF,27,IND,29,4,316,56,113,.496,3,15,.200,53,98,.541,.509,19,29,.655,27,50,77,4,2,14,15,52,134
447,Dario Šarić\saricda01,C,26,PHO,50,4,871,153,342,.447,47,135,.348,106,207,.512,.516,84,99,.848,46,144,190,65,30,4,57,95,437
448,Tomáš Satoranský\satorto01,SG,29,CHI,58,18,1307,169,329,.514,42,118,.356,127,211,.602,.578,67,79,.848,30,112,142,271,40,14,96,89,447
449,Dennis Schröder\schrode01,SG,27,LAL,61,61,1956,332,760,.437,71,212,.335,261,548,.476,.484,206,243,.848,30,181,211,351,70,13,163,159,941
450,Mike Scott\scottmi01,PF,32,PHI,51,12,852,76,211,.360,53,155,.342,23,56,.411,.486,8,12,.667,11,109,120,40,24,14,19,72,213
451,Jay Scrubb\scrubja01,SG,20,LAC,4,1,84,14,36,.389,2,9,.222,12,27,.444,.417,5,5,1.000,2,12,14,1,4,0,7,5,35
452,Collin Sexton\sextoco01,SG,22,CLE,60,60,2115,525,1105,.475,98,264,.371,427,841,.508,.519,312,383,.815,58,129,187,262,62,10,167,157,1460
453,Landry Shamet\shamela01,SG,23,BRK,61,12,1403,186,456,.408,129,333,.387,57,123,.463,.549,66,78,.846,11,101,112,99,31,10,48,93,567
454,Iman Shumpert\shumpim01,SG,30,BRK,2,0,11,1,4,.250,0,3,.000,1,1,1.000,.250,0,0,,1,0,1,0,1,0,1,0,2
455,Pascal Siakam\siakapa01,PF,26,TOR,56,56,2006,437,961,.455,73,246,.297,364,715,.509,.493,249,301,.827,95,310,405,250,64,37,130,174,1196
456,Chris Silva\silvach01,PF,24,TOT,15,0,92,10,16,.625,1,1,1.000,9,15,.600,.656,11,15,.733,7,20,27,6,1,6,10,24,32
456,Chris Silva\silvach01,PF,24,MIA,11,0,83,9,13,.692,1,1,1.000,8,12,.667,.731,11,15,.733,7,18,25,6,1,5,9,20,30
456,Chris Silva\silvach01,PF,24,SAC,4,0,9,1,3,.333,0,0,,1,3,.333,.333,0,0,,0,2,2,0,0,1,1,4,2
457,Ben Simmons\simmobe01,PG,24,PHI,58,58,1877,325,583,.557,3,10,.300,322,573,.562,.560,176,287,.613,93,324,417,401,93,35,173,171,829
458,Anfernee Simons\simonan01,SG,21,POR,64,0,1104,168,401,.419,120,282,.426,48,119,.403,.569,46,57,.807,14,126,140,89,18,8,43,96,502
459,Deividas Sirvydis\sirvyde01,SG,20,DET,20,0,133,14,40,.350,10,28,.357,4,12,.333,.475,3,6,.500,0,29,29,5,2,0,5,9,41
460,Alen Smailagić\smailal01,PF,20,GSW,15,1,84,11,27,.407,4,10,.400,7,17,.412,.481,2,6,.333,6,10,16,4,3,5,5,11,28
461,Marcus Smart\smartma01,PG,26,BOS,48,45,1581,203,510,.398,93,282,.330,110,228,.482,.489,128,162,.790,36,131,167,273,72,23,96,126,627
462,Dennis Smith Jr.\smithde03,PG,23,TOT,23,9,420,58,145,.400,19,58,.328,39,87,.448,.466,19,26,.731,12,43,55,77,23,14,26,37,154
462,Dennis Smith Jr.\smithde03,PG,23,NYK,3,0,28,2,10,.200,0,4,.000,2,6,.333,.200,5,6,.833,0,2,2,3,3,0,1,4,9
462,Dennis Smith Jr.\smithde03,PG,23,DET,20,9,392,56,135,.415,19,54,.352,37,81,.457,.485,14,20,.700,12,41,53,74,20,14,25,33,145
463,Ish Smith\smithis01,PG,32,WAS,44,1,924,129,297,.434,18,49,.367,111,248,.448,.465,19,33,.576,22,128,150,172,32,13,41,62,295
464,Jalen Smith\smithja04,PF,20,PHO,27,1,156,22,50,.440,4,17,.235,18,33,.545,.480,5,7,.714,7,30,37,4,1,5,7,16,53
465,Tony Snell\snellto01,SG,29,ATL,47,23,992,88,171,.515,62,109,.569,26,62,.419,.696,11,11,1.000,18,94,112,59,13,11,21,75,249
466,Ray Spalding\spaldra01,C,23,HOU,2,0,19,2,4,.500,0,1,.000,2,3,.667,.500,0,2,.000,2,2,4,0,0,2,3,3,4
467,Cassius Stanley\stanlca01,SG,21,IND,24,0,93,13,43,.302,3,13,.231,10,30,.333,.337,7,9,.778,8,12,20,1,1,2,1,14,36
468,Lamar Stevens\stevela01,PF,23,CLE,40,0,499,62,136,.456,4,25,.160,58,111,.523,.471,37,51,.725,24,72,96,25,17,13,23,53,165
469,Isaiah Stewart\stewais01,C,19,DET,68,14,1455,226,409,.553,21,63,.333,205,346,.592,.578,64,92,.696,159,294,453,59,39,86,67,184,537
470,Max Strus\strusma01,SF,24,MIA,39,0,507,85,187,.455,50,148,.338,35,39,.897,.588,16,24,.667,5,36,41,24,11,2,8,43,236
471,Edmond Sumner\sumneed01,SG,25,IND,53,24,861,148,282,.525,35,88,.398,113,194,.582,.587,68,83,.819,18,76,94,49,33,10,51,88,399
472,Jae'Sean Tate\tateja01,SF,25,HOU,70,58,2043,316,625,.506,60,195,.308,256,430,.595,.554,102,147,.694,132,242,374,178,85,36,98,222,794
473,Jayson Tatum\tatumja01,SF,22,BOS,64,64,2290,605,1318,.459,187,485,.386,418,833,.502,.530,295,340,.868,50,422,472,276,75,31,171,122,1692
474,Jeff Teague\teaguje01,PG,32,TOT,55,7,950,123,284,.433,36,82,.439,87,202,.431,.496,89,105,.848,15,73,88,132,34,12,64,56,371
474,Jeff Teague\teaguje01,PG,32,BOS,34,5,616,78,188,.415,26,56,.464,52,132,.394,.484,51,61,.836,10,47,57,73,26,7,39,43,233
474,Jeff Teague\teaguje01,PG,32,MIL,21,2,334,45,96,.469,10,26,.385,35,70,.500,.521,38,44,.864,5,26,31,59,8,5,25,13,138
475,Garrett Temple\templga01,SG,34,CHI,56,25,1528,158,381,.415,67,200,.335,91,181,.503,.503,40,50,.800,29,131,160,124,43,30,58,126,423
476,Tyrell Terry\terryty01,PG,20,DAL,11,0,56,5,16,.313,0,7,.000,5,9,.556,.313,1,3,.333,0,6,6,6,5,0,2,2,11
477,Daniel Theis\theisda01,C,28,TOT,65,51,1601,252,466,.541,49,152,.322,203,314,.646,.593,74,110,.673,93,263,356,108,41,57,66,167,627
477,Daniel Theis\theisda01,C,28,BOS,42,37,1027,159,288,.552,33,95,.347,126,193,.653,.609,46,67,.687,54,166,220,67,25,43,41,120,397
477,Daniel Theis\theisda01,C,28,CHI,23,14,574,93,178,.522,16,57,.281,77,121,.636,.567,28,43,.651,39,97,136,41,16,14,25,47,230
478,Brodric Thomas\thomabr01,SG,24,TOT,32,1,399,39,108,.361,16,59,.271,23,49,.469,.435,31,46,.674,8,45,53,30,15,10,22,40,125
478,Brodric Thomas\thomabr01,SG,24,HOU,4,0,24,2,7,.286,1,6,.167,1,1,1.000,.357,5,7,.714,1,3,4,4,1,1,4,5,10
478,Brodric Thomas\thomabr01,SG,24,CLE,28,1,375,37,101,.366,15,53,.283,22,48,.458,.441,26,39,.667,7,42,49,26,14,9,18,35,115
479,Isaiah Thomas\thomais02,PG,31,NOP,3,0,48,9,27,.333,3,12,.250,6,15,.400,.389,2,2,1.000,1,3,4,5,1,0,6,3,23
480,Khyri Thomas\thomakh01,SG,24,HOU,5,2,153,32,66,.485,9,27,.333,23,39,.590,.553,9,9,1.000,7,11,18,25,9,6,6,8,82
481,Matt Thomas\thomama02,SG,26,TOT,45,0,326,50,127,.394,27,80,.338,23,47,.489,.500,12,14,.857,7,37,44,19,4,0,14,18,139
481,Matt Thomas\thomama02,SG,26,TOR,26,0,192,24,62,.387,17,41,.415,7,21,.333,.524,6,7,.857,3,18,21,9,2,0,6,10,71
481,Matt Thomas\thomama02,SG,26,UTA,19,0,134,26,65,.400,10,39,.256,16,26,.615,.477,6,7,.857,4,19,23,10,2,0,8,8,68
482,Tristan Thompson\thomptr01,PF,29,BOS,54,43,1287,169,326,.518,0,3,.000,169,323,.523,.518,71,120,.592,169,270,439,67,24,33,62,119,409
483,Sindarius Thornwell\thornsi01,SG,26,TOT,21,1,217,15,46,.326,7,23,.304,8,23,.348,.402,4,8,.500,3,15,18,21,13,2,7,15,41
483,Sindarius Thornwell\thornsi01,SG,26,NOP,14,1,73,7,21,.333,3,9,.333,4,12,.333,.405,0,2,.000,1,4,5,4,5,1,4,3,17
483,Sindarius Thornwell\thornsi01,SG,26,ORL,7,0,144,8,25,.320,4,14,.286,4,11,.364,.400,4,6,.667,2,11,13,17,8,1,3,12,24
484,Matisse Thybulle\thybuma01,SG,23,PHI,65,8,1298,102,243,.420,43,143,.301,59,100,.590,.508,8,18,.444,30,94,124,63,105,71,32,127,255
485,Killian Tillie\tilliki02,C,22,MEM,18,1,182,19,57,.333,10,33,.303,9,24,.375,.421,9,11,.818,6,18,24,8,5,8,2,20,57
486,Xavier Tillman Sr.\tillmxa01,PF,22,MEM,59,12,1085,167,299,.559,22,65,.338,145,234,.620,.595,34,53,.642,74,182,256,75,44,33,45,116,390
487,Anthony Tolliver\tollian01,PF,35,PHI,11,0,99,4,17,.235,4,14,.286,0,3,.000,.353,5,6,.833,3,7,10,2,3,2,3,7,17
488,Obi Toppin\toppiob01,PF,22,NYK,62,0,683,104,209,.498,26,85,.306,78,124,.629,.560,19,26,.731,26,112,138,29,17,15,23,55,253
489,Juan Toscano-Anderson\toscaju01,SG,27,GSW,53,16,1107,121,209,.579,37,92,.402,84,117,.718,.667,22,31,.710,29,205,234,150,41,26,61,111,301
490,Axel Toupane\toupaax01,SF,28,MIL,8,1,61,4,11,.364,1,2,.500,3,9,.333,.409,5,7,.714,0,6,6,4,2,3,0,6,14
491,Karl-Anthony Towns\townska01,C,25,MIN,50,50,1689,425,875,.486,122,315,.387,303,560,.541,.555,267,311,.859,133,396,529,225,39,57,160,186,1239
492,Gary Trent Jr.\trentga02,SG,22,TOT,58,38,1802,320,785,.408,165,429,.385,155,356,.435,.513,83,106,.783,27,125,152,80,56,10,43,92,888
492,Gary Trent Jr.\trentga02,SG,22,POR,41,23,1262,217,524,.414,121,305,.397,96,219,.438,.530,58,75,.773,21,70,91,58,37,6,31,63,613
492,Gary Trent Jr.\trentga02,SG,22,TOR,17,15,540,103,261,.395,44,124,.355,59,137,.431,.479,25,31,.806,6,55,61,22,19,4,12,29,275
493,P.J. Tucker\tuckepj01,PF,35,TOT,52,33,1356,66,177,.373,40,119,.336,26,58,.448,.486,21,28,.750,51,153,204,61,39,20,40,125,193
493,P.J. Tucker\tuckepj01,PF,35,HOU,32,32,959,48,131,.366,27,86,.314,21,45,.467,.469,18,23,.783,33,115,148,45,29,18,33,91,141
493,P.J. Tucker\tuckepj01,PF,35,MIL,20,1,397,18,46,.391,13,33,.394,5,13,.385,.533,3,5,.600,18,38,56,16,10,2,7,34,52
494,Rayjon Tucker\tuckera01,PG,23,PHI,14,0,68,9,18,.500,2,7,.286,7,11,.636,.556,14,19,.737,1,10,11,6,2,0,4,8,34
495,Myles Turner\turnemy01,C,24,IND,47,47,1455,206,432,.477,69,206,.335,137,226,.606,.557,111,142,.782,63,243,306,48,40,159,67,165,592
496,Jonas Valančiūnas\valanjo01,C,28,MEM,62,61,1755,440,743,.592,21,57,.368,419,686,.611,.606,157,203,.773,253,523,776,112,35,57,100,179,1058
497,Denzel Valentine\valende01,SG,27,CHI,62,3,1036,155,416,.373,80,242,.331,75,174,.431,.469,16,17,.941,24,173,197,105,30,7,42,70,406
498,Jarred Vanderbilt\vandeja01,PF,21,MIN,64,30,1139,143,236,.606,1,5,.200,142,231,.615,.608,57,102,.559,118,250,368,76,64,46,53,123,344
499,Fred VanVleet\vanvlfr01,SG,26,TOR,52,52,1899,338,870,.389,174,476,.366,164,394,.416,.489,169,191,.885,32,188,220,328,87,37,95,119,1019
500,Anderson Varejão\varejan01,C,38,CLE,5,0,36,4,16,.250,0,1,.000,4,15,.267,.250,5,9,.556,7,13,20,3,0,2,1,3,13
501,Devin Vassell\vassede01,SF,20,SAS,62,7,1056,123,303,.406,52,150,.347,71,153,.464,.492,43,51,.843,24,150,174,56,43,18,22,88,341
502,Gabe Vincent\vincega01,PG,24,MIA,50,7,655,88,233,.378,46,149,.309,42,84,.500,.476,20,23,.870,10,46,56,67,21,2,34,79,242
503,Noah Vonleh\vonleno01,PF,25,BRK,4,0,11,0,3,.000,0,2,.000,0,1,.000,.000,0,0,,0,1,1,1,0,0,2,2,0
504,Nikola Vučević\vucevni01,C,30,TOT,70,70,2348,666,1396,.477,176,440,.400,490,956,.513,.540,131,156,.840,146,671,817,269,65,48,126,137,1639
504,Nikola Vučević\vucevni01,C,30,ORL,44,44,1500,436,908,.480,117,288,.406,319,620,.515,.545,91,110,.827,87,430,517,167,42,28,83,79,1080
504,Nikola Vučević\vucevni01,C,30,CHI,26,26,848,230,488,.471,59,152,.388,171,336,.509,.532,40,46,.870,59,241,300,102,23,20,43,58,559
505,Dean Wade\wadede01,PF,24,CLE,63,19,1212,134,311,.431,78,213,.366,56,98,.571,.556,30,39,.769,38,177,215,74,35,21,30,78,376
506,Moritz Wagner\wagnemo01,C,23,TOT,45,24,722,104,229,.454,31,91,.341,73,138,.529,.522,71,87,.816,27,119,146,50,26,18,43,108,310
506,Moritz Wagner\wagnemo01,C,23,WAS,25,13,375,62,122,.508,13,42,.310,49,80,.613,.561,41,52,.788,13,60,73,32,22,8,21,62,178
506,Moritz Wagner\wagnemo01,C,23,BOS,9,1,61,4,14,.286,2,6,.333,2,8,.250,.357,1,2,.500,3,16,19,6,0,1,9,10,11
506,Moritz Wagner\wagnemo01,C,23,ORL,11,10,286,38,93,.409,16,43,.372,22,50,.440,.495,29,33,.879,11,43,54,12,4,9,13,36,121
507,Kemba Walker\walkeke02,PG,30,BOS,43,43,1369,284,676,.420,127,353,.360,157,323,.486,.514,134,149,.899,16,154,170,212,48,12,88,61,829
508,Lonnie Walker IV\walkelo01,SG,22,SAS,60,38,1522,256,609,.420,100,282,.355,156,327,.477,.502,57,70,.814,14,141,155,101,29,15,65,101,669
509,John Wall\walljo01,PG,30,HOU,40,40,1288,293,726,.404,79,249,.317,214,477,.449,.458,158,211,.749,17,112,129,275,42,31,141,46,823
510,Brad Wanamaker\wanambr01,PG,31,TOT,61,0,1053,115,299,.385,16,85,.188,99,214,.463,.411,90,101,.891,18,87,105,174,43,11,71,94,336
510,Brad Wanamaker\wanambr01,PG,31,GSW,39,0,625,61,173,.353,13,61,.213,48,112,.429,.390,50,56,.893,8,58,66,99,26,6,37,55,185
510,Brad Wanamaker\wanambr01,PG,31,CHO,22,0,428,54,126,.429,3,24,.125,51,102,.500,.440,40,45,.889,10,29,39,75,17,5,34,39,151
511,T.J. Warren\warretj01,SF,27,IND,4,4,117,27,51,.529,0,7,.000,27,44,.614,.529,8,10,.800,2,12,14,5,2,0,4,16,62
512,P.J. Washington\washipj01,PF,22,CHO,64,61,1954,302,686,.440,112,290,.386,190,396,.480,.522,108,145,.745,93,325,418,161,69,79,128,171,824
513,Yuta Watanabe\watanyu01,SF,26,TOR,50,4,723,79,180,.439,36,90,.400,43,90,.478,.539,24,29,.828,36,123,159,40,26,19,19,57,218
514,Tremont Waters\watertr01,PG,23,BOS,26,3,238,34,84,.405,15,38,.395,19,46,.413,.494,16,17,.941,5,16,21,62,15,1,27,17,99
515,Paul Watson\watsopa01,SF,26,TOR,27,2,297,38,82,.463,30,64,.469,8,18,.444,.646,5,8,.625,4,41,45,17,6,3,9,36,111
516,Quinndary Weatherspoon\weathqu01,SG,24,SAS,20,0,121,16,35,.457,1,6,.167,15,29,.517,.471,13,16,.813,3,8,11,8,8,2,10,18,46
517,Russell Westbrook\westbru01,PG,32,WAS,65,65,2369,544,1238,.439,86,273,.315,458,965,.475,.474,271,413,.656,109,641,750,763,89,23,312,190,1445
518,Coby White\whiteco01,PG,20,CHI,69,54,2156,375,902,.416,163,454,.359,212,448,.473,.506,128,142,.901,28,256,284,328,38,15,156,179,1041
519,Derrick White\whitede01,SG,26,SAS,36,32,1064,186,453,.411,84,243,.346,102,210,.486,.503,97,114,.851,13,94,107,127,26,36,45,91,553
520,Hassan Whiteside\whiteha01,C,31,SAC,36,4,546,126,224,.563,0,1,.000,126,223,.565,.563,41,79,.519,61,154,215,20,9,46,40,73,293
521,Greg Whittington\whittgr01,PF,27,DEN,4,0,12,0,3,.000,0,2,.000,0,1,.000,.000,0,0,,0,0,0,0,0,0,0,0,0
522,Andrew Wiggins\wiggian01,PF,25,GSW,71,71,2364,505,1058,.477,140,368,.380,365,690,.529,.543,170,238,.714,82,265,347,167,67,70,126,159,1320
523,Grant Williams\willigr01,PF,22,BOS,63,9,1138,108,247,.437,48,129,.372,60,118,.508,.534,30,51,.588,48,130,178,64,32,24,56,161,294
524,Kenrich Williams\willike04,PF,26,OKC,66,13,1426,219,411,.533,52,117,.444,167,294,.568,.596,36,63,.571,84,189,273,152,55,17,76,143,526
525,Lou Williams\willilo02,PG,34,TOT,66,4,1423,265,646,.410,69,173,.399,196,473,.414,.464,150,173,.867,21,117,138,225,47,6,108,62,749
525,Lou Williams\willilo02,PG,34,LAC,42,3,918,181,430,.421,45,119,.378,136,311,.437,.473,103,119,.866,15,73,88,144,39,4,66,42,510
525,Lou Williams\willilo02,PG,34,ATL,24,1,505,84,216,.389,24,54,.444,60,162,.370,.444,47,54,.870,6,44,50,81,8,2,42,20,239
526,Patrick Williams\willipa01,PF,19,CHI,71,71,1983,255,528,.483,54,138,.391,201,390,.515,.534,91,125,.728,66,261,327,99,64,46,98,126,655
527,Robert Williams\williro04,C,23,BOS,52,13,985,186,258,.721,0,2,.000,186,256,.727,.721,45,73,.616,133,225,358,94,43,91,52,105,417
528,Zion Williamson\willizi01,PF,20,NOP,61,61,2026,634,1037,.611,10,34,.294,624,1003,.622,.616,369,529,.698,167,274,441,226,57,39,167,135,1647
529,D.J. Wilson\wilsodj01,PF,24,TOT,35,1,433,68,168,.405,30,87,.345,38,81,.469,.494,17,25,.680,20,92,112,23,11,16,22,44,183
529,D.J. Wilson\wilsodj01,PF,24,MIL,12,0,105,16,43,.372,10,28,.357,6,15,.400,.488,1,2,.500,3,22,25,3,1,4,4,13,43
529,D.J. Wilson\wilsodj01,PF,24,HOU,23,1,328,52,125,.416,20,59,.339,32,66,.485,.496,16,23,.696,17,70,87,20,10,12,18,31,140
530,Dylan Windler\windldy01,SF,24,CLE,31,0,513,57,130,.438,26,77,.338,31,53,.585,.538,21,27,.778,20,87,107,33,19,12,32,37,161
531,Justise Winslow\winslju01,SF,24,MEM,26,1,507,74,210,.352,10,54,.185,64,156,.410,.376,20,35,.571,18,100,118,50,15,12,37,47,178
532,Cassius Winston\winstca01,PG,22,WAS,22,0,98,14,33,.424,8,17,.471,6,16,.375,.545,5,6,.833,0,9,9,12,2,1,5,8,41
533,James Wiseman\wisemja01,C,19,GSW,39,27,836,191,368,.519,12,38,.316,179,330,.542,.535,54,86,.628,55,171,226,26,11,36,60,121,448
534,Christian Wood\woodch01,C,25,HOU,41,41,1326,329,640,.514,77,206,.374,252,434,.581,.574,125,198,.631,76,319,395,71,34,48,80,88,860
535,Robert Woodard II\woodaro01,SF,21,SAC,13,0,45,8,20,.400,1,6,.167,7,14,.500,.425,3,8,.375,4,12,16,2,0,3,1,4,20
536,Delon Wright\wrighde01,SG-PG,28,TOT,63,39,1748,240,518,.463,64,172,.372,176,346,.509,.525,101,126,.802,65,204,269,278,101,30,83,75,645
536,Delon Wright\wrighde01,SG,28,DET,36,31,1052,136,293,.464,31,89,.348,105,204,.515,.517,71,90,.789,37,127,164,181,58,19,48,45,374
536,Delon Wright\wrighde01,PG,28,SAC,27,8,696,104,225,.462,33,83,.398,71,142,.500,.536,30,36,.833,28,77,105,97,43,11,35,30,271
537,Thaddeus Young\youngth01,PF,32,CHI,68,23,1652,370,662,.559,12,45,.267,358,617,.580,.568,71,113,.628,168,255,423,291,74,40,137,152,823
538,Trae Young\youngtr01,PG,22,ATL,63,63,2125,487,1112,.438,136,397,.343,351,715,.491,.499,484,546,.886,38,207,245,594,53,12,261,111,1594
539,Cody Zeller\zelleco01,C,28,CHO,48,21,1005,181,324,.559,4,28,.143,177,296,.598,.565,85,119,.714,119,209,328,86,27,17,51,121,451
540,Ivica Zubac\zubaciv01,C,23,LAC,72,33,1609,257,394,.652,1,4,.250,256,390,.656,.654,135,171,.789,189,330,519,90,24,62,81,187,650