Rk,Player,Pos,Age,Tm,G,GS,MP,FG,FGA,FG%,3P,3PA,3P%,2P,2PA,2P%,eFG%,FT,FTA,FT%,ORB,DRB,TRB,AST,STL,BLK,TOV,PF,PTS
1,Precious Achiuwa\achiupr01,C,22,TOR,73,28,1725,265,603,.439,56,156,.359,209,447,.468,.486,78,131,.595,146,327,473,82,37,41,84,151,664
2,Steven Adams\adamsst01,C,28,MEM,76,75,1999,210,384,.547,0,1,.000,210,383,.548,.547,108,199,.543,349,411,760,256,65,60,115,153,528
3,Bam Adebayo\adebaba01,C,24,MIA,56,56,1825,406,729,.557,0,6,.000,406,723,.562,.557,256,340,.753,137,427,564,190,80,44,148,171,1068
4,Santi Aldama\aldamsa01,PF,21,MEM,32,0,360,53,132,.402,6,48,.125,47,84,.560,.424,20,32,.625,33,54,87,21,6,10,16,36,132
5,LaMarcus Aldridge\aldrila01,C,36,BRK,47,12,1050,252,458,.550,14,46,.304,238,412,.578,.566,89,102,.873,73,185,258,42,14,47,44,78,607
6,Nickeil Alexander-Walker\alexani01,SG,23,TOT,65,21,1466,253,680,.372,105,338,.311,148,342,.433,.449,81,109,.743,37,150,187,156,46,23,93,103,692
6,Nickeil Alexander-Walker\alexani01,SG,23,NOP,50,19,1317,237,632,.375,95,305,.311,142,327,.434,.450,70,97,.722,36,128,164,139,41,19,85,88,639
6,Nickeil Alexander-Walker\alexani01,SG,23,UTA,15,2,149,16,48,.333,10,33,.303,6,15,.400,.438,11,12,.917,1,22,23,17,5,4,8,15,53
7,Grayson Allen\allengr01,SG,26,MIL,66,61,1805,255,569,.448,159,389,.409,96,180,.533,.588,64,74,.865,32,190,222,100,46,18,43,96,733
8,Jarrett Allen\allenja01,C,23,CLE,56,56,1809,369,545,.677,1,10,.100,368,535,.688,.678,165,233,.708,192,410,602,92,44,75,94,97,904
9,Jose Alvarado\alvarjo01,PG,23,NOP,54,1,834,131,294,.446,32,110,.291,99,184,.538,.500,36,53,.679,25,75,100,152,71,7,40,73,330
10,Justin Anderson\anderju01,SF,28,TOT,16,6,316,36,95,.379,15,59,.254,21,36,.583,.458,15,19,.789,4,42,46,33,8,6,8,22,102
10,Justin Anderson\anderju01,SF,28,CLE,3,0,47,4,8,.500,2,6,.333,2,2,1.000,.625,3,4,.750,0,6,6,6,1,0,2,4,13
10,Justin Anderson\anderju01,SF,28,IND,13,6,269,32,87,.368,13,53,.245,19,34,.559,.443,12,15,.800,4,36,40,27,7,6,6,18,89
11,Kyle Anderson\anderky01,PF,28,MEM,69,11,1484,209,469,.446,36,109,.330,173,360,.481,.484,67,105,.638,69,299,368,183,77,45,71,108,521
12,Giannis Antetokounmpo\antetgi01,PF,27,MIL,67,67,2204,689,1245,.553,71,242,.293,618,1003,.616,.582,553,766,.722,134,644,778,388,72,91,219,212,2002
13,Thanasis Antetokounmpo\antetth01,SF,29,MIL,48,6,473,70,128,.547,2,14,.143,68,114,.596,.555,29,46,.630,40,61,101,22,16,12,26,68,171
14,Carmelo Anthony\anthoca01,PF,37,LAL,69,3,1793,319,723,.441,149,397,.375,170,326,.521,.544,132,159,.830,62,226,288,68,47,52,59,166,919
15,Cole Anthony\anthoco01,PG,21,ORL,65,65,2059,357,912,.391,132,391,.338,225,521,.432,.464,216,253,.854,32,316,348,369,46,17,170,171,1062
16,OG Anunoby\anunoog01,SF,24,TOR,48,48,1728,309,697,.443,115,317,.363,194,380,.511,.526,89,118,.754,74,190,264,125,71,25,80,131,822
17,Ryan Arcidiacono\arcidry01,PG,27,NYK,10,0,76,6,12,.500,4,9,.444,2,3,.667,.667,0,0,,0,8,8,4,1,0,3,5,16
18,Trevor Ariza\arizatr01,SF,36,LAL,24,11,462,33,99,.333,20,74,.270,13,25,.520,.434,10,18,.556,10,72,82,27,13,6,11,20,96
19,D.J. Augustin\augusdj01,PG,34,TOT,55,2,883,94,222,.423,68,164,.415,26,58,.448,.577,38,43,.884,11,57,68,107,17,1,56,39,294
19,D.J. Augustin\augusdj01,PG,34,HOU,34,2,510,55,136,.404,39,96,.406,16,40,.400,.548,33,38,.868,7,34,41,74,10,0,45,17,182
19,D.J. Augustin\augusdj01,PG,34,LAL,21,0,373,39,86,.453,29,68,.426,10,18,.556,.622,5,5,1.000,4,23,27,33,7,1,11,22,112
20,Deni Avdija\avdijde01,SF,21,WAS,82,8,1984,250,579,.432,82,259,.317,168,320,.525,.503,103,136,.757,52,373,425,167,59,44,87,190,685
21,Joel Ayayi\ayayijo01,SG,21,WAS,7,0,20,1,6,.167,0,1,.000,1,5,.200,.167,0,0,,1,2,3,4,0,0,0,0,2
22,Deandre Ayton\aytonde01,C,23,PHO,58,58,1713,442,697,.634,7,19,.368,435,678,.642,.639,106,142,.746,149,444,593,84,40,40,91,142,997
23,Udoka Azubuike\azubuud01,C,22,UTA,17,6,195,37,49,.755,0,0,,37,49,.755,.755,6,11,.545,18,53,71,0,1,11,12,25,80
24,Marvin Bagley III\baglema01,PF,22,TOT,48,25,1146,225,446,.504,23,97,.237,202,349,.579,.530,67,101,.663,105,233,338,36,22,18,39,93,540
24,Marvin Bagley III\baglema01,PF,22,SAC,30,17,656,114,246,.463,15,62,.242,99,184,.538,.494,35,47,.745,67,148,215,17,9,11,21,50,278
24,Marvin Bagley III\baglema01,PF,22,DET,18,8,490,111,200,.555,8,35,.229,103,165,.624,.575,32,54,.593,38,85,123,19,13,7,18,43,262
25,LaMelo Ball\ballla01,PG,20,CHO,75,75,2422,538,1254,.429,220,565,.389,318,689,.462,.517,212,243,.872,108,393,501,571,119,30,245,237,1508
26,Lonzo Ball\balllo01,PG,24,CHI,35,35,1212,162,383,.423,110,260,.423,52,123,.423,.567,21,28,.750,35,155,190,178,64,31,82,85,455
27,Mo Bamba\bambamo01,C,23,ORL,71,69,1824,296,617,.480,107,281,.381,189,336,.563,.566,57,73,.781,148,424,572,85,38,118,77,182,756
28,Desmond Bane\banede01,SF,23,MEM,76,76,2266,508,1101,.461,228,523,.436,280,578,.484,.565,140,155,.903,46,288,334,208,92,29,111,196,1384
29,Dalano Banton\bantoda01,PG,22,TOR,64,1,696,83,202,.411,13,51,.255,70,151,.464,.443,26,44,.591,38,86,124,99,28,10,53,68,205
30,Cat Barber\barbeca01,PG,27,ATL,3,0,13,0,4,.000,0,0,,0,4,.000,.000,0,4,.000,1,2,3,3,0,0,1,1,0
31,Harrison Barnes\barneha02,PF,29,SAC,77,77,2587,391,834,.469,142,360,.394,249,474,.525,.554,341,413,.826,82,350,432,186,53,14,118,94,1265
32,Scottie Barnes\barnesc01,PF,20,TOR,74,74,2617,459,932,.492,58,193,.301,401,739,.543,.524,158,215,.735,195,362,557,256,80,55,136,192,1134
33,RJ Barrett\barrerj01,SF,21,NYK,70,70,2417,487,1194,.408,138,404,.342,349,790,.442,.466,290,406,.714,66,342,408,208,43,16,151,142,1402
34,Will Barton\bartowi01,SG,31,DEN,71,71,2277,392,896,.438,157,430,.365,235,466,.504,.525,102,127,.803,44,296,340,276,55,31,127,114,1043
35,Paris Bass\basspa01,SF,26,PHO,2,0,7,2,6,.333,0,2,.000,2,4,.500,.333,2,2,1.000,2,2,4,0,1,0,2,2,6
36,Charles Bassey\bassech01,PF,21,PHI,23,0,168,30,47,.638,0,4,.000,30,43,.698,.638,9,12,.750,22,40,62,7,5,17,8,32,69
37,Keita Bates-Diop\bateske01,SF,26,SAS,59,14,956,136,263,.517,17,55,.309,119,208,.572,.549,46,61,.754,62,169,231,41,27,14,45,61,335
38,Nicolas Batum\batumni01,PF,33,LAC,59,54,1462,179,387,.463,108,270,.400,71,117,.607,.602,25,38,.658,29,225,254,100,58,42,40,80,491
39,Kent Bazemore\bazemke01,SF,32,LAL,39,14,545,45,139,.324,29,80,.363,16,59,.271,.428,13,17,.765,13,56,69,34,25,9,21,70,132
40,Darius Bazley\bazleda01,PF,21,OKC,69,53,1924,274,649,.422,80,269,.297,194,380,.511,.484,117,170,.688,71,365,436,97,58,70,90,68,745
41,Bradley Beal\bealbr01,SG,28,WAS,40,40,1439,348,771,.451,63,210,.300,285,561,.508,.492,169,203,.833,38,151,189,265,36,15,135,95,928
42,Malik Beasley\beaslma01,SG,25,MIN,79,18,1976,332,850,.391,240,637,.377,92,213,.432,.532,49,60,.817,26,201,227,116,43,12,43,88,953
43,Jordan Bell\belljo01,C,27,CHI,1,0,2,0,0,,0,0,,0,0,,,0,0,,1,0,1,0,1,0,0,2,0
44,DeAndre' Bembry\bembrde01,SF,27,TOT,56,20,1026,124,221,.561,15,36,.417,109,185,.589,.595,21,35,.600,42,121,163,66,49,25,31,113,284
44,DeAndre' Bembry\bembrde01,SF,27,BRK,48,20,949,121,213,.568,15,36,.417,106,177,.599,.603,21,35,.600,38,114,152,60,47,25,30,104,278
44,DeAndre' Bembry\bembrde01,SF,27,MIL,8,0,77,3,8,.375,0,0,,3,8,.375,.375,0,0,,4,7,11,6,2,0,1,9,6
45,Dāvis Bertāns\bertada01,PF,29,TOT,56,0,807,99,275,.360,77,230,.335,22,45,.489,.500,36,40,.900,12,105,117,31,17,12,19,85,311
45,Dāvis Bertāns\bertada01,PF,29,WAS,34,0,501,60,171,.351,46,144,.319,14,27,.519,.485,28,30,.933,6,55,61,16,11,6,14,55,194
45,Dāvis Bertāns\bertada01,PF,29,DAL,22,0,306,39,104,.375,31,86,.360,8,18,.444,.524,8,10,.800,6,50,56,15,6,6,5,30,117
46,Patrick Beverley\beverpa01,PG,33,MIN,58,54,1476,177,436,.406,83,242,.343,94,194,.485,.501,96,133,.722,62,178,240,268,67,52,73,174,533
47,Saddiq Bey\beysa01,SF,22,DET,82,82,2704,450,1136,.396,211,610,.346,239,526,.454,.489,210,254,.827,107,334,441,233,73,16,96,128,1321
48,Khem Birch\birchkh01,C,29,TOR,55,28,991,97,200,.485,0,14,.000,97,186,.522,.485,53,71,.746,122,117,239,56,30,26,29,104,247
49,Goga Bitadze\bitadgo01,C,22,IND,50,16,729,131,252,.520,23,80,.288,108,172,.628,.565,64,94,.681,79,98,177,55,21,42,46,107,349
50,Bismack Biyombo\biyombi01,C,29,PHO,36,3,506,86,145,.593,0,0,,86,145,.593,.593,38,71,.535,63,104,167,23,12,26,25,70,210
51,Nemanja Bjelica\bjeline01,C,33,GSW,71,0,1142,160,342,.468,54,149,.362,106,193,.549,.547,59,81,.728,62,232,294,159,41,26,87,128,433
52,Eric Bledsoe\bledser01,PG,32,LAC,54,29,1361,197,468,.421,51,163,.313,146,305,.479,.475,89,117,.761,28,154,182,225,69,19,116,85,534
53,Keljin Blevins\blevike01,SF,26,POR,31,1,349,34,111,.306,21,72,.292,13,39,.333,.401,6,11,.545,16,29,45,19,13,1,17,29,95
54,Bogdan Bogdanović\bogdabo01,SG,29,ATL,63,27,1848,342,794,.431,169,459,.368,173,335,.516,.537,97,115,.843,29,221,250,194,68,14,70,132,950
55,Bojan Bogdanović\bogdabo02,PF,32,UTA,69,69,2131,422,928,.455,181,468,.387,241,460,.524,.552,223,260,.858,58,238,296,120,34,1,118,116,1248
56,Bol Bol\bolbo01,PF,22,DEN,14,0,81,15,27,.556,1,4,.250,14,23,.609,.574,2,5,.400,4,16,20,5,1,2,4,4,33
57,Leandro Bolmaro\bolmale01,SF,21,MIN,35,2,241,17,54,.315,5,18,.278,12,36,.333,.361,11,13,.846,16,27,43,21,6,0,13,26,50
58,Isaac Bonga\bongais01,SF,22,TOR,15,0,69,3,13,.231,1,4,.250,2,9,.222,.269,5,8,.625,4,3,7,4,8,2,2,10,12
59,Devin Booker\bookede01,SG,25,PHO,68,68,2345,662,1421,.466,183,478,.383,479,943,.508,.530,315,363,.868,45,297,342,329,77,26,162,180,1822
60,Brandon Boston Jr.\bostobr01,SG,20,LAC,51,0,760,125,325,.385,34,111,.306,91,214,.425,.437,59,72,.819,17,94,111,51,26,13,31,43,343
61,Chris Boucher\bouchch01,PF,29,TOR,80,9,1690,268,577,.464,68,229,.297,200,348,.575,.523,150,193,.777,179,315,494,25,49,75,42,174,754
62,James Bouknight\bouknja01,SG,21,CHO,31,0,304,49,141,.348,17,49,.347,32,92,.348,.408,27,31,.871,22,30,52,26,7,1,15,29,142
63,Avery Bradley\bradlav01,SG,31,LAL,62,45,1406,148,350,.423,82,210,.390,66,140,.471,.540,16,18,.889,31,105,136,47,53,9,38,118,394
64,Tony Bradley\bradlto01,C,24,CHI,55,7,549,72,123,.585,0,0,,72,123,.585,.585,19,29,.655,67,119,186,27,10,33,34,62,163
65,Ignas Brazdeikis\brazdig01,SF,23,ORL,42,1,536,81,188,.431,27,87,.310,54,101,.535,.503,21,32,.656,23,49,72,37,10,3,17,48,210
66,Mikal Bridges\bridgmi01,SF,25,PHO,82,82,2854,458,858,.534,115,312,.369,343,546,.628,.601,131,157,.834,74,273,347,185,96,36,68,150,1162
67,Miles Bridges\bridgmi02,PF,23,CHO,80,80,2837,596,1214,.491,154,465,.331,442,749,.590,.554,267,333,.802,90,469,559,300,74,67,150,193,1613
68,Oshae Brissett\brissos01,SF,23,IND,67,25,1564,208,506,.411,83,237,.350,125,269,.465,.493,114,164,.695,108,250,358,72,44,29,54,116,613
69,Malcolm Brogdon\brogdma01,PG,29,IND,36,36,1206,243,543,.448,58,186,.312,185,357,.518,.501,143,167,.856,33,152,185,212,30,14,77,71,687
70,Armoni Brooks\brookar01,SG-PG,23,TOT,54,11,844,98,289,.339,74,249,.297,24,40,.600,.467,18,21,.857,20,83,103,62,28,11,27,74,288
70,Armoni Brooks\brookar01,SG,23,HOU,41,8,690,87,251,.347,64,213,.300,23,38,.605,.474,16,19,.842,12,69,81,49,21,8,23,60,254
70,Armoni Brooks\brookar01,PG,23,TOR,13,3,154,11,38,.289,10,36,.278,1,2,.500,.421,2,2,1.000,8,14,22,13,7,3,4,14,34
71,Dillon Brooks\brookdi01,SF,26,MEM,32,31,885,227,526,.432,46,149,.309,181,377,.480,.475,90,106,.849,29,73,102,88,36,8,50,105,590
72,Bruce Brown\brownbr01,SF,25,BRK,72,45,1774,256,506,.506,38,94,.404,218,412,.529,.543,97,128,.758,100,245,345,148,77,52,56,176,647
73,Charlie Brown Jr.\brownch02,SG,24,TOT,22,2,177,10,39,.256,1,12,.083,9,27,.333,.269,9,10,.900,14,18,32,6,10,4,5,18,30
73,Charlie Brown Jr.\brownch02,SG,24,DAL,3,0,15,1,5,.200,0,3,.000,1,2,.500,.200,0,0,,0,1,1,1,2,1,0,2,2
73,Charlie Brown Jr.\brownch02,SG,24,PHI,19,2,162,9,34,.265,1,9,.111,8,25,.320,.279,9,10,.900,14,17,31,5,8,3,5,16,28
74,Chaundee Brown Jr.\brownch05,SG-SF,23,TOT,5,2,104,10,32,.313,6,18,.333,4,14,.286,.406,5,6,.833,1,15,16,4,2,0,1,7,31
74,Chaundee Brown Jr.\brownch05,SF,23,LAL,2,0,21,1,7,.143,0,3,.000,1,4,.250,.143,0,0,,0,2,2,0,0,0,1,0,2
74,Chaundee Brown Jr.\brownch05,SG,23,ATL,3,2,83,9,25,.360,6,15,.400,3,10,.300,.480,5,6,.833,1,13,14,4,2,0,0,7,29
75,Greg Brown III\browngr01,SF,20,POR,48,6,640,81,190,.426,19,61,.311,62,129,.481,.476,44,65,.677,38,97,135,35,26,24,36,90,225
76,Jaylen Brown\brownja02,SF,25,BOS,66,66,2220,576,1217,.473,166,464,.358,410,753,.544,.541,241,318,.758,53,351,404,231,70,18,178,163,1559
77,Moses Brown\brownmo01,C,22,TOT,40,6,345,64,108,.593,0,0,,64,108,.593,.593,43,72,.597,39,96,135,1,7,16,20,53,171
77,Moses Brown\brownmo01,C,22,DAL,26,1,169,27,50,.540,0,0,,27,50,.540,.540,27,43,.628,16,45,61,1,3,9,14,28,81
77,Moses Brown\brownmo01,C,22,CLE,14,5,176,37,58,.638,0,0,,37,58,.638,.638,16,29,.552,23,51,74,0,4,7,6,25,90
78,Sterling Brown\brownst02,SG,26,DAL,49,3,628,59,155,.381,28,92,.304,31,63,.492,.471,14,15,.933,26,123,149,34,14,7,23,56,160
79,Troy Brown Jr.\browntr01,SF,22,CHI,66,7,1055,108,258,.419,47,133,.353,61,125,.488,.510,20,26,.769,39,164,203,66,36,5,26,62,283
80,Jalen Brunson\brunsja01,PG,25,DAL,79,61,2524,506,1008,.502,94,252,.373,412,756,.545,.549,179,213,.840,43,266,309,377,66,3,124,151,1285
81,Thomas Bryant\bryanth01,C,24,WAS,27,9,439,77,148,.520,12,42,.286,65,106,.613,.561,35,40,.875,26,82,108,23,6,21,19,43,201
82,Shaq Buchanan\buchash01,PG,25,MEM,2,0,10,1,4,.250,0,2,.000,1,2,.500,.250,0,0,,1,1,2,2,1,0,2,1,2
83,Reggie Bullock\bullore01,SF,30,DAL,68,37,1902,201,501,.401,141,392,.360,60,109,.550,.542,40,48,.833,33,208,241,83,41,14,40,111,583
84,Trey Burke\burketr01,PG,29,DAL,42,0,441,84,215,.391,26,82,.317,58,133,.436,.451,20,23,.870,4,29,33,57,12,0,26,39,214
85,Alec Burks\burksal01,SG,30,NYK,81,44,2318,285,728,.391,157,389,.404,128,339,.378,.499,217,264,.822,47,350,397,239,85,26,91,215,944
86,Jared Butler\butleja02,SG,21,UTA,42,1,360,61,151,.404,28,88,.318,33,63,.524,.497,11,16,.688,5,40,45,63,17,8,33,47,161
87,Jimmy Butler\butleji01,SF,32,MIA,57,57,1931,398,829,.480,27,116,.233,371,713,.520,.496,396,455,.870,102,234,336,312,94,27,121,88,1219
88,Devontae Cacok\cacokde01,PF,25,SAS,15,0,121,21,31,.677,0,0,,21,31,.677,.677,4,7,.571,8,34,42,6,8,7,3,16,46
89,Kentavious Caldwell-Pope\caldwke01,SG,28,WAS,77,77,2329,361,829,.435,159,408,.390,202,421,.480,.531,137,154,.890,41,220,261,145,83,26,97,139,1018
90,Facundo Campazzo\campafa01,PG,30,DEN,65,4,1184,107,296,.361,58,193,.301,49,103,.476,.459,60,78,.769,23,94,117,220,63,23,67,124,332
91,Vlatko Čančar\cancavl01,PF,24,DEN,15,1,176,23,41,.561,7,12,.583,16,29,.552,.646,9,14,.643,8,23,31,17,2,3,9,18,62
92,Devin Cannady\cannade01,PG,25,ORL,5,0,145,15,44,.341,15,37,.405,0,7,.000,.511,5,7,.714,1,5,6,10,5,3,5,9,50
93,Clint Capela\capelca01,C,27,ATL,74,73,2042,370,604,.613,0,1,.000,370,603,.614,.613,80,169,.473,279,598,877,92,55,93,44,166,820
94,Vernon Carey Jr.\careyve01,C,20,TOT,7,1,44,7,13,.538,0,0,,7,13,.538,.538,6,13,.462,8,4,12,0,2,1,3,4,20
94,Vernon Carey Jr.\careyve01,C,20,CHO,4,1,17,3,6,.500,0,0,,3,6,.500,.500,2,3,.667,3,2,5,0,1,0,1,1,8
94,Vernon Carey Jr.\careyve01,C,20,WAS,3,0,27,4,7,.571,0,0,,4,7,.571,.571,4,10,.400,5,2,7,0,1,1,2,3,12
95,Jevon Carter\carteje01,PG,26,TOT,66,3,905,98,253,.387,66,170,.388,32,83,.386,.518,15,18,.833,14,96,110,96,24,14,34,67,277
95,Jevon Carter\carteje01,PG,26,BRK,46,1,552,58,174,.333,42,127,.331,16,47,.340,.454,7,10,.700,9,58,67,46,14,10,26,45,165
95,Jevon Carter\carteje01,PG,26,MIL,20,2,353,40,79,.506,24,43,.558,16,36,.444,.658,8,8,1.000,5,38,43,50,10,4,8,22,112
96,Wendell Carter Jr.\cartewe01,C,22,ORL,62,61,1852,359,684,.525,70,214,.327,289,470,.615,.576,143,207,.691,139,509,648,171,36,43,117,169,931
97,Alex Caruso\carusal01,SG,27,CHI,41,18,1147,102,256,.398,42,126,.333,60,130,.462,.480,58,73,.795,33,115,148,165,71,15,57,106,304
98,Willie Cauley-Stein\caulewi01,C,28,TOT,20,2,183,16,35,.457,1,2,.500,15,33,.455,.471,1,2,.500,13,27,40,10,6,3,7,19,34
98,Willie Cauley-Stein\caulewi01,C,28,DAL,18,2,177,16,35,.457,1,2,.500,15,33,.455,.471,1,2,.500,13,25,38,9,6,3,7,17,34
98,Willie Cauley-Stein\caulewi01,C,28,PHI,2,0,6,0,0,,0,0,,0,0,,,0,0,,0,2,2,1,0,0,0,2,0
99,Ahmad Caver\caverah01,PG,25,IND,1,0,1,1,1,1.000,0,0,,1,1,1.000,1.000,0,0,,0,0,0,0,0,0,0,0,2
100,Justin Champagnie\champju01,SF,20,TOR,36,0,281,31,67,.463,10,28,.357,21,39,.538,.537,9,9,1.000,37,35,72,11,8,4,8,32,81
101,Zylan Cheatham\cheatzy01,SF,26,UTA,1,0,5,0,3,.000,0,2,.000,0,1,.000,.000,0,0,,0,0,0,0,0,0,0,0,0
102,Chris Chiozza\chiozch01,PG,26,GSW,34,1,372,24,81,.296,17,53,.321,7,28,.250,.401,2,3,.667,9,27,36,65,13,0,32,32,67
103,Marquese Chriss\chrisma01,PF,24,DAL,34,0,346,62,134,.463,8,25,.320,54,109,.495,.493,22,33,.667,33,70,103,17,13,12,17,64,154
104,Josh Christopher\chrisjo01,SG,20,HOU,74,2,1334,224,500,.448,56,189,.296,168,311,.540,.504,83,113,.735,52,134,186,150,65,13,114,97,587
105,Gary Clark\clarkga01,PF,27,NOP,38,1,378,33,88,.375,28,70,.400,5,18,.278,.534,7,10,.700,23,67,90,18,13,7,10,20,101
106,Brandon Clarke\clarkbr01,PF,25,MEM,64,1,1246,288,447,.644,5,22,.227,283,425,.666,.650,85,130,.654,135,207,342,86,39,68,34,122,666
107,Jordan Clarkson\clarkjo01,SG,29,UTA,79,1,2141,466,1113,.419,190,597,.318,276,516,.535,.504,144,174,.828,67,206,273,194,66,16,129,149,1266
108,Nic Claxton\claxtni01,C,22,BRK,47,19,974,178,264,.674,0,0,,178,264,.674,.674,54,93,.581,91,173,264,43,24,51,38,110,410
109,Amir Coffey\coffeam01,SG,24,LAC,69,30,1567,211,466,.453,96,254,.378,115,212,.542,.556,101,117,.863,26,171,197,124,38,15,45,87,619
110,John Collins\collijo01,PF,24,ATL,54,53,1663,339,644,.526,64,176,.364,275,468,.588,.576,134,169,.793,93,329,422,98,33,56,60,164,876
111,Zach Collins\colliza01,PF,24,SAS,28,4,502,76,155,.490,14,41,.341,62,114,.544,.535,52,65,.800,46,107,153,61,13,23,45,67,218
112,Darren Collison\collida01,PG,34,LAL,3,0,37,2,7,.286,0,3,.000,2,4,.500,.286,0,0,,0,4,4,2,1,0,1,5,4
113,Mike Conley\conlemi01,PG,34,UTA,72,72,2058,344,791,.435,169,414,.408,175,377,.464,.542,129,162,.796,47,170,217,385,96,21,123,142,986
114,Pat Connaughton\connapa01,SG,29,MIL,65,19,1691,227,496,.458,146,370,.395,81,126,.643,.605,45,54,.833,45,228,273,82,59,15,35,86,645
115,Tyler Cook\cookty01,PF,24,CHI,20,2,200,23,38,.605,0,0,,23,38,.605,.605,21,32,.656,16,37,53,3,4,4,7,28,67
116,Sharife Cooper\coopesh01,PG,20,ATL,13,0,39,3,14,.214,1,6,.167,2,8,.250,.250,0,0,,0,5,5,5,0,0,5,1,7
117,Petr Cornelie\cornepe01,PF,26,DEN,13,0,38,5,15,.333,1,8,.125,4,7,.571,.367,3,4,.750,7,7,14,3,1,1,4,7,14
118,DeMarcus Cousins\couside01,C,31,TOT,48,7,718,149,324,.460,37,122,.303,112,202,.554,.517,95,125,.760,74,196,270,71,35,21,85,139,430
118,DeMarcus Cousins\couside01,C,31,MIL,17,5,287,55,118,.466,13,48,.271,42,70,.600,.521,31,38,.816,24,74,98,18,16,8,16,46,154
118,DeMarcus Cousins\couside01,C,31,DEN,31,2,431,94,206,.456,24,74,.324,70,132,.530,.515,64,87,.736,50,122,172,53,19,13,69,93,276
119,Robert Covington\covinro01,PF-SF,31,TOT,71,42,1940,209,498,.420,128,339,.378,81,159,.509,.548,58,69,.841,59,332,391,92,103,91,75,190,604
119,Robert Covington\covinro01,PF,31,POR,48,40,1431,128,336,.381,79,230,.343,49,106,.462,.499,30,36,.833,41,233,274,68,74,63,58,132,365
119,Robert Covington\covinro01,SF,31,LAC,23,2,509,81,162,.500,49,109,.450,32,53,.604,.651,28,33,.848,18,99,117,24,29,28,17,58,239
120,Torrey Craig\craigto01,SF,31,TOT,78,16,1596,200,441,.454,77,234,.329,123,207,.594,.541,39,52,.750,86,224,310,91,46,36,67,151,516
120,Torrey Craig\craigto01,SF,31,IND,51,14,1034,128,281,.456,46,138,.333,82,143,.573,.537,27,35,.771,59,136,195,58,24,19,39,95,329
120,Torrey Craig\craigto01,SF,31,PHO,27,2,562,72,160,.450,31,96,.323,41,64,.641,.547,12,17,.706,27,88,115,33,22,17,28,56,187
121,Jae Crowder\crowdja01,PF,31,PHO,67,67,1886,217,544,.399,127,365,.348,90,179,.503,.516,71,90,.789,30,324,354,124,95,30,55,173,632
122,Jarrett Culver\culveja01,SG,22,MEM,37,0,338,51,135,.378,12,47,.255,39,88,.443,.422,16,34,.471,13,35,48,33,20,5,20,42,130
123,Jarron Cumberland\cumbeja01,SG,24,POR,3,0,12,1,2,.500,0,1,.000,1,1,1.000,.500,0,0,,1,2,3,1,0,0,0,2,2
124,Cade Cunningham\cunnica01,PG,20,DET,64,64,2088,429,1031,.416,114,363,.314,315,668,.472,.471,142,168,.845,58,296,354,356,78,43,234,200,1114
125,Seth Curry\curryse01,SG,31,TOT,64,64,2135,360,739,.487,158,374,.422,202,365,.553,.594,82,94,.872,21,179,200,230,53,14,109,148,960
125,Seth Curry\curryse01,SG,31,PHI,45,45,1566,256,528,.485,100,250,.400,156,278,.561,.580,64,73,.877,17,134,151,181,36,11,84,101,676
125,Seth Curry\curryse01,SG,31,BRK,19,19,569,104,211,.493,58,124,.468,46,87,.529,.630,18,21,.857,4,45,49,49,17,3,25,47,284
126,Stephen Curry\curryst01,PG,33,GSW,64,64,2211,535,1224,.437,285,750,.380,250,474,.527,.554,275,298,.923,34,301,335,404,85,23,206,130,1630
127,Anthony Davis\davisan02,C,28,LAL,40,40,1404,370,695,.532,13,70,.186,357,625,.571,.542,174,244,.713,106,288,394,122,49,90,82,97,927
128,Ed Davis\davised01,C,32,CLE,31,3,201,11,16,.688,0,0,,11,16,.688,.688,6,14,.429,14,50,64,7,3,9,5,33,28
129,Terence Davis\daviste02,SG,24,SAC,30,11,536,113,267,.423,49,149,.329,64,118,.542,.515,36,44,.818,11,83,94,40,25,11,33,70,311
130,Gabriel Deck\deckga01,PF,26,OKC,7,0,56,8,14,.571,2,4,.500,6,10,.600,.643,0,0,,1,5,6,5,1,0,2,2,18
131,Dewayne Dedmon\dedmode01,C,32,MIA,67,15,1065,164,290,.566,19,47,.404,145,243,.597,.598,75,100,.750,105,281,386,47,24,42,70,174,422
132,Sam Dekker\dekkesa01,PF,27,TOR,1,0,1,0,0,,0,0,,0,0,,,0,0,,0,0,0,0,0,0,0,0,0
133,Javin DeLaurier\delauja01,C,23,MIL,1,0,3,0,0,,0,0,,0,0,,,0,0,,0,1,1,0,1,0,0,1,0
134,DeMar DeRozan\derozde01,PF,32,CHI,76,76,2743,774,1535,.504,50,142,.352,724,1393,.520,.521,520,593,.877,56,336,392,374,68,24,181,178,2118
135,Mamadi Diakite\diakima01,PF,25,OKC,13,3,188,25,47,.532,0,5,.000,25,42,.595,.532,6,11,.545,17,42,59,2,5,9,7,33,56
136,Cheick Diallo\diallch01,C,25,DET,3,0,31,3,8,.375,0,0,,3,8,.375,.375,5,6,.833,4,8,12,0,1,0,1,6,11
137,Hamidou Diallo\diallha01,SG,23,DET,58,29,1269,261,526,.496,23,93,.247,238,433,.550,.518,91,140,.650,69,208,277,73,71,17,58,143,636
138,Gorgui Dieng\dienggo01,C,32,ATL,44,3,371,53,112,.473,29,68,.426,24,44,.545,.603,19,26,.731,32,89,121,34,11,13,20,52,154
139,Spencer Dinwiddie\dinwisp01,PG,28,TOT,67,51,1980,306,735,.416,112,330,.339,194,405,.479,.493,195,252,.774,45,234,279,346,44,13,104,150,919
139,Spencer Dinwiddie\dinwisp01,PG,28,WAS,44,44,1330,185,492,.376,70,226,.310,115,266,.432,.447,116,143,.811,36,171,207,256,27,7,73,107,556
139,Spencer Dinwiddie\dinwisp01,PG,28,DAL,23,7,650,121,243,.498,42,104,.404,79,139,.568,.584,79,109,.725,9,63,72,90,17,6,31,43,363
140,Donte DiVincenzo\divindo01,SG,25,TOT,42,1,1006,118,336,.351,74,218,.339,44,118,.373,.461,70,83,.843,40,130,170,118,48,8,72,69,380
140,Donte DiVincenzo\divindo01,SG,25,MIL,17,0,341,39,118,.331,21,74,.284,18,44,.409,.419,23,27,.852,18,42,60,29,11,3,28,26,122
140,Donte DiVincenzo\divindo01,SG,25,SAC,25,1,665,79,218,.362,53,144,.368,26,74,.351,.484,47,56,.839,22,88,110,89,37,5,44,43,258
141,Luka Dončić\doncilu01,PG,22,DAL,65,65,2301,641,1403,.457,201,569,.353,440,834,.528,.529,364,489,.744,56,537,593,568,75,36,292,145,1847
142,Luguentz Dort\dortlu01,SF,22,OKC,51,51,1665,293,726,.404,130,391,.332,163,335,.487,.493,161,191,.843,38,174,212,88,46,18,88,149,877
143,Ayo Dosunmu\dosunay01,SG,22,CHI,77,40,2110,278,535,.520,70,186,.376,208,349,.596,.585,53,78,.679,27,187,214,256,60,29,108,182,679
144,Damyean Dotson\dotsoda01,SG,27,NYK,2,0,21,2,4,.500,0,1,.000,2,3,.667,.500,0,0,,0,2,2,1,0,0,0,0,4
145,Devon Dotson\dotsode01,PG,22,CHI,11,0,85,11,23,.478,2,9,.222,9,14,.643,.522,5,9,.556,1,8,9,15,1,0,5,11,29
146,Sekou Doumbouya\doumbse01,PF,21,LAL,2,0,16,5,8,.625,1,2,.500,4,6,.667,.688,3,4,.750,2,4,6,0,3,2,2,1,14
147,Jeff Dowtin\dowtije01,PG,24,TOT,9,0,108,8,26,.308,1,9,.111,7,17,.412,.327,2,2,1.000,8,10,18,10,5,1,5,5,19
147,Jeff Dowtin\dowtije01,PG,24,GSW,4,0,28,3,6,.500,0,1,.000,3,5,.600,.500,0,0,,1,6,7,3,0,1,1,2,6
147,Jeff Dowtin\dowtije01,PG,24,MIL,1,0,3,0,1,.000,0,1,.000,0,0,,.000,0,0,,0,0,0,0,0,0,0,0,0
147,Jeff Dowtin\dowtije01,PG,24,ORL,4,0,77,5,19,.263,1,7,.143,4,12,.333,.289,2,2,1.000,7,4,11,7,5,0,4,3,13
148,PJ Dozier\doziepj01,SG,25,DEN,18,0,340,36,99,.364,15,48,.313,21,51,.412,.439,10,13,.769,14,49,63,29,11,6,13,33,97
149,Goran Dragić\dragigo01,PG,35,TOT,21,8,498,57,151,.377,16,63,.254,41,88,.466,.430,27,33,.818,13,52,65,86,19,4,34,45,157
149,Goran Dragić\dragigo01,PG,35,TOR,5,2,90,13,34,.382,4,14,.286,9,20,.450,.441,10,10,1.000,2,12,14,9,5,1,1,8,40
149,Goran Dragić\dragigo01,PG,35,BRK,16,6,408,44,117,.376,12,49,.245,32,68,.471,.427,17,23,.739,11,40,51,77,14,3,33,37,117
150,Andre Drummond\drumman01,C,28,TOT,73,36,1437,247,433,.570,0,3,.000,247,430,.574,.570,86,164,.524,229,451,680,131,78,68,115,192,580
150,Andre Drummond\drumman01,C,28,PHI,49,12,902,128,238,.538,0,2,.000,128,236,.542,.538,42,82,.512,136,297,433,97,56,45,79,121,298
150,Andre Drummond\drumman01,C,28,BRK,24,24,535,119,195,.610,0,1,.000,119,194,.613,.610,44,82,.537,93,154,247,34,22,23,36,71,282
151,Chris Duarte\duartch01,SG,24,IND,55,39,1541,268,621,.432,94,255,.369,174,366,.475,.507,90,112,.804,41,185,226,114,56,10,90,95,720
152,David Duke Jr.\dukeda01,PG,22,BRK,22,7,341,39,108,.361,9,37,.243,30,71,.423,.403,17,21,.810,30,37,67,17,14,7,9,36,104
153,Kris Dunn\dunnkr01,PG,27,POR,14,3,336,44,102,.431,1,11,.091,43,91,.473,.436,17,18,.944,9,40,49,79,23,3,32,38,106
154,Kevin Durant\duranke01,PF,33,BRK,55,55,2047,578,1115,.518,115,300,.383,463,815,.568,.570,372,409,.910,29,378,407,351,48,52,191,113,1643
155,Jaime Echenique\echenja01,C,24,WAS,1,0,3,0,0,,0,0,,0,0,,,0,0,,0,0,0,0,0,0,0,0,0
156,Anthony Edwards\edwaran01,SG,20,MIN,72,72,2466,549,1245,.441,215,602,.357,334,643,.519,.527,220,280,.786,62,281,343,275,105,46,190,164,1533
157,Carsen Edwards\edwarca01,SG,23,DET,4,0,79,9,30,.300,4,16,.250,5,14,.357,.367,1,1,1.000,2,4,6,14,2,0,5,4,23
158,Kessler Edwards\edwarke02,SF,21,BRK,48,23,987,110,267,.412,48,136,.353,62,131,.473,.502,16,19,.842,44,128,172,31,29,24,42,85,284
159,Rob Edwards\edwarro01,SG,25,OKC,2,0,11,1,4,.250,1,4,.250,0,0,,.375,0,0,,0,3,3,0,0,0,1,0,3
160,CJ Elleby\ellebcj01,SF,21,POR,58,28,1174,121,308,.393,37,126,.294,84,182,.462,.453,60,84,.714,66,161,227,87,35,19,56,116,339
161,Wayne Ellington\ellinwa01,SG,34,LAL,43,9,810,98,237,.414,82,211,.389,16,26,.615,.586,9,11,.818,10,67,77,30,23,5,19,42,287
162,Joel Embiid\embiijo01,C,27,PHI,68,68,2297,666,1334,.499,93,251,.371,573,1083,.529,.534,654,803,.814,146,650,796,284,77,99,214,181,2079
163,James Ennis III\ennisja01,SF,31,TOT,7,0,56,11,24,.458,3,8,.375,8,16,.500,.521,4,5,.800,5,7,12,3,2,2,2,5,29
163,James Ennis III\ennisja01,SF,31,BRK,2,0,14,2,7,.286,1,2,.500,1,5,.200,.357,0,0,,2,3,5,0,1,1,0,0,5
163,James Ennis III\ennisja01,SF,31,LAC,2,0,28,7,11,.636,2,4,.500,5,7,.714,.727,4,4,1.000,2,3,5,0,1,1,1,4,20
163,James Ennis III\ennisja01,SF,31,DEN,3,0,14,2,6,.333,0,2,.000,2,4,.500,.333,0,1,.000,1,1,2,3,0,0,1,1,4
164,Drew Eubanks\eubandr01,C,24,TOT,71,31,1245,221,371,.596,5,23,.217,216,348,.621,.602,99,130,.762,130,252,382,85,31,40,81,122,546
164,Drew Eubanks\eubandr01,C,24,SAS,49,9,595,84,159,.528,1,8,.125,83,151,.550,.531,59,79,.747,64,132,196,50,13,30,46,61,228
164,Drew Eubanks\eubandr01,C,24,POR,22,22,650,137,212,.646,4,15,.267,133,197,.675,.656,40,51,.784,66,120,186,35,18,10,35,61,318
165,Tacko Fall\fallta01,C,26,CLE,11,1,59,5,12,.417,0,0,,5,12,.417,.417,2,7,.286,7,16,23,2,0,6,3,3,12
166,Derrick Favors\favorde01,C,30,OKC,39,18,653,94,182,.516,2,16,.125,92,166,.554,.522,16,25,.640,58,126,184,25,17,12,9,62,206
167,Bruno Fernando\fernabr01,C,23,TOT,30,0,152,36,55,.655,1,2,.500,35,53,.660,.664,15,24,.625,18,37,55,7,1,11,14,24,88
167,Bruno Fernando\fernabr01,C,23,BOS,20,0,58,7,14,.500,1,1,1.000,6,13,.462,.536,4,5,.800,7,8,15,4,0,3,5,6,19
167,Bruno Fernando\fernabr01,C,23,HOU,10,0,94,29,41,.707,0,1,.000,29,40,.725,.707,11,19,.579,11,29,40,3,1,8,9,18,69
168,Dorian Finney-Smith\finnedo01,PF,28,DAL,80,80,2644,326,692,.471,172,435,.395,154,257,.599,.595,56,83,.675,122,253,375,150,88,39,80,183,880
169,Malik Fitts\fittsma01,PF,24,TOT,15,0,63,8,19,.421,5,10,.500,3,9,.333,.553,0,0,,2,15,17,5,0,0,2,4,21
169,Malik Fitts\fittsma01,PF,24,UTA,7,0,35,2,9,.222,2,4,.500,0,5,.000,.333,0,0,,0,10,10,0,0,0,2,3,6
169,Malik Fitts\fittsma01,PF,24,BOS,8,0,28,6,10,.600,3,6,.500,3,4,.750,.750,0,0,,2,5,7,5,0,0,0,1,15
170,Malachi Flynn\flynnma01,PG,23,TOR,44,5,537,72,183,.393,30,90,.333,42,93,.452,.475,15,24,.625,10,53,63,70,20,4,13,45,189
171,Bryn Forbes\forbebr01,SG,28,TOT,75,2,1286,231,539,.429,122,295,.414,109,244,.447,.542,79,87,.908,10,83,93,75,25,5,56,95,663
171,Bryn Forbes\forbebr01,SG,28,SAS,40,1,676,128,296,.432,63,151,.417,65,145,.448,.539,44,49,.898,4,59,63,41,17,3,33,42,363
171,Bryn Forbes\forbebr01,SG,28,DEN,35,1,610,103,243,.424,59,144,.410,44,99,.444,.545,35,38,.921,6,24,30,34,8,2,23,53,300
172,Aleem Ford\fordal03,SF,24,ORL,5,0,74,6,20,.300,2,15,.133,4,5,.800,.350,0,0,,2,13,15,2,1,0,4,7,14
173,Trent Forrest\forretr01,PG,23,UTA,60,6,765,76,155,.490,5,27,.185,71,128,.555,.506,38,48,.792,23,76,99,106,30,6,48,43,195
174,Evan Fournier\fournev01,SG,29,NYK,80,80,2358,402,965,.417,241,619,.389,161,346,.465,.541,80,113,.708,34,176,210,171,79,20,105,180,1125
175,De'Aaron Fox\foxde01,PG,24,SAC,59,59,2083,516,1092,.473,74,249,.297,442,843,.524,.506,261,348,.750,25,206,231,330,68,25,168,172,1367
176,Melvin Frazier\frazime01,SG,25,OKC,3,0,120,13,48,.271,1,21,.048,12,27,.444,.281,5,7,.714,5,8,13,1,1,0,3,8,32
177,Tim Frazier\fraziti01,PG,31,TOT,12,3,208,14,45,.311,6,17,.353,8,28,.286,.378,5,9,.556,5,14,19,34,3,1,15,27,39
177,Tim Frazier\fraziti01,PG,31,ORL,10,3,200,13,43,.302,6,17,.353,7,26,.269,.372,5,9,.556,5,14,19,33,3,1,13,24,37
177,Tim Frazier\fraziti01,PG,31,CLE,2,0,8,1,2,.500,0,0,,1,2,.500,.500,0,0,,0,0,0,1,0,0,2,3,2
178,Enes Freedom\kanteen01,C,29,BOS,35,1,411,51,97,.526,2,5,.400,49,92,.533,.536,24,28,.857,61,99,160,8,5,14,20,42,128
179,Markelle Fultz\fultzma01,PG,23,ORL,18,3,360,83,175,.474,4,17,.235,79,158,.500,.486,25,31,.806,4,45,49,99,20,5,40,22,195
180,Wenyen Gabriel\gabriwe01,PF,24,TOT,26,5,358,54,110,.491,8,28,.286,46,82,.561,.527,25,42,.595,39,58,97,14,5,11,16,68,141
180,Wenyen Gabriel\gabriwe01,PF,24,BRK,1,0,1,0,0,,0,0,,0,0,,,0,0,,0,1,1,0,0,0,0,0,0
180,Wenyen Gabriel\gabriwe01,PF,24,LAC,6,0,46,5,13,.385,2,5,.400,3,8,.375,.462,2,4,.500,5,9,14,2,1,2,3,11,14
180,Wenyen Gabriel\gabriwe01,PF,24,LAL,19,5,311,49,97,.505,6,23,.261,43,74,.581,.536,23,38,.605,34,48,82,12,4,9,13,57,127
181,Daniel Gafford\gaffoda01,C,23,WAS,72,53,1444,285,411,.693,0,1,.000,285,410,.695,.693,107,153,.699,155,252,407,68,30,99,65,170,677
182,Danilo Gallinari\gallida01,PF,33,ATL,66,18,1672,259,597,.434,112,294,.381,147,303,.485,.528,141,156,.904,35,273,308,101,28,12,38,93,771
183,Langston Galloway\gallola01,SG,30,TOT,7,0,107,6,26,.231,2,16,.125,4,10,.400,.269,0,0,,3,15,18,12,1,0,6,7,14
183,Langston Galloway\gallola01,SG,30,BRK,4,0,58,5,13,.385,2,8,.250,3,5,.600,.462,0,0,,1,7,8,5,0,0,5,5,12
183,Langston Galloway\gallola01,SG,30,MIL,3,0,49,1,13,.077,0,8,.000,1,5,.200,.077,0,0,,2,8,10,7,1,0,1,2,2
184,Darius Garland\garlada01,PG,22,CLE,68,68,2430,542,1173,.462,174,454,.383,368,719,.512,.536,215,241,.892,39,185,224,583,89,7,248,115,1473
185,Marcus Garrett\garrema01,SG,23,MIA,12,0,128,5,21,.238,1,4,.250,4,17,.235,.262,2,5,.400,9,14,23,7,5,3,2,16,13
186,Usman Garuba\garubus01,PF,19,HOU,24,2,239,19,44,.432,5,20,.250,14,24,.583,.489,5,7,.714,21,62,83,17,10,11,6,28,48
187,Luka Garza\garzalu01,C,23,DET,32,5,389,66,147,.449,16,49,.327,50,98,.510,.503,38,61,.623,58,42,100,20,9,6,18,55,186
188,Rudy Gay\gayru01,PF,35,UTA,55,1,1038,157,379,.414,70,203,.345,87,176,.494,.507,62,79,.785,55,187,242,56,25,19,47,95,446
189,Paul George\georgpa01,SF,31,LAC,31,31,1077,268,636,.421,91,257,.354,177,379,.467,.493,127,148,.858,12,201,213,176,67,13,126,74,754
190,Taj Gibson\gibsota01,C,36,NYK,52,4,946,86,166,.518,15,38,.395,71,128,.555,.563,42,52,.808,88,141,229,32,22,40,27,137,229
191,Josh Giddey\giddejo01,SG,19,OKC,54,54,1700,281,670,.419,56,213,.263,225,457,.492,.461,56,79,.709,98,323,421,345,51,20,171,88,674
192,Shai Gilgeous-Alexander\gilgesh01,PG,23,OKC,56,56,1942,477,1052,.453,89,297,.300,388,755,.514,.496,328,405,.810,37,241,278,331,71,46,154,142,1371
193,Anthony Gill\gillan01,PF,29,WAS,44,0,463,62,109,.569,14,26,.538,48,83,.578,.633,42,52,.808,33,52,85,27,5,11,18,58,180
194,Freddie Gillespie\gillefr01,PF,24,ORL,9,2,119,9,22,.409,0,1,.000,9,21,.429,.409,3,7,.429,13,23,36,5,3,9,5,18,21
195,Rudy Gobert\goberru01,C,29,UTA,66,66,2120,362,508,.713,0,4,.000,362,504,.718,.713,303,439,.690,241,727,968,72,45,137,119,176,1027
196,Brandon Goodwin\goodwbr01,PG,26,CLE,36,5,502,64,154,.416,19,55,.345,45,99,.455,.477,24,38,.632,14,53,67,91,25,1,36,39,171
197,Jordan Goodwin\goodwjo01,SG,23,WAS,2,0,6,0,3,.000,0,1,.000,0,2,.000,.000,0,0,,0,1,1,0,0,0,0,1,0
198,Aaron Gordon\gordoaa01,PF,26,DEN,75,75,2376,434,834,.520,87,260,.335,347,574,.605,.573,171,230,.743,125,314,439,188,44,44,133,148,1126
199,Eric Gordon\gordoer01,SG,33,HOU,57,46,1669,268,564,.475,124,301,.412,144,263,.548,.585,105,135,.778,15,98,113,154,28,18,107,63,765
200,Devonte' Graham\grahade01,PG,26,NOP,76,63,2162,296,815,.363,192,563,.341,104,252,.413,.481,118,140,.843,37,140,177,316,71,12,105,95,902
201,Jerami Grant\grantje01,PF,27,DET,47,47,1500,298,699,.426,91,254,.358,207,445,.465,.491,217,259,.838,28,163,191,111,44,49,85,107,904
202,Hassani Gravett\graveha01,PG,25,ORL,8,3,171,18,38,.474,11,26,.423,7,12,.583,.618,3,4,.750,1,20,21,20,5,1,9,13,50
203,Danny Green\greenda02,SF,34,PHI,62,28,1353,126,320,.394,103,271,.380,23,49,.469,.555,11,14,.786,32,125,157,64,60,37,45,105,366
204,Draymond Green\greendr01,PF,31,GSW,46,44,1329,135,257,.525,16,54,.296,119,203,.586,.556,60,91,.659,45,291,336,320,61,50,139,136,346
205,Jalen Green\greenja05,SG,19,HOU,67,67,2138,406,954,.426,157,458,.343,249,496,.502,.508,188,236,.797,33,193,226,176,44,18,135,103,1157
206,JaMychal Green\greenja01,PF,31,DEN,67,8,1085,159,327,.486,33,124,.266,126,203,.621,.537,81,93,.871,81,200,281,59,43,26,57,158,432
207,Javonte Green\greenja02,SF,28,CHI,65,45,1519,176,325,.542,36,101,.356,140,224,.625,.597,80,96,.833,91,185,276,60,67,32,30,132,468
208,Jeff Green\greenje02,C,35,DEN,75,63,1849,277,529,.524,53,168,.315,224,361,.620,.574,165,198,.833,41,190,231,96,28,27,71,151,772
209,Josh Green\greenjo02,SG,21,DAL,67,3,1039,130,256,.508,28,78,.359,102,178,.573,.563,31,45,.689,52,109,161,79,45,14,44,115,319
210,Blake Griffin\griffbl01,PF,32,BRK,56,24,958,133,313,.425,38,145,.262,95,168,.565,.486,55,76,.724,60,168,228,105,27,14,31,95,359
211,Quentin Grimes\grimequ01,SG,21,NYK,46,6,786,95,235,.404,72,189,.381,23,46,.500,.557,13,19,.684,24,70,94,44,31,11,28,72,275
212,Kyle Guy\guyky01,SG,24,MIA,19,0,186,26,65,.400,14,40,.350,12,25,.480,.508,8,12,.667,4,13,17,17,7,1,13,12,74
213,Rui Hachimura\hachiru01,PF,23,WAS,42,13,943,187,381,.491,55,123,.447,132,258,.512,.563,46,66,.697,25,135,160,48,23,9,33,53,475
214,Tyrese Haliburton\halibty01,SG-PG,21,TOT,77,77,2695,430,909,.473,161,389,.414,269,520,.517,.562,160,190,.842,61,250,311,628,134,49,199,121,1181
214,Tyrese Haliburton\halibty01,SG,21,SAC,51,51,1757,268,586,.457,104,252,.413,164,334,.491,.546,87,104,.837,39,160,199,379,86,34,115,71,727
214,Tyrese Haliburton\halibty01,PG,21,IND,26,26,938,162,323,.502,57,137,.416,105,186,.565,.590,73,86,.849,22,90,112,249,48,15,84,50,454
215,Tyler Hall\hallty01,SG,24,NYK,1,0,2,0,0,,0,0,,0,0,,,0,0,,0,0,0,0,0,0,0,0,0
216,R.J. Hampton\hamptrj01,SG,20,ORL,64,14,1402,175,457,.383,64,183,.350,111,274,.405,.453,75,117,.641,23,171,194,158,42,13,87,101,489
217,Tim Hardaway Jr.\hardati02,SG,29,DAL,42,20,1245,209,530,.394,102,304,.336,107,226,.473,.491,78,103,.757,13,143,156,92,38,6,34,74,598
218,James Harden\hardeja01,PG-SG,32,TOT,65,65,2419,407,992,.410,148,448,.330,259,544,.476,.485,470,536,.877,55,445,500,667,82,36,284,153,1432
218,James Harden\hardeja01,PG,32,BRK,44,44,1627,292,706,.414,102,307,.332,190,399,.476,.486,304,350,.869,42,309,351,447,56,31,212,105,990
218,James Harden\hardeja01,SG,32,PHI,21,21,792,115,286,.402,46,141,.326,69,145,.476,.483,166,186,.892,13,136,149,220,26,5,72,48,442
219,Maurice Harkless\harklma01,SF,28,SAC,47,24,863,83,181,.459,31,101,.307,52,80,.650,.544,20,28,.714,12,100,112,23,29,24,31,77,217
220,Jared Harper\harpeja01,PG,24,NOP,5,0,43,14,26,.538,5,12,.417,9,14,.643,.635,4,4,1.000,2,0,2,14,4,1,2,5,37
221,Montrezl Harrell\harremo01,C,28,TOT,71,3,1641,358,555,.645,4,17,.235,354,538,.658,.649,212,296,.716,149,282,431,145,29,43,72,137,932
221,Montrezl Harrell\harremo01,C,28,WAS,46,3,1117,247,383,.645,4,15,.267,243,368,.660,.650,149,205,.727,96,213,309,96,18,31,50,88,647
221,Montrezl Harrell\harremo01,C,28,CHO,25,0,524,111,172,.645,0,2,.000,111,170,.653,.645,63,91,.692,53,69,122,49,11,12,22,49,285
222,Gary Harris\harriga01,SG,27,ORL,61,30,1730,240,553,.434,116,302,.384,124,251,.494,.539,83,95,.874,36,86,122,108,59,9,61,112,679
223,Joe Harris\harrijo01,SF,30,BRK,14,14,423,56,124,.452,41,88,.466,15,36,.417,.617,5,6,.833,5,51,56,14,7,2,16,31,158
224,Tobias Harris\harrito02,PF,29,PHI,73,73,2543,493,1022,.482,101,275,.367,392,747,.525,.532,170,202,.842,77,419,496,252,47,43,116,164,1257
225,Shaquille Harrison\harrish01,SG,28,BRK,2,0,23,2,6,.333,0,2,.000,2,4,.500,.333,0,0,,1,3,4,3,1,1,2,3,4
226,Josh Hart\hartjo01,SG-SF,26,TOT,54,53,1791,287,569,.504,73,213,.343,214,356,.601,.569,160,211,.758,62,326,388,224,61,13,114,150,807
226,Josh Hart\hartjo01,SG,26,NOP,41,40,1374,195,386,.505,42,130,.323,153,256,.598,.560,116,154,.753,53,265,318,168,45,11,81,118,548
226,Josh Hart\hartjo01,SF,26,POR,13,13,417,92,183,.503,31,83,.373,61,100,.610,.587,44,57,.772,9,61,70,56,16,2,33,32,259
227,Isaiah Hartenstein\harteis01,C,23,LAC,68,0,1216,229,366,.626,14,30,.467,215,336,.640,.645,91,132,.689,117,215,332,160,50,77,84,167,563
228,Udonis Haslem\hasleud01,C,41,MIA,13,0,83,14,31,.452,1,4,.250,13,27,.481,.468,3,3,1.000,4,21,25,4,1,1,5,15,32
229,Sam Hauser\hausesa01,SF,24,BOS,26,0,158,23,50,.460,19,44,.432,4,6,.667,.650,0,0,,5,24,29,10,1,2,2,7,65
230,Jaxson Hayes\hayesja02,C,21,NOP,70,28,1398,245,398,.616,20,57,.351,225,341,.660,.641,144,188,.766,115,200,315,43,33,55,54,155,654
231,Killian Hayes\hayeski01,PG,20,DET,66,40,1647,176,459,.383,44,167,.263,132,292,.452,.431,57,74,.770,36,174,210,277,78,35,111,183,453
232,Gordon Hayward\haywago01,SF,31,CHO,49,48,1564,283,617,.459,86,220,.391,197,397,.496,.528,126,149,.846,38,186,224,177,47,22,81,85,778
233,Aaron Henry\henryaa01,SF,22,PHI,6,0,17,1,5,.200,0,1,.000,1,4,.250,.200,0,0,,0,1,1,0,0,2,2,2,2
234,Juancho Hernangómez\hernaju01,PF,26,TOT,40,9,445,44,106,.415,24,69,.348,20,37,.541,.528,19,34,.559,28,72,100,20,14,10,16,25,131
234,Juancho Hernangómez\hernaju01,PF,26,BOS,18,0,96,5,27,.185,3,18,.167,2,9,.222,.241,6,9,.667,9,16,25,3,4,2,6,7,19
234,Juancho Hernangómez\hernaju01,PF,26,SAS,5,0,51,2,6,.333,0,3,.000,2,3,.667,.333,3,4,.750,4,11,15,3,1,1,2,0,7
234,Juancho Hernangómez\hernaju01,PF,26,UTA,17,9,298,37,73,.507,21,48,.438,16,25,.640,.651,10,21,.476,15,45,60,14,9,7,8,18,105
235,Willy Hernangómez\hernawi01,C,27,NOP,50,8,839,170,327,.520,4,12,.333,166,315,.527,.526,109,141,.773,143,195,338,63,21,19,51,97,453
236,Tyler Herro\herroty01,SG,22,MIA,66,10,2151,501,1122,.447,175,439,.399,326,683,.477,.525,190,219,.868,32,297,329,263,44,8,174,95,1367
237,Buddy Hield\hieldbu01,SG,29,TOT,81,32,2499,446,1098,.406,262,716,.366,184,382,.482,.526,111,127,.874,66,287,353,229,73,25,153,184,1265
237,Buddy Hield\hieldbu01,SG,29,SAC,55,6,1574,265,693,.382,182,495,.368,83,198,.419,.514,80,92,.870,43,178,221,105,48,15,90,113,792
237,Buddy Hield\hieldbu01,SG,29,IND,26,26,925,181,405,.447,80,221,.362,101,184,.549,.546,31,35,.886,23,109,132,124,25,10,63,71,473
238,Haywood Highsmith\highsha01,SF,25,MIA,19,1,163,16,46,.348,9,28,.321,7,18,.389,.446,2,5,.400,10,16,26,6,2,3,3,13,43
239,George Hill\hillge01,SG,35,MIL,54,17,1253,118,275,.429,41,134,.306,77,141,.546,.504,57,62,.919,38,117,155,120,42,6,41,70,334
240,Malcolm Hill\hillma01,SF-SG,26,TOT,19,0,212,24,52,.462,13,36,.361,11,16,.688,.587,11,14,.786,11,24,35,8,7,3,3,24,72
240,Malcolm Hill\hillma01,SG,26,ATL,3,0,46,5,8,.625,3,5,.600,2,3,.667,.813,4,4,1.000,2,4,6,1,4,1,0,7,17
240,Malcolm Hill\hillma01,SF,26,CHI,16,0,166,19,44,.432,10,31,.323,9,13,.692,.545,7,10,.700,9,20,29,7,3,2,3,17,55
241,Solomon Hill\hillso01,PF,30,ATL,13,1,139,3,20,.150,2,13,.154,1,7,.143,.200,0,0,,6,17,23,12,4,2,1,16,8
242,Nate Hinton\hintona01,SG,22,IND,2,0,2,0,1,.000,0,0,,0,1,.000,.000,0,0,,0,0,0,0,0,0,1,0,0
243,Jaylen Hoard\hoardja01,SF,22,OKC,7,5,240,44,90,.489,9,25,.360,35,65,.538,.539,6,14,.429,30,54,84,17,6,5,8,14,103
244,Aaron Holiday\holidaa01,PG,25,TOT,63,15,1021,151,338,.447,39,103,.379,112,235,.477,.504,59,68,.868,24,98,122,153,42,9,67,92,400
244,Aaron Holiday\holidaa01,PG,25,WAS,41,14,663,100,214,.467,23,67,.343,77,147,.524,.521,28,35,.800,9,58,67,78,24,9,39,60,251
244,Aaron Holiday\holidaa01,PG,25,PHO,22,1,358,51,124,.411,16,36,.444,35,88,.398,.476,31,33,.939,15,40,55,75,18,0,28,32,149
245,Jrue Holiday\holidjr01,PG,31,MIL,67,64,2207,478,954,.501,132,321,.411,346,633,.547,.570,137,180,.761,69,232,301,457,108,29,183,133,1225
246,Justin Holiday\holidju01,SF-SG,32,TOT,74,65,2057,261,662,.394,177,482,.367,84,180,.467,.528,50,62,.806,29,161,190,128,57,33,70,154,749
246,Justin Holiday\holidju01,SF,32,IND,49,40,1416,190,458,.415,127,336,.378,63,122,.516,.553,34,41,.829,18,117,135,90,36,18,49,105,541
246,Justin Holiday\holidju01,SG,32,SAC,25,25,641,71,204,.348,50,146,.342,21,58,.362,.471,16,21,.762,11,44,55,38,21,15,21,49,208
247,Richaun Holmes\holmeri01,C,28,SAC,45,37,1074,198,300,.660,2,5,.400,196,295,.664,.663,70,90,.778,93,224,317,48,17,41,56,128,468
248,Rodney Hood\hoodro01,SF-SG,29,TOT,52,0,709,58,157,.369,30,91,.330,28,66,.424,.465,17,19,.895,15,62,77,38,15,6,11,31,163
248,Rodney Hood\hoodro01,SF,29,MIL,39,0,581,46,131,.351,24,80,.300,22,51,.431,.443,13,14,.929,13,54,67,30,12,4,7,27,129
248,Rodney Hood\hoodro01,SG,29,LAC,13,0,128,12,26,.462,6,11,.545,6,15,.400,.577,4,5,.800,2,8,10,8,3,2,4,4,34
249,Scotty Hopson\hopsosc01,SG,32,OKC,1,0,18,2,4,.500,0,1,.000,2,3,.667,.500,0,0,,0,1,1,1,0,0,2,1,4
250,Al Horford\horfoal01,C,35,BOS,69,69,2005,266,569,.467,89,265,.336,177,304,.582,.546,80,95,.842,108,422,530,232,49,92,65,130,701
251,Talen Horton-Tucker\hortota01,SG,21,LAL,60,19,1511,224,538,.416,49,182,.269,175,356,.492,.462,100,125,.800,37,156,193,159,59,29,82,148,597
252,Danuel House Jr.\houseda01,SF,28,TOT,42,7,727,80,198,.404,44,117,.376,36,81,.444,.515,44,58,.759,18,93,111,44,21,17,33,51,248
252,Danuel House Jr.\houseda01,SF,28,HOU,16,1,233,25,74,.338,10,34,.294,15,40,.375,.405,17,19,.895,4,39,43,19,5,5,18,16,77
252,Danuel House Jr.\houseda01,SF,28,NYK,1,0,3,0,1,.000,0,1,.000,0,0,,.000,0,0,,0,0,0,0,0,0,0,0,0
252,Danuel House Jr.\houseda01,SF,28,UTA,25,6,491,55,123,.447,34,82,.415,21,41,.512,.585,27,39,.692,14,54,68,25,16,12,15,35,171
253,Dwight Howard\howardw01,C,36,LAL,60,27,971,134,219,.612,8,15,.533,126,204,.618,.630,96,146,.658,118,238,356,35,34,36,47,115,372
254,Markus Howard\howarma02,SG,22,DEN,31,0,176,39,101,.386,28,70,.400,11,31,.355,.525,20,23,.870,2,10,12,7,9,0,7,17,126
255,Kevin Huerter\huertke01,SG,23,ATL,74,60,2188,345,760,.454,160,411,.389,185,349,.530,.559,42,52,.808,32,222,254,203,55,26,91,185,892
256,Jay Huff\huffja01,C,23,LAL,4,0,20,0,3,.000,0,2,.000,0,1,.000,.000,0,0,,1,3,4,1,1,1,1,1,0
257,Elijah Hughes\hugheel01,SG-SF,23,TOT,36,4,434,47,144,.326,25,95,.263,22,49,.449,.413,7,9,.778,6,52,58,22,14,8,17,39,126
257,Elijah Hughes\hugheel01,SF,23,UTA,14,1,112,15,36,.417,10,28,.357,5,8,.625,.556,3,3,1.000,2,15,17,6,4,1,7,7,43
257,Elijah Hughes\hugheel01,SG,23,POR,22,3,322,32,108,.296,15,67,.224,17,41,.415,.366,4,6,.667,4,37,41,16,10,7,10,32,83
258,Feron Hunt\huntfe01,SF,22,NYK,2,0,8,0,2,.000,0,0,,0,2,.000,.000,0,0,,1,0,1,1,1,0,1,1,0
259,De'Andre Hunter\huntede01,SF,24,ATL,53,52,1577,254,575,.442,74,195,.379,180,380,.474,.506,127,166,.765,26,150,176,68,36,21,69,155,709
260,Chandler Hutchison\hutchch01,SF,25,PHO,6,0,22,1,2,.500,0,0,,1,2,.500,.500,2,2,1.000,0,5,5,2,0,0,4,1,4
261,Bones Hyland\hylanbo01,PG,21,DEN,69,4,1310,230,571,.403,131,358,.366,99,213,.465,.518,107,125,.856,14,174,188,191,41,20,86,153,698
262,Serge Ibaka\ibakase01,C-PF,32,TOT,54,12,877,148,296,.500,37,99,.374,111,197,.563,.563,32,44,.727,62,188,250,49,11,33,43,102,365
262,Serge Ibaka\ibakase01,C,32,LAC,35,10,538,94,192,.490,24,62,.387,70,130,.538,.552,20,29,.690,40,110,150,36,7,26,33,56,232
262,Serge Ibaka\ibakase01,PF,32,MIL,19,2,339,54,104,.519,13,37,.351,41,67,.612,.582,12,15,.800,22,78,100,13,4,7,10,46,133
263,Andre Iguodala\iguodan01,SF,38,GSW,31,0,603,46,121,.380,17,74,.230,29,47,.617,.450,15,20,.750,21,79,100,114,27,22,28,34,124
264,Joe Ingles\inglejo01,SF,34,UTA,45,15,1122,115,285,.404,78,225,.347,37,60,.617,.540,17,22,.773,12,119,131,158,23,5,46,82,325
265,Brandon Ingram\ingrabr01,SF,24,NOP,55,55,1869,453,983,.461,74,226,.327,379,757,.501,.498,266,322,.826,35,285,320,307,34,26,151,119,1246
266,Kyrie Irving\irvinky01,PG,29,BRK,29,29,1091,289,616,.469,100,239,.418,189,377,.501,.550,118,129,.915,16,111,127,167,41,17,73,81,796
267,Wes Iwundu\iwundwe01,SF,27,ATL,3,1,82,8,18,.444,3,5,.600,5,13,.385,.528,3,4,.750,3,10,13,0,1,0,1,8,22
268,Frank Jackson\jacksfr01,PG,23,DET,53,7,1164,194,483,.402,86,279,.308,108,204,.529,.491,86,104,.827,19,68,87,55,27,9,38,89,560
269,Isaiah Jackson\jacksis01,PF,20,IND,36,15,541,116,206,.563,5,16,.313,111,190,.584,.575,60,88,.682,60,89,149,10,25,52,40,92,297
270,Jaren Jackson Jr.\jacksja02,PF,22,MEM,78,78,2126,430,1036,.415,128,401,.319,302,635,.476,.477,284,345,.823,119,335,454,86,73,177,130,272,1272
271,Josh Jackson\jacksjo02,SF,24,TOT,51,3,830,120,300,.400,33,130,.254,87,170,.512,.455,55,77,.714,21,120,141,54,26,22,47,88,328
271,Josh Jackson\jacksjo02,SF,24,DET,39,3,707,103,251,.410,30,113,.265,73,138,.529,.470,40,56,.714,17,106,123,49,21,18,38,71,276
271,Josh Jackson\jacksjo02,SF,24,SAC,12,0,123,17,49,.347,3,17,.176,14,32,.438,.378,15,21,.714,4,14,18,5,5,4,9,17,52
272,Justin Jackson\jacksju01,SF,26,TOT,7,0,37,5,15,.333,3,9,.333,2,6,.333,.433,2,2,1.000,1,6,7,2,0,0,1,3,15
272,Justin Jackson\jacksju01,SF,26,BOS,1,0,2,0,1,.000,0,0,,0,1,.000,.000,2,2,1.000,0,0,0,0,0,0,0,0,2
272,Justin Jackson\jacksju01,SF,26,PHO,6,0,35,5,14,.357,3,9,.333,2,5,.400,.464,0,0,,1,6,7,2,0,0,1,3,13
273,Reggie Jackson\jacksre01,SG,31,LAC,75,75,2337,479,1222,.392,167,512,.326,312,710,.439,.460,138,163,.847,39,232,271,359,55,15,173,159,1263
274,LeBron James\jamesle01,SF,37,LAL,56,56,2084,640,1221,.524,161,448,.359,479,773,.620,.590,254,336,.756,63,396,459,349,73,59,196,121,1695
275,DeJon Jarreau\jarrede01,SG,24,IND,1,0,1,0,0,,0,0,,0,0,,,0,0,,0,0,0,0,0,0,0,0,0
276,DaQuan Jeffries\jeffrda01,SG,24,MEM,3,0,9,1,2,.500,0,1,.000,1,1,1.000,.500,0,0,,0,2,2,1,0,0,0,1,2
277,Ty Jerome\jeromty01,SG,24,OKC,48,4,801,124,328,.378,54,186,.290,70,142,.493,.460,38,47,.809,19,59,78,109,30,5,37,73,340
278,Isaiah Joe\joeis01,SG,22,PHI,55,1,609,62,177,.350,45,135,.333,17,42,.405,.477,29,31,.935,6,50,56,35,14,3,19,47,198
279,Alize Johnson\johnsal02,PF,25,TOT,23,0,167,17,39,.436,0,4,.000,17,35,.486,.436,7,12,.583,28,33,61,9,5,0,12,18,41
279,Alize Johnson\johnsal02,PF,25,CHI,16,0,121,12,23,.522,0,2,.000,12,21,.571,.522,4,7,.571,16,20,36,8,3,0,8,15,28
279,Alize Johnson\johnsal02,PF,25,WAS,3,0,18,2,6,.333,0,2,.000,2,4,.500,.333,0,1,.000,5,7,12,0,0,0,3,0,4
279,Alize Johnson\johnsal02,PF,25,NOP,4,0,28,3,10,.300,0,0,,3,10,.300,.300,3,4,.750,7,6,13,1,2,0,1,3,9
280,B.J. Johnson\johnsbj01,SF,26,ORL,4,0,65,11,25,.440,4,10,.400,7,15,.467,.520,0,0,,6,9,15,0,0,1,0,4,26
281,Cameron Johnson\johnsca02,PF,25,PHO,66,16,1730,279,607,.460,166,391,.425,113,216,.523,.596,98,114,.860,42,231,273,99,57,16,47,113,822
282,David Johnson\johnsda08,SG,20,TOR,2,0,2,0,1,.000,0,1,.000,0,0,,.000,0,0,,0,0,0,0,0,0,0,0,0
283,Jalen Johnson\johnsja05,PF,20,ATL,22,0,120,22,41,.537,3,13,.231,19,28,.679,.573,5,7,.714,2,24,26,3,3,2,9,9,52
284,James Johnson\johnsja01,PF,34,BRK,62,10,1191,144,307,.469,23,85,.271,121,222,.545,.507,29,55,.527,51,164,215,130,30,34,48,162,340
285,Joe Johnson\johnsjo02,SG,40,BOS,1,0,2,1,1,1.000,0,0,,1,1,1.000,1.000,0,0,,0,0,0,0,0,0,0,0,2
286,Keldon Johnson\johnske04,SF,22,SAS,75,74,2392,471,1011,.466,159,399,.398,312,612,.510,.545,177,234,.756,80,377,457,158,58,14,92,148,1278
287,Keon Johnson\johnske07,SG,19,TOT,37,12,697,96,272,.353,34,100,.340,62,172,.360,.415,41,51,.804,24,57,81,76,28,12,46,69,267
287,Keon Johnson\johnske07,SG,19,LAC,15,0,135,17,51,.333,3,11,.273,14,40,.350,.363,16,21,.762,6,15,21,13,7,2,7,21,53
287,Keon Johnson\johnske07,SG,19,POR,22,12,562,79,221,.357,31,89,.348,48,132,.364,.428,25,30,.833,18,42,60,63,21,10,39,48,214
288,Stanley Johnson\johnsst04,PF,25,LAL,48,27,1094,117,251,.466,33,105,.314,84,146,.575,.532,53,74,.716,34,121,155,80,43,14,35,109,320
289,Tyler Johnson\johnsty01,PG,29,TOT,6,0,91,6,20,.300,5,13,.385,1,7,.143,.425,0,0,,3,9,12,7,3,3,2,7,17
289,Tyler Johnson\johnsty01,PG,29,PHI,3,0,38,4,10,.400,3,7,.429,1,3,.333,.550,0,0,,1,5,6,2,1,1,1,4,11
289,Tyler Johnson\johnsty01,PG,29,SAS,3,0,53,2,10,.200,2,6,.333,0,4,.000,.300,0,0,,2,4,6,5,2,2,1,3,6
290,Nikola Jokić\jokicni01,C,26,DEN,74,74,2476,764,1311,.583,97,288,.337,667,1023,.652,.620,379,468,.810,206,813,1019,584,109,63,281,191,2004
291,Carlik Jones\jonesca03,PG,24,TOT,5,0,23,1,9,.111,0,1,.000,1,8,.125,.111,2,2,1.000,1,2,3,5,1,0,3,0,4
291,Carlik Jones\jonesca03,PG,24,DAL,3,0,19,0,7,.000,0,1,.000,0,6,.000,.000,2,2,1.000,1,2,3,5,1,0,3,0,2
291,Carlik Jones\jonesca03,PG,24,DEN,2,0,4,1,2,.500,0,0,,1,2,.500,.500,0,0,,0,0,0,0,0,0,0,0,2
292,Damian Jones\jonesda03,C,26,SAC,56,15,1017,175,266,.658,10,29,.345,165,237,.696,.677,94,131,.718,75,171,246,69,26,47,59,130,454
293,Derrick Jones Jr.\jonesde02,PF,24,CHI,51,8,899,105,195,.538,20,61,.328,85,134,.634,.590,56,70,.800,60,109,169,30,25,33,30,105,286
294,Herbert Jones\joneshe01,PF,23,NOP,78,69,2335,274,576,.476,57,169,.337,217,407,.533,.525,137,163,.840,98,198,296,167,130,60,100,238,742
295,Jemerrio Jones\jonesje01,SF,26,LAL,2,0,15,2,3,.667,0,0,,2,3,.667,.667,0,0,,2,1,3,0,1,0,0,2,4
296,Kai Jones\joneska01,C,21,CHO,21,0,63,9,14,.643,1,2,.500,8,12,.667,.679,3,8,.375,3,8,11,4,1,2,6,8,22
297,Mason Jones\jonesma05,SG,23,LAL,4,0,51,7,15,.467,1,4,.250,6,11,.545,.500,12,15,.800,1,9,10,4,2,0,1,8,27
298,Tre Jones\jonestr01,PG,22,SAS,69,11,1148,166,339,.490,10,51,.196,156,288,.542,.504,71,91,.780,29,126,155,233,42,7,46,78,413
299,Tyus Jones\jonesty01,PG,25,MEM,73,23,1549,249,552,.451,80,205,.390,169,347,.487,.524,54,66,.818,17,159,176,324,66,2,46,32,632
300,DeAndre Jordan\jordade01,C,33,TOT,48,20,622,92,143,.643,0,0,,92,143,.643,.643,22,40,.550,83,181,264,21,12,35,37,71,206
300,DeAndre Jordan\jordade01,C,33,LAL,32,19,408,60,89,.674,0,0,,60,89,.674,.674,12,26,.462,51,121,172,13,10,26,21,50,132
300,DeAndre Jordan\jordade01,C,33,PHI,16,1,214,32,54,.593,0,0,,32,54,.593,.593,10,14,.714,32,60,92,8,2,9,16,21,74
301,Cory Joseph\josepco01,PG,30,DET,65,39,1600,178,400,.445,65,157,.414,113,243,.465,.526,100,113,.885,29,145,174,237,42,17,85,147,521
302,Georgios Kalaitzakis\kalaige01,SF,23,TOT,13,4,214,31,67,.463,10,26,.385,21,41,.512,.537,14,30,.467,6,15,21,12,11,2,20,19,86
302,Georgios Kalaitzakis\kalaige01,SF,23,MIL,9,0,48,5,11,.455,2,4,.500,3,7,.429,.545,4,9,.444,4,4,8,0,1,1,4,8,16
302,Georgios Kalaitzakis\kalaige01,SF,23,OKC,4,4,166,26,56,.464,8,22,.364,18,34,.529,.536,10,21,.476,2,11,13,12,10,1,16,11,70
303,Frank Kaminsky\kaminfr01,C,28,PHO,9,0,181,36,66,.545,5,15,.333,31,51,.608,.583,18,20,.900,11,30,41,13,8,7,5,14,95
304,Luke Kennard\kennalu01,SG,25,LAC,70,13,1919,287,639,.449,190,423,.449,97,216,.449,.598,69,77,.896,20,209,229,146,42,6,60,101,833
305,Braxton Key\keybr01,SF,24,TOT,11,0,197,33,72,.458,6,21,.286,27,51,.529,.500,7,13,.538,13,37,50,11,10,11,11,26,79
305,Braxton Key\keybr01,SF,24,PHI,2,0,6,1,2,.500,0,1,.000,1,1,1.000,.500,0,0,,1,1,2,1,1,0,2,1,2
305,Braxton Key\keybr01,SF,24,DET,9,0,191,32,70,.457,6,20,.300,26,50,.520,.500,7,13,.538,12,36,48,10,9,11,9,25,77
306,George King\kingge03,SF,28,DAL,4,0,19,0,5,.000,0,4,.000,0,1,.000,.000,1,2,.500,0,5,5,0,0,0,1,4,1
307,Louis King\kinglo02,SF,22,SAC,10,0,104,15,47,.319,8,27,.296,7,20,.350,.404,7,10,.700,0,12,12,9,2,1,0,14,45
308,Corey Kispert\kispeco01,SF,22,WAS,77,36,1801,234,514,.455,112,320,.350,122,194,.629,.564,54,62,.871,53,156,209,85,35,22,50,93,634
309,Maxi Kleber\klebima01,PF,30,DAL,59,21,1450,141,354,.398,83,255,.325,58,99,.586,.516,46,65,.708,70,280,350,68,30,58,47,137,411
310,Brandon Knight\knighbr03,PG,30,DAL,5,0,65,10,25,.400,4,17,.235,6,8,.750,.480,8,8,1.000,0,8,8,8,1,0,4,5,32
311,Nathan Knight\knighna01,PF,24,MIN,37,2,267,45,88,.511,4,13,.308,41,75,.547,.534,44,60,.733,32,53,85,22,7,8,18,42,138
312,Kevin Knox\knoxke01,SF,22,TOT,30,0,222,31,85,.365,15,54,.278,16,31,.516,.453,16,22,.727,14,30,44,10,4,2,7,19,93
312,Kevin Knox\knoxke01,SF,22,NYK,13,0,111,15,40,.375,10,28,.357,5,12,.417,.500,7,10,.700,8,14,22,3,2,1,5,5,47
312,Kevin Knox\knoxke01,SF,22,ATL,17,0,111,16,45,.356,5,26,.192,11,19,.579,.411,9,12,.750,6,16,22,7,2,1,2,14,46
313,John Konchar\konchjo01,SG,25,MEM,72,7,1292,135,262,.515,52,126,.413,83,136,.610,.615,27,49,.551,87,242,329,109,45,22,29,90,349
314,Furkan Korkmaz\korkmfu01,SG,24,PHI,67,19,1414,182,470,.387,77,266,.289,105,204,.515,.469,68,84,.810,22,153,175,127,33,9,48,58,509
315,Luke Kornet\kornelu01,C,26,TOT,15,0,103,13,27,.481,0,5,.000,13,22,.591,.481,4,6,.667,13,16,29,9,3,3,0,9,30
315,Luke Kornet\kornelu01,C,26,CLE,2,0,15,1,5,.200,0,1,.000,1,4,.250,.200,2,3,.667,2,1,3,1,0,1,0,1,4
315,Luke Kornet\kornelu01,C,26,MIL,1,0,3,0,1,.000,0,0,,0,1,.000,.000,0,0,,1,0,1,0,0,0,0,1,0
315,Luke Kornet\kornelu01,C,26,BOS,12,0,85,12,21,.571,0,4,.000,12,17,.706,.571,2,3,.667,10,15,25,8,3,2,0,7,26
316,Vit Krejci\krejcvi01,SG,21,OKC,30,8,690,68,167,.407,32,98,.327,36,69,.522,.503,19,22,.864,18,83,101,57,19,8,29,65,187
317,Arnoldas Kulboka\kulboar01,SF,24,CHO,2,0,5,0,1,.000,0,1,.000,0,0,,.000,0,0,,0,0,0,0,0,0,0,1,0
318,Jonathan Kuminga\kuminjo01,SF,19,GSW,70,12,1185,236,460,.513,50,149,.336,186,311,.598,.567,130,190,.684,54,180,234,64,31,22,74,146,652
319,Kyle Kuzma\kuzmaky01,PF,26,WAS,66,66,2204,423,936,.452,128,375,.341,295,561,.526,.520,156,219,.712,70,491,561,233,42,57,169,128,1130
320,Anthony Lamb\lamban01,SF,24,SAS,2,0,8,0,2,.000,0,2,.000,0,0,,.000,0,0,,0,1,1,2,0,0,0,0,0
321,Jeremy Lamb\lambje01,SF-SG,29,TOT,56,0,935,133,347,.383,55,170,.324,78,177,.441,.463,89,106,.840,26,128,154,81,31,22,37,59,410
321,Jeremy Lamb\lambje01,SF,29,IND,39,0,613,85,228,.373,39,117,.333,46,111,.414,.458,67,80,.838,15,79,94,51,23,14,24,44,276
321,Jeremy Lamb\lambje01,SG,29,SAC,17,0,322,48,119,.403,16,53,.302,32,66,.485,.471,22,26,.846,11,49,60,30,8,8,13,15,134
322,Jock Landale\landajo01,C,26,SAS,54,1,589,101,204,.495,29,89,.326,72,115,.626,.566,34,41,.829,63,75,138,45,10,14,31,53,265
323,Romeo Langford\langfro01,SG,22,TOT,48,5,771,83,191,.435,29,85,.341,54,106,.509,.510,23,42,.548,30,78,108,21,22,16,16,47,218
323,Romeo Langford\langfro01,SG,22,BOS,44,5,728,79,184,.429,29,83,.349,50,101,.495,.508,20,34,.588,30,74,104,19,21,16,16,46,207
323,Romeo Langford\langfro01,SG,22,SAS,4,0,43,4,7,.571,0,2,.000,4,5,.800,.571,3,8,.375,0,4,4,2,1,0,0,1,11
324,Zach LaVine\lavinza01,SF,26,CHI,67,67,2328,565,1186,.476,185,475,.389,380,711,.534,.554,320,375,.853,22,286,308,303,41,23,171,120,1635
325,Jake Layman\laymaja01,SF,27,MIN,34,1,231,30,73,.411,8,35,.229,22,38,.579,.466,13,18,.722,6,30,36,9,7,5,10,12,81
326,Damion Lee\leeda03,SG,29,GSW,63,5,1256,169,383,.441,63,187,.337,106,196,.541,.523,66,75,.880,27,176,203,63,39,6,38,95,467
327,Saben Lee\leesa01,PG,22,DET,37,0,604,69,177,.390,14,60,.233,55,117,.470,.429,56,71,.789,18,69,87,107,36,12,36,44,208
328,Alex Len\lenal01,C,28,SAC,39,10,620,94,176,.534,6,21,.286,88,155,.568,.551,41,63,.651,52,109,161,45,13,25,43,100,235
329,Caris LeVert\leverca01,SG,27,TOT,58,49,1781,379,854,.444,82,256,.320,297,598,.497,.492,146,193,.756,43,171,214,248,51,23,108,131,986
329,Caris LeVert\leverca01,SG,27,IND,39,39,1214,278,622,.447,61,189,.323,217,433,.501,.496,111,146,.760,30,120,150,173,35,18,75,91,728
329,Caris LeVert\leverca01,SG,27,CLE,19,10,567,101,232,.435,21,67,.313,80,165,.485,.481,35,47,.745,13,51,64,75,16,5,33,40,258
330,Kira Lewis Jr.\lewiski01,PG,20,NOP,24,0,341,59,146,.404,13,58,.224,46,88,.523,.449,10,12,.833,9,30,39,49,11,1,26,17,141
331,Scottie Lewis\lewissc01,SG,21,CHO,2,0,7,0,0,,0,0,,0,0,,,1,2,.500,0,0,0,1,1,0,0,0,1
332,Damian Lillard\lillada01,PG,31,POR,29,29,1056,222,552,.402,92,284,.324,130,268,.485,.486,159,181,.878,13,107,120,212,17,11,83,37,695
333,Nassir Little\littlna01,SF,21,POR,42,23,1088,145,315,.460,51,154,.331,94,161,.584,.541,69,94,.734,58,178,236,54,25,36,40,82,410
334,Isaiah Livers\liveris01,SF,23,DET,19,5,383,41,90,.456,27,64,.422,14,26,.538,.606,12,14,.857,15,42,57,21,13,7,15,37,121
335,Kevon Looney\looneke01,C,25,GSW,82,80,1732,208,364,.571,0,1,.000,208,363,.573,.571,75,125,.600,208,388,596,165,50,52,67,215,491
336,Brook Lopez\lopezbr01,C,33,MIL,13,11,298,61,131,.466,19,53,.358,42,78,.538,.538,20,23,.870,19,34,53,6,8,15,12,34,161
337,Robin Lopez\lopezro01,C,33,ORL,36,9,612,110,199,.553,2,6,.333,108,193,.560,.558,32,54,.593,68,58,126,54,2,18,44,67,254
338,Didi Louzada\louzama01,SG-SF,22,TOT,9,1,129,12,33,.364,9,23,.391,3,10,.300,.500,2,2,1.000,5,12,17,5,2,2,5,13,35
338,Didi Louzada\louzama01,SF,22,NOP,2,0,7,0,3,.000,0,3,.000,0,0,,.000,0,0,,2,0,2,1,0,0,0,0,0
338,Didi Louzada\louzama01,SG,22,POR,7,1,122,12,30,.400,9,20,.450,3,10,.300,.550,2,2,1.000,3,12,15,4,2,2,5,13,35
339,Kevin Love\loveke01,PF,33,CLE,74,4,1665,327,761,.430,187,477,.392,140,284,.493,.553,166,198,.838,87,449,536,160,26,18,98,101,1007
340,Kyle Lowry\lowryky01,PG,35,MIA,63,63,2133,276,627,.440,144,382,.377,132,245,.539,.555,148,174,.851,33,249,282,474,67,17,168,177,844
341,Gabriel Lundberg\lundbga01,SG,27,PHO,4,0,44,5,19,.263,3,8,.375,2,11,.182,.342,0,0,,2,5,7,11,3,0,3,7,13
342,Timothé Luwawu-Cabarrot\luwawti01,SF,26,ATL,52,18,685,74,186,.398,44,122,.361,30,64,.469,.516,35,41,.854,17,65,82,40,18,6,20,76,227
343,Trey Lyles\lylestr01,PF,26,TOT,75,23,1537,262,562,.466,67,209,.321,195,353,.552,.526,195,243,.802,89,290,379,88,29,32,73,123,786
343,Trey Lyles\lylestr01,PF,26,DET,51,3,990,175,384,.456,44,146,.301,131,238,.550,.513,138,176,.784,60,184,244,58,22,26,54,91,532
343,Trey Lyles\lylestr01,PF,26,SAC,24,20,547,87,178,.489,23,63,.365,64,115,.557,.553,57,67,.851,29,106,135,30,7,6,19,32,254
344,Théo Maledon\maledth01,PG,20,OKC,51,7,908,119,317,.375,44,150,.293,75,167,.449,.445,79,100,.790,20,111,131,111,31,11,65,67,361
345,Sandro Mamukelashvili\mamuksa01,PF,22,MIL,41,3,407,57,115,.496,22,52,.423,35,63,.556,.591,18,22,.818,35,47,82,22,9,9,15,28,154
346,Terance Mann\mannte01,SF,25,LAC,81,33,2317,334,690,.484,76,208,.365,258,482,.535,.539,128,164,.780,104,321,425,209,55,21,84,178,872
347,Tre Mann\manntr01,PG,20,OKC,60,26,1367,231,588,.393,98,272,.360,133,316,.421,.476,65,82,.793,25,146,171,91,47,12,71,102,625
348,Boban Marjanović\marjabo01,C,33,DAL,23,0,128,42,70,.600,1,4,.250,41,66,.621,.607,13,22,.591,8,31,39,3,0,3,15,24,98
349,Lauri Markkanen\markkla01,PF,24,CLE,61,61,1878,313,703,.445,136,380,.358,177,323,.548,.542,138,159,.868,59,286,345,81,45,30,54,130,900
350,Naji Marshall\marshna01,SF,24,NOP,55,4,735,109,269,.405,21,105,.200,88,164,.537,.444,74,93,.796,38,104,142,62,33,8,46,69,313
351,Caleb Martin\martica02,SF,26,MIA,60,12,1372,208,410,.507,64,155,.413,144,255,.565,.585,71,93,.763,70,160,230,64,58,30,52,104,551
352,Cody Martin\martico01,SF,26,CHO,71,11,1866,204,423,.482,61,159,.384,143,264,.542,.554,75,107,.701,82,203,285,179,88,32,61,116,544
353,Kelan Martin\martike03,SF,26,TOT,30,1,450,70,171,.409,22,75,.293,48,96,.500,.474,9,13,.692,17,38,55,21,13,9,14,36,171
353,Kelan Martin\martike03,SF,26,IND,27,1,444,70,168,.417,22,74,.297,48,94,.511,.482,9,13,.692,16,37,53,21,13,9,14,36,171
353,Kelan Martin\martike03,SF,26,BOS,3,0,6,0,3,.000,0,1,.000,0,2,.000,.000,0,0,,1,1,2,0,0,0,0,0,0
354,Kenyon Martin Jr.\martike04,SF,21,HOU,79,2,1656,279,523,.533,60,168,.357,219,355,.617,.591,78,123,.634,80,217,297,101,34,40,60,113,696
355,Garrison Mathews\mathega01,SG,25,HOU,65,33,1712,184,461,.399,139,386,.360,45,75,.600,.550,143,180,.794,32,158,190,64,57,24,41,168,650
356,Dakota Mathias\mathida01,SG,26,MEM,6,0,16,2,6,.333,2,6,.333,0,0,,.500,0,0,,0,2,2,1,1,0,0,1,6
357,Wesley Matthews\matthwe02,SG,35,MIL,49,14,1002,87,220,.395,53,157,.338,34,63,.540,.516,22,28,.786,30,62,92,36,23,8,18,87,249
358,Tyrese Maxey\maxeyty01,PG,21,PHI,75,74,2650,483,995,.485,132,309,.427,351,686,.512,.552,213,246,.866,26,214,240,321,55,32,88,156,1311
359,Skylar Mays\mayssk01,SG,24,ATL,28,5,220,32,64,.500,8,25,.320,24,39,.615,.563,8,9,.889,5,20,25,17,7,0,10,9,80
360,Miles McBride\mcbrimi01,PG,21,NYK,40,2,372,32,108,.296,17,68,.250,15,40,.375,.375,8,12,.667,4,38,42,41,14,1,5,45,89
361,Mac McClung\mccluma01,SG-PG,23,TOT,2,0,25,3,6,.500,1,3,.333,2,3,.667,.583,1,1,1.000,0,3,3,1,1,1,3,5,8
361,Mac McClung\mccluma01,PG,23,CHI,1,0,3,1,1,1.000,0,0,,1,1,1.000,1.000,0,0,,0,0,0,0,0,0,1,0,2
361,Mac McClung\mccluma01,SG,23,LAL,1,0,22,2,5,.400,1,3,.333,1,2,.500,.500,1,1,1.000,0,3,3,1,1,1,2,5,6
362,CJ McCollum\mccolcj01,SG,30,TOT,62,62,2145,536,1164,.460,182,469,.388,354,695,.509,.539,116,170,.682,53,216,269,315,70,22,127,121,1370
362,CJ McCollum\mccolcj01,SG,30,POR,36,36,1267,290,665,.436,111,289,.384,179,376,.476,.520,48,68,.706,34,119,153,163,36,21,70,77,739
362,CJ McCollum\mccolcj01,SG,30,NOP,26,26,878,246,499,.493,71,180,.394,175,319,.549,.564,68,102,.667,19,97,116,152,34,1,57,44,631
363,T.J. McConnell\mccontj01,PG,29,IND,27,8,652,100,208,.481,10,33,.303,90,175,.514,.505,19,23,.826,20,70,90,131,29,10,29,53,229
364,Jaden McDaniels\mcdanja02,PF,21,MIN,70,31,1803,255,554,.460,80,252,.317,175,302,.579,.532,57,71,.803,76,217,293,79,52,54,75,224,647
365,Jalen McDaniels\mcdanja01,SF,24,CHO,55,2,895,123,254,.484,41,108,.380,82,146,.562,.565,53,72,.736,37,133,170,58,26,22,36,93,340
366,Doug McDermott\mcderdo01,PF,30,SAS,51,51,1223,215,465,.462,108,256,.422,107,209,.512,.578,40,51,.784,18,97,115,64,13,6,43,79,578
367,JaVale McGee\mcgeeja01,C,34,PHO,74,17,1172,288,458,.629,2,9,.222,286,449,.637,.631,102,146,.699,163,333,496,42,22,81,98,181,680
368,Cameron McGriff\mcgrica01,SF,24,POR,3,0,46,5,14,.357,2,6,.333,3,8,.375,.429,2,2,1.000,6,9,15,3,0,1,0,7,14
369,Rodney McGruder\mcgruro01,SG,30,DET,51,2,754,98,225,.436,58,146,.397,40,79,.506,.564,19,26,.731,31,80,111,48,21,7,24,58,273
370,Alfonzo McKinnie\mckinal01,SF,29,CHI,17,3,206,24,61,.393,9,27,.333,15,34,.441,.467,2,8,.250,13,20,33,5,2,3,7,26,59
371,JaQuori McLaughlin\mclauja01,PG,24,DAL,4,0,11,0,2,.000,0,1,.000,0,1,.000,.000,0,0,,0,0,0,2,0,0,0,1,0
372,Jordan McLaughlin\mclaujo01,PG,25,MIN,62,3,902,88,200,.440,27,85,.318,61,115,.530,.508,30,40,.750,22,72,94,180,57,10,38,54,233
373,Ben McLemore\mclembe01,SG,28,POR,64,6,1285,216,539,.401,151,417,.362,65,122,.533,.541,72,88,.818,12,91,103,59,38,10,55,103,655
374,De'Anthony Melton\meltode01,SG,23,MEM,73,15,1657,281,695,.404,139,372,.374,142,323,.440,.504,90,120,.750,64,264,328,194,104,39,112,128,791
375,Sam Merrill\merrisa01,SG,25,MEM,6,0,58,8,24,.333,7,23,.304,1,1,1.000,.479,2,4,.500,1,6,7,4,0,0,2,3,25
376,Chimezie Metu\metuch01,C,24,SAC,60,20,1279,203,449,.452,57,186,.306,146,263,.555,.516,71,91,.780,34,301,335,60,51,32,61,93,534
377,Khris Middleton\middlkh01,SF,30,MIL,66,66,2141,452,1021,.443,162,434,.373,290,587,.494,.522,259,291,.890,41,315,356,358,76,18,190,160,1325
378,C.J. Miles\milescj01,SG,34,BOS,1,0,2,0,0,,0,0,,0,0,,,0,0,,0,0,0,0,0,0,0,1,0
379,Patty Mills\millspa02,PG,33,BRK,81,48,2346,324,794,.408,227,568,.400,97,226,.429,.551,48,59,.814,18,138,156,183,51,17,73,112,923
380,Paul Millsap\millspa01,PF,36,TOT,33,1,376,45,115,.391,8,35,.229,37,80,.463,.426,17,24,.708,41,73,114,29,10,13,19,67,115
380,Paul Millsap\millspa01,PF,36,BRK,24,0,270,32,85,.376,6,27,.222,26,58,.448,.412,12,17,.706,29,60,89,24,5,11,11,48,82
380,Paul Millsap\millspa01,PF,36,PHI,9,1,106,13,30,.433,2,8,.250,11,22,.500,.467,5,7,.714,12,13,25,5,5,2,8,19,33
381,Shake Milton\miltosh01,PG,25,PHI,55,6,1179,173,403,.429,43,133,.323,130,270,.481,.483,61,73,.836,30,112,142,139,28,17,44,99,450
382,Davion Mitchell\mitchda01,PG,23,SAC,75,19,2076,352,843,.418,101,320,.316,251,523,.480,.477,56,85,.659,33,133,166,313,55,24,114,141,861
383,Donovan Mitchell\mitchdo01,SG,25,UTA,67,67,2266,617,1376,.448,232,654,.355,385,722,.533,.533,267,313,.853,55,227,282,358,99,12,200,164,1733
384,Evan Mobley\mobleev01,PF,20,CLE,69,69,2331,422,830,.508,23,92,.250,399,738,.541,.522,167,252,.663,143,427,570,174,56,115,133,147,1034
385,Malik Monk\monkma01,SG,23,LAL,76,37,2139,391,826,.473,173,442,.391,218,384,.568,.578,93,117,.795,37,219,256,218,61,29,122,138,1048
386,Greg Monroe\monrogr01,C,31,TOT,14,0,195,32,57,.561,0,0,,32,57,.561,.561,12,23,.522,30,34,64,22,8,10,12,24,76
386,Greg Monroe\monrogr01,C,31,MIN,4,0,81,13,22,.591,0,0,,13,22,.591,.591,3,7,.429,6,18,24,16,4,6,7,9,29
386,Greg Monroe\monrogr01,C,31,WAS,2,0,18,4,8,.500,0,0,,4,8,.500,.500,0,0,,7,3,10,1,1,1,2,2,8
386,Greg Monroe\monrogr01,C,31,MIL,5,0,70,11,22,.500,0,0,,11,22,.500,.500,5,9,.556,11,10,21,2,3,2,3,7,27
386,Greg Monroe\monrogr01,C,31,UTA,3,0,26,4,5,.800,0,0,,4,5,.800,.800,4,7,.571,6,3,9,3,0,1,0,6,12
387,Moses Moody\moodymo01,SG,19,GSW,52,11,607,80,183,.437,40,110,.364,40,73,.548,.546,28,36,.778,17,63,80,23,7,10,13,43,228
388,Xavier Moon\moonxa01,SG,27,LAC,10,0,137,25,51,.490,5,14,.357,20,37,.541,.539,3,5,.600,2,12,14,24,7,3,6,9,58
389,Matt Mooney\moonema01,SG,24,NYK,1,0,2,0,1,.000,0,1,.000,0,0,,.000,0,0,,0,0,0,0,1,0,1,0,0
390,Ja Morant\moranja01,PG,22,MEM,57,57,1889,580,1177,.493,88,256,.344,492,921,.534,.530,316,415,.761,77,248,325,384,66,22,196,86,1564
391,Juwan Morgan\morgaju01,PF,24,TOT,2,0,31,2,3,.667,1,2,.500,1,1,1.000,.833,0,0,,2,2,4,1,0,0,0,3,5
391,Juwan Morgan\morgaju01,PF,24,TOR,1,0,27,2,3,.667,1,2,.500,1,1,1.000,.833,0,0,,2,2,4,1,0,0,0,3,5
391,Juwan Morgan\morgaju01,PF,24,BOS,1,0,4,0,0,,0,0,,0,0,,,0,0,,0,0,0,0,0,0,0,0,0
392,Jaylen Morris\morrija01,SG,26,SAS,3,0,16,0,6,.000,0,2,.000,0,4,.000,.000,2,4,.500,0,2,2,2,0,0,1,2,2
393,Marcus Morris\morrima03,PF,32,LAC,54,54,1564,300,691,.434,101,275,.367,199,416,.478,.507,129,148,.872,26,213,239,113,28,18,69,115,830
394,Markieff Morris\morrima02,PF,32,MIA,17,1,298,54,114,.474,13,39,.333,41,75,.547,.531,8,9,.889,17,28,45,23,6,1,20,33,129
395,Monte Morris\morrimo01,PG,26,DEN,75,74,2239,374,773,.484,124,314,.395,250,459,.545,.564,73,84,.869,27,199,226,333,56,14,78,92,945
396,Emmanuel Mudiay\mudiaem01,PG,25,SAC,2,0,11,0,2,.000,0,0,,0,2,.000,.000,3,4,.750,0,0,0,4,1,0,1,1,3
397,Mychal Mulder\muldemy01,PG,27,TOT,17,3,239,24,77,.312,17,54,.315,7,23,.304,.422,4,4,1.000,2,22,24,5,4,2,8,13,69
397,Mychal Mulder\muldemy01,PG,27,ORL,15,2,195,20,67,.299,13,46,.283,7,21,.333,.396,2,2,1.000,2,19,21,3,4,1,8,12,55
397,Mychal Mulder\muldemy01,PG,27,MIA,2,1,44,4,10,.400,4,8,.500,0,2,.000,.600,2,2,1.000,0,3,3,2,0,1,0,1,14
398,Ade Murkey\murkead01,SG,24,SAC,1,0,1,0,0,,0,0,,0,0,,,0,0,,0,0,0,0,0,0,0,0,0
399,Trey Murphy III\murphtr02,SF,21,NOP,62,1,864,109,277,.394,71,186,.382,38,91,.418,.522,45,51,.882,47,100,147,38,23,7,16,60,334
400,Dejounte Murray\murrade01,PG,25,SAS,68,68,2366,573,1241,.462,96,294,.327,477,947,.504,.500,196,247,.794,80,483,563,627,138,23,180,138,1438
401,Mike Muscala\muscami01,C,30,OKC,43,0,592,113,248,.456,70,163,.429,43,85,.506,.597,48,57,.842,21,108,129,22,18,26,14,58,344
402,Svi Mykhailiuk\mykhasv01,SF,24,TOR,56,5,716,91,234,.389,41,134,.306,50,100,.500,.476,32,37,.865,20,72,92,45,26,4,32,54,255
403,Abdel Nader\naderab01,SF,28,PHO,14,0,145,12,35,.343,4,14,.286,8,21,.381,.400,6,10,.600,4,23,27,7,8,4,11,20,34
404,Larry Nance Jr.\nancela02,PF,29,TOT,46,11,1040,129,247,.522,23,70,.329,106,177,.599,.569,40,57,.702,72,176,248,81,43,20,37,84,321
404,Larry Nance Jr.\nancela02,PF,29,POR,37,11,858,102,198,.515,19,62,.306,83,136,.610,.563,32,49,.653,58,151,209,73,38,13,27,67,255
404,Larry Nance Jr.\nancela02,PF,29,NOP,9,0,182,27,49,.551,4,8,.500,23,41,.561,.592,8,8,1.000,14,25,39,8,5,7,10,17,66
405,RJ Nembhard Jr.\nembhrj01,SG,22,CLE,14,0,63,6,18,.333,0,2,.000,6,16,.375,.333,3,4,.750,3,4,7,12,1,0,3,2,15
406,Aaron Nesmith\nesmiaa01,SF,22,BOS,52,3,574,72,182,.396,31,115,.270,41,67,.612,.481,21,26,.808,15,74,89,22,20,5,31,70,196
407,Raul Neto\netora01,PG,29,WAS,70,19,1372,204,441,.463,35,120,.292,169,321,.526,.502,83,108,.769,13,121,134,217,55,3,79,104,526
408,Malik Newman\newmama01,PG,24,CLE,1,0,8,3,5,.600,0,1,.000,3,4,.750,.600,2,2,1.000,0,1,1,1,0,0,1,0,8
409,Georges Niang\niangge01,PF,28,PHI,76,7,1736,246,563,.437,156,387,.403,90,176,.511,.575,52,59,.881,25,178,203,102,30,13,59,190,700
410,Daishen Nix\nixda01,SG,19,HOU,24,0,261,27,67,.403,7,26,.269,20,41,.488,.455,16,30,.533,7,26,33,40,15,0,26,21,77
411,Zeke Nnaji\nnajize01,PF,21,DEN,41,1,698,96,186,.516,37,80,.463,59,106,.557,.616,41,65,.631,56,91,147,17,16,13,23,79,270
412,Nerlens Noel\noelne01,C,27,NYK,25,11,562,32,60,.533,0,3,.000,32,57,.561,.533,21,30,.700,48,93,141,23,30,31,20,67,85
413,Jaylen Nowell\nowelja01,SG,22,MIN,62,1,975,196,413,.475,63,160,.394,133,253,.526,.551,72,92,.783,22,101,123,130,27,10,36,73,527
414,Frank Ntilikina\ntilila01,PG,23,DAL,58,5,685,89,223,.399,38,111,.342,51,112,.455,.484,24,25,.960,12,67,79,69,27,7,31,61,240
415,Jusuf Nurkić\nurkiju01,C,27,POR,56,56,1579,321,600,.535,15,56,.268,306,544,.563,.548,185,268,.690,167,452,619,157,62,34,143,189,842
416,David Nwaba\nwabada01,SF,29,HOU,46,4,609,85,176,.483,15,49,.306,70,127,.551,.526,48,67,.716,41,110,151,35,28,20,21,55,233
417,Jordan Nwora\nworajo01,SF,23,MIL,62,13,1185,186,462,.403,79,227,.348,107,235,.455,.488,36,43,.837,37,184,221,59,25,17,57,78,487
418,Royce O'Neale\onealro01,SF,28,UTA,77,77,2406,203,444,.457,119,306,.389,84,138,.609,.591,45,56,.804,64,304,368,191,86,32,79,183,570
419,Semi Ojeleye\ojelese01,PF,27,TOT,30,0,406,30,99,.303,15,50,.300,15,49,.306,.379,23,29,.793,27,47,74,9,7,6,9,30,98
419,Semi Ojeleye\ojelese01,PF,27,MIL,20,0,308,18,70,.257,11,41,.268,7,29,.241,.336,10,13,.769,25,33,58,5,5,5,5,26,57
419,Semi Ojeleye\ojelese01,PF,27,LAC,10,0,98,12,29,.414,4,9,.444,8,20,.400,.483,13,16,.813,2,14,16,4,2,1,4,4,41
420,Chuma Okeke\okekech01,PF,23,ORL,70,20,1749,216,575,.376,118,371,.318,98,204,.480,.478,55,65,.846,47,300,347,118,97,42,57,95,605
421,Josh Okogie\okogijo01,SG,23,MIN,49,6,516,42,104,.404,14,47,.298,28,57,.491,.471,35,51,.686,29,41,70,25,26,12,23,53,133
422,Onyeka Okongwu\okongon01,C,21,ATL,48,6,992,156,226,.690,0,0,,156,226,.690,.690,80,110,.727,115,168,283,53,31,60,44,149,392
423,Isaac Okoro\okorois01,SF,21,CLE,67,61,1981,207,431,.480,55,157,.350,152,274,.555,.544,119,155,.768,72,129,201,121,56,22,58,164,588
424,KZ Okpala\okpalkz01,PF,22,MIA,21,0,244,30,69,.435,9,26,.346,21,43,.488,.500,8,11,.727,11,30,41,14,4,7,5,25,77
425,Victor Oladipo\oladivi01,SG,29,MIA,8,1,173,35,73,.479,15,36,.417,20,37,.541,.582,14,19,.737,3,20,23,28,5,1,16,13,99
426,Cameron Oliver\oliveca01,SF,25,ATL,2,0,43,10,15,.667,1,3,.333,9,12,.750,.700,2,3,.667,2,4,6,3,1,1,0,5,23
427,Kelly Olynyk\olynyke01,C,30,DET,40,1,764,128,286,.448,40,119,.336,88,167,.527,.517,69,89,.775,54,123,177,111,31,19,58,100,365
428,Eugene Omoruyi\omorueu01,SF,24,DAL,4,0,18,2,5,.400,1,2,.500,1,3,.333,.500,2,4,.500,2,5,7,2,0,0,0,2,7
429,Miye Oni\onimi01,SG,24,UTA,16,0,44,2,9,.222,1,8,.125,1,1,1.000,.278,0,1,.000,1,6,7,5,0,0,1,7,5
430,Cedi Osman\osmande01,SF,26,CLE,66,3,1462,247,572,.432,128,359,.357,119,213,.559,.544,87,131,.664,25,121,146,135,52,10,67,127,709
431,Daniel Oturu\oturuda01,C,22,TOR,3,0,27,3,6,.500,0,1,.000,3,5,.600,.500,3,5,.600,1,4,5,0,0,2,0,1,9
432,Kelly Oubre Jr.\oubreke01,SF,26,CHO,76,13,1999,410,932,.440,191,553,.345,219,379,.578,.542,126,189,.667,79,223,302,84,77,31,67,189,1137
433,Jaysean Paige\paigeja01,PG,27,DET,1,0,7,0,3,.000,0,2,.000,0,1,.000,.000,0,0,,0,1,1,1,0,0,1,2,0
434,Trayvon Palmer\palmetr01,SG,27,DET,1,0,17,0,1,.000,0,0,,0,1,.000,.000,0,0,,0,2,2,0,0,0,1,2,0
435,Kevin Pangos\pangoke01,PG,29,CLE,24,3,166,15,46,.326,6,26,.231,9,20,.450,.391,3,4,.750,2,9,11,30,3,0,7,11,39
436,Jabari Parker\parkeja01,PF,26,BOS,12,0,112,18,38,.474,8,16,.500,10,22,.455,.579,9,9,1.000,5,23,28,6,4,1,8,13,53
437,Eric Paschall\pascher01,PF,25,UTA,58,3,736,114,235,.485,40,108,.370,74,127,.583,.570,66,86,.767,30,76,106,36,9,5,27,51,334
438,Chris Paul\paulch01,PG,36,PHO,65,65,2139,363,736,.493,63,199,.317,300,537,.559,.536,169,202,.837,22,261,283,702,121,20,153,134,958
439,Cameron Payne\payneca01,PG,27,PHO,58,12,1278,240,587,.409,71,211,.336,169,376,.449,.469,75,89,.843,24,151,175,282,40,17,103,119,626
440,Elfrid Payton\paytoel01,PG,27,PHO,50,1,549,67,175,.383,4,18,.222,63,157,.401,.394,12,32,.375,21,67,88,99,25,6,47,38,150
441,Gary Payton II\paytoga02,PG,29,GSW,71,16,1247,212,344,.616,43,120,.358,169,224,.754,.679,35,58,.603,72,175,247,64,96,22,40,131,502
442,Norvel Pelle\pelleno01,C,28,UTA,3,0,19,3,5,.600,0,0,,3,5,.600,.600,0,0,,3,3,6,0,0,1,2,1,6
443,Reggie Perry\perryre01,PF,21,TOT,10,1,187,40,79,.506,3,16,.188,37,63,.587,.525,9,15,.600,15,32,47,12,9,6,11,33,92
443,Reggie Perry\perryre01,PF,21,POR,9,1,177,39,78,.500,3,16,.188,36,62,.581,.519,9,15,.600,15,31,46,12,9,6,11,30,90
443,Reggie Perry\perryre01,PF,21,IND,1,0,10,1,1,1.000,0,0,,1,1,1.000,1.000,0,0,,0,1,1,0,0,0,0,3,2
444,Jamorko Pickett\pickeja01,PF,24,DET,13,0,176,18,50,.360,13,39,.333,5,11,.455,.490,1,2,.500,6,26,32,7,0,7,5,12,50
445,Theo Pinson\pinsoth01,SF,26,DAL,19,0,148,14,39,.359,10,30,.333,4,9,.444,.487,10,10,1.000,2,19,21,17,5,2,5,12,48
446,Mason Plumlee\plumlma01,C,31,CHO,73,73,1793,205,320,.641,0,2,.000,205,318,.645,.641,67,171,.392,176,389,565,226,61,52,100,224,477
447,Jakob Poeltl\poeltja01,C,26,SAS,68,67,1970,410,663,.618,1,1,1.000,409,662,.618,.619,94,190,.495,262,372,634,189,45,118,109,212,915
448,Aleksej Pokusevski\pokusal01,PF,20,OKC,61,12,1233,186,456,.408,57,197,.289,129,259,.498,.470,35,50,.700,73,245,318,131,39,38,94,88,464
449,Yves Pons\ponsyv01,SF,22,MEM,12,0,71,5,16,.313,3,9,.333,2,7,.286,.406,0,2,.000,5,7,12,1,1,4,1,6,13
450,Jordan Poole\poolejo01,SG,22,GSW,76,51,2283,474,1058,.448,211,580,.364,263,478,.550,.548,246,266,.925,34,226,260,304,60,23,187,206,1405
451,Kevin Porter Jr.\porteke02,PG,21,HOU,61,61,1907,335,808,.415,155,413,.375,180,395,.456,.511,124,193,.642,43,224,267,376,69,22,192,156,949
452,Michael Porter Jr.\portemi01,SF,23,DEN,9,9,265,37,103,.359,10,48,.208,27,55,.491,.408,5,9,.556,9,50,59,17,10,2,12,16,89
453,Otto Porter Jr.\porteot01,PF,28,GSW,63,15,1396,193,416,.464,80,216,.370,113,200,.565,.560,49,61,.803,86,276,362,94,68,29,37,83,515
454,Bobby Portis\portibo01,C,26,MIL,72,59,2028,417,871,.479,133,338,.393,284,533,.533,.555,85,113,.752,180,477,657,86,53,51,90,174,1052
455,Kristaps Porziņģis\porzikr01,PF,26,TOT,51,51,1481,352,767,.459,78,252,.310,274,515,.532,.510,248,286,.867,102,309,411,119,37,84,81,137,1030
455,Kristaps Porziņģis\porzikr01,PF,26,DAL,34,34,1002,229,508,.451,49,173,.283,180,335,.537,.499,147,170,.865,64,197,261,69,25,59,53,88,654
455,Kristaps Porziņģis\porzikr01,PF,26,WAS,17,17,479,123,259,.475,29,79,.367,94,180,.522,.531,101,116,.871,38,112,150,50,12,25,28,49,376
456,Micah Potter\pottemi01,C,23,DET,3,0,31,5,11,.455,0,2,.000,5,9,.556,.455,2,2,1.000,4,5,9,0,1,1,1,4,12
457,Dwight Powell\poweldw01,C,30,DAL,82,71,1798,269,401,.671,13,37,.351,256,364,.703,.687,166,212,.783,173,231,404,97,37,39,64,220,717
458,Myles Powell\powelmy01,PG,24,PHI,11,0,52,5,17,.294,1,6,.167,4,11,.364,.324,2,2,1.000,1,5,6,3,1,0,3,8,13
459,Norman Powell\powelno01,SF-SG,28,TOT,45,41,1458,279,605,.461,106,253,.419,173,352,.491,.549,189,233,.811,20,125,145,96,42,21,69,106,853
459,Norman Powell\powelno01,SF,28,POR,40,39,1333,247,542,.456,93,229,.406,154,313,.492,.542,159,198,.803,17,114,131,82,40,17,62,92,746
459,Norman Powell\powelno01,SG,28,LAC,5,2,125,32,63,.508,13,24,.542,19,39,.487,.611,30,35,.857,3,11,14,14,2,4,7,14,107
460,Joshua Primo\primojo01,SG,19,SAS,50,16,965,101,270,.374,42,137,.307,59,133,.444,.452,44,59,.746,32,81,113,81,20,23,57,79,288
461,Taurean Prince\princta02,PF,27,MIN,69,8,1177,177,390,.454,86,229,.376,91,161,.565,.564,62,82,.756,26,148,174,68,47,23,53,116,502
462,Payton Pritchard\pritcpa01,SG,24,BOS,71,2,1001,160,373,.429,101,245,.412,59,128,.461,.564,21,21,1.000,32,102,134,139,25,6,41,61,442
463,Trevelin Queen\queentr01,SG,24,HOU,10,0,74,15,33,.455,9,24,.375,6,9,.667,.591,4,4,1.000,7,9,16,4,5,1,7,6,43
464,Neemias Queta\quetane01,C,22,SAC,14,0,120,17,38,.447,0,0,,17,38,.447,.447,11,17,.647,14,17,31,6,1,8,6,18,45
465,Immanuel Quickley\quickim01,PG,22,NYK,78,3,1802,284,724,.392,137,396,.346,147,328,.448,.487,177,201,.881,31,216,247,275,54,3,99,167,882
466,Jahmi'us Ramsey\ramseja01,SG,20,SAC,19,0,134,24,58,.414,5,18,.278,19,40,.475,.457,7,14,.500,4,9,13,7,1,1,5,10,60
467,Julius Randle\randlju01,PF,27,NYK,72,72,2544,512,1246,.411,120,390,.308,392,856,.458,.459,303,401,.756,125,591,716,370,53,39,245,205,1447
468,Austin Reaves\reaveau01,SG,23,LAL,61,19,1418,146,318,.459,53,167,.317,93,151,.616,.542,99,118,.839,45,148,193,110,29,20,40,87,444
469,Cam Reddish\reddica01,SF,22,TOT,49,7,1012,165,408,.404,66,184,.359,99,224,.442,.485,101,112,.902,25,80,105,48,47,15,57,60,497
469,Cam Reddish\reddica01,SF,22,ATL,34,7,797,138,343,.402,58,153,.379,80,190,.421,.487,72,80,.900,20,64,84,38,35,11,44,45,406
469,Cam Reddish\reddica01,SF,22,NYK,15,0,215,27,65,.415,8,31,.258,19,34,.559,.477,29,32,.906,5,16,21,10,12,4,13,15,91
470,Davon Reed\reedda01,SG,26,DEN,48,5,668,81,161,.503,37,86,.430,44,75,.587,.618,10,15,.667,14,94,108,53,24,9,16,63,209
471,Paul Reed\reedpa01,C,22,PHI,38,2,302,54,96,.563,2,8,.250,52,88,.591,.573,6,14,.429,44,48,92,16,33,14,10,57,116
472,Naz Reid\reidna01,C,22,MIN,77,6,1215,233,476,.489,57,166,.343,176,310,.568,.549,114,149,.765,102,199,301,71,40,71,82,172,637
473,Nick Richards\richani01,C,24,CHO,50,5,367,60,90,.667,0,0,,60,90,.667,.667,30,43,.698,34,52,86,13,9,21,24,51,150
474,Josh Richardson\richajo01,SG,28,TOT,65,7,1600,234,534,.438,102,246,.415,132,288,.458,.534,96,108,.889,42,143,185,115,56,29,66,116,666
474,Josh Richardson\richajo01,SG,28,BOS,44,0,1087,152,343,.443,62,156,.397,90,187,.481,.534,61,71,.859,26,99,125,66,34,23,39,82,427
474,Josh Richardson\richajo01,SG,28,SAS,21,7,513,82,191,.429,40,90,.444,42,101,.416,.534,35,37,.946,16,44,60,49,22,6,27,34,239
475,Austin Rivers\riverau01,SG,29,DEN,67,18,1480,146,350,.417,79,231,.342,67,119,.563,.530,32,44,.727,19,95,114,90,51,6,54,121,403
476,Duncan Robinson\robindu01,SG,27,MIA,79,68,2043,290,726,.399,232,624,.372,58,102,.569,.559,51,61,.836,24,179,203,129,42,14,60,201,863
477,Justin Robinson\robinju01,PG,24,TOT,25,0,304,28,93,.301,18,61,.295,10,32,.313,.398,4,8,.500,4,17,21,32,9,1,17,27,78
477,Justin Robinson\robinju01,PG,24,MIL,17,0,198,18,57,.316,10,37,.270,8,20,.400,.404,2,2,1.000,2,11,13,21,8,0,11,17,48
477,Justin Robinson\robinju01,PG,24,SAC,3,0,15,1,8,.125,0,3,.000,1,5,.200,.125,0,0,,0,1,1,2,0,0,1,2,2
477,Justin Robinson\robinju01,PG,24,DET,5,0,91,9,28,.321,8,21,.381,1,7,.143,.464,2,6,.333,2,5,7,9,1,1,5,8,28
478,Mitchell Robinson\robinmi01,C,23,NYK,72,62,1848,261,343,.761,0,0,,261,343,.761,.761,88,181,.486,295,322,617,38,58,133,60,195,610
479,Jeremiah Robinson-Earl\robinje02,C,21,OKC,49,36,1087,134,324,.414,58,165,.352,76,159,.478,.503,40,54,.741,75,199,274,49,29,15,39,75,366
480,Isaiah Roby\robyis01,PF,23,OKC,45,28,948,166,323,.514,44,99,.444,122,224,.545,.582,78,116,.672,75,142,217,71,36,34,43,109,454
481,Rajon Rondo\rondora01,PG,35,TOT,39,1,697,68,176,.386,31,88,.352,37,88,.420,.474,19,26,.731,15,93,108,170,30,6,68,56,186
481,Rajon Rondo\rondora01,PG,35,LAL,18,0,289,23,71,.324,8,30,.267,15,41,.366,.380,1,2,.500,10,39,49,67,12,5,34,25,55
481,Rajon Rondo\rondora01,PG,35,CLE,21,1,408,45,105,.429,23,58,.397,22,47,.468,.538,18,24,.750,5,54,59,103,18,1,34,31,131
482,Derrick Rose\rosede01,PG,33,NYK,26,4,636,122,274,.445,37,92,.402,85,182,.467,.513,30,31,.968,21,57,78,103,22,12,39,15,311
483,Terrence Ross\rosste01,SG,30,ORL,63,0,1448,220,554,.397,77,264,.292,143,290,.493,.467,112,130,.862,20,141,161,116,28,12,75,68,629
484,Terry Rozier\roziete01,SG,27,CHO,73,73,2458,518,1167,.444,222,593,.374,296,574,.516,.539,150,176,.852,56,259,315,326,93,25,96,119,1408
485,Ricky Rubio\rubiori01,PG,31,CLE,34,8,970,149,411,.363,59,174,.339,90,237,.380,.434,88,103,.854,15,126,141,225,49,7,90,75,445
486,D'Angelo Russell\russeda01,PG,25,MIN,65,65,2077,401,975,.411,176,518,.340,225,457,.492,.502,198,240,.825,25,191,216,460,62,22,165,130,1176
487,Matt Ryan\ryanma01,SF,24,BOS,1,0,5,1,5,.200,1,5,.200,0,0,,.300,0,0,,0,0,0,0,1,0,0,0,3
488,Domantas Sabonis\sabondo01,C-PF,25,TOT,62,61,2136,443,773,.573,39,125,.312,404,648,.623,.598,246,332,.741,201,551,752,323,59,27,195,203,1171
488,Domantas Sabonis\sabondo01,C,25,IND,47,46,1632,331,571,.580,35,108,.324,296,463,.639,.610,191,258,.740,155,412,567,236,46,22,143,146,888
488,Domantas Sabonis\sabondo01,PF,25,SAC,15,15,504,112,202,.554,4,17,.235,108,185,.584,.564,55,74,.743,46,139,185,87,13,5,52,57,283
489,Olivier Sarr\sarrol01,C,22,OKC,22,2,421,58,101,.574,13,29,.448,45,72,.625,.639,24,29,.828,34,59,93,19,6,15,22,52,153
490,Tomáš Satoranský\satorto01,SG,30,TOT,55,13,906,72,191,.377,11,53,.208,61,138,.442,.406,43,54,.796,27,99,126,184,29,5,46,71,198
490,Tomáš Satoranský\satorto01,SG,30,NOP,32,3,481,32,107,.299,5,31,.161,27,76,.355,.322,19,25,.760,18,46,64,76,14,1,23,33,88
490,Tomáš Satoranský\satorto01,SG,30,SAS,1,0,9,0,0,,0,0,,0,0,,,3,4,.750,0,1,1,0,0,0,0,0,3
490,Tomáš Satoranský\satorto01,SG,30,WAS,22,10,416,40,84,.476,6,22,.273,34,62,.548,.512,21,25,.840,9,52,61,108,15,4,23,38,107
491,Jordan Schakel\schakjo01,SG,23,WAS,4,0,30,1,11,.091,1,6,.167,0,5,.000,.136,2,2,1.000,2,6,8,0,1,0,1,0,5
492,Admiral Schofield\schofad01,SF,24,ORL,38,1,469,54,129,.419,26,79,.329,28,50,.560,.519,12,15,.800,17,72,89,25,4,5,21,58,146
493,Dennis Schröder\schrode01,SG-PG,28,TOT,64,29,1837,312,724,.431,86,250,.344,226,474,.477,.490,157,184,.853,34,180,214,296,53,8,143,154,867
493,Dennis Schröder\schrode01,SG,28,BOS,49,25,1433,257,584,.440,67,192,.349,190,392,.485,.497,123,145,.848,28,136,164,208,41,5,104,116,704
493,Dennis Schröder\schrode01,PG,28,HOU,15,4,404,55,140,.393,19,58,.328,36,82,.439,.461,34,39,.872,6,44,50,88,12,3,39,38,163
494,Tre Scott\scotttr01,SF,25,CLE,2,0,11,3,6,.500,0,1,.000,3,5,.600,.500,0,0,,1,1,2,0,1,1,0,2,6
495,Jay Scrubb\scrubja01,SG,21,LAC,18,0,121,18,46,.391,6,21,.286,12,25,.480,.457,7,10,.700,2,14,16,8,4,3,7,9,49
496,Wayne Selden\seldewa01,SG,27,NYK,3,0,19,1,4,.250,1,2,.500,0,2,.000,.375,2,4,.500,0,1,1,1,0,0,0,1,5
497,Alperen Şengün\sengual01,C,19,HOU,72,13,1489,249,525,.474,29,117,.248,220,408,.539,.502,165,232,.711,138,255,393,185,59,68,145,214,692
498,Collin Sexton\sextoco01,SG,23,CLE,11,11,316,68,151,.450,11,45,.244,57,106,.538,.487,29,39,.744,13,23,36,23,10,0,31,25,176
499,Landry Shamet\shamela01,SG,24,PHO,69,14,1437,191,485,.394,123,334,.368,68,151,.450,.521,68,81,.840,16,110,126,108,28,9,41,92,573
500,Day'Ron Sharpe\sharpda01,PF,20,BRK,32,8,391,86,149,.577,2,7,.286,84,142,.592,.584,24,41,.585,81,79,160,17,10,15,30,60,198
501,Pascal Siakam\siakapa01,PF,27,TOR,68,68,2578,596,1207,.494,75,218,.344,521,989,.527,.525,284,379,.749,128,452,580,360,85,42,181,225,1551
502,Chris Silva\silvach01,PF,25,TOT,10,0,91,8,15,.533,0,0,,8,15,.533,.533,10,12,.833,13,23,36,7,0,1,8,20,26
502,Chris Silva\silvach01,PF,25,MIN,1,0,3,0,0,,0,0,,0,0,,,0,0,,0,1,1,0,0,0,0,0,0
502,Chris Silva\silvach01,PF,25,MIA,9,0,88,8,15,.533,0,0,,8,15,.533,.533,10,12,.833,13,22,35,7,0,1,8,20,26
503,Marko Simonovic\simonma01,C,22,CHI,9,0,35,4,15,.267,1,5,.200,3,10,.300,.300,8,11,.727,5,5,10,0,1,1,2,6,17
504,Anfernee Simons\simonan01,SG,22,POR,57,30,1681,353,797,.443,179,442,.405,174,355,.490,.555,103,116,.888,26,125,151,221,30,6,115,110,988
505,Zavier Simpson\simpsza01,PG,24,OKC,4,4,174,19,52,.365,1,8,.125,18,44,.409,.375,5,5,1.000,2,19,21,30,5,4,10,15,44
506,Jericho Sims\simsje01,PF,23,NYK,41,5,555,39,54,.722,0,0,,39,54,.722,.722,12,29,.414,61,108,169,21,11,22,20,66,90
507,Deividas Sirvydis\sirvyde01,SG,21,DET,3,0,27,1,10,.100,1,7,.143,0,3,.000,.150,0,0,,0,6,6,1,3,1,0,4,3
508,Javonte Smart\smartja01,PG,22,TOT,17,1,200,19,60,.317,8,27,.296,11,33,.333,.383,5,6,.833,5,19,24,16,6,3,11,12,51
508,Javonte Smart\smartja01,PG,22,MIL,13,1,160,11,43,.256,4,18,.222,7,25,.280,.302,5,6,.833,4,15,19,14,4,2,9,11,31
508,Javonte Smart\smartja01,PG,22,MIA,4,0,40,8,17,.471,4,9,.444,4,8,.500,.588,0,0,,1,4,5,2,2,1,2,1,20
509,Marcus Smart\smartma01,PG,27,BOS,71,71,2296,300,718,.418,119,360,.331,181,358,.506,.501,142,179,.793,42,228,270,417,119,18,159,160,861
510,Dennis Smith Jr.\smithde03,PG,24,POR,37,4,638,79,189,.418,6,27,.222,73,162,.451,.434,42,64,.656,20,68,88,132,45,12,51,52,206
511,Ish Smith\smithis01,PG,33,TOT,65,1,1126,185,430,.430,25,67,.373,160,363,.441,.459,15,24,.625,25,115,140,244,47,23,78,78,410
511,Ish Smith\smithis01,PG,33,CHO,37,1,511,73,185,.395,10,25,.400,63,160,.394,.422,12,19,.632,11,46,57,98,20,10,36,34,168
511,Ish Smith\smithis01,PG,33,WAS,28,0,615,112,245,.457,15,42,.357,97,203,.478,.488,3,5,.600,14,69,83,146,27,13,42,44,242
512,Jalen Smith\smithja04,PF,21,TOT,51,8,925,176,350,.503,40,122,.328,136,228,.596,.560,78,102,.765,101,206,307,24,15,41,42,96,470
512,Jalen Smith\smithja04,PF,21,PHO,29,4,382,63,137,.460,9,39,.231,54,98,.551,.493,40,52,.769,55,84,139,6,6,18,22,52,175
512,Jalen Smith\smithja04,PF,21,IND,22,4,543,113,213,.531,31,83,.373,82,130,.631,.603,38,50,.760,46,122,168,18,9,23,20,44,295
513,Xavier Sneed\sneedxa01,SF,24,TOT,9,0,39,2,10,.200,1,8,.125,1,2,.500,.250,0,0,,2,4,6,1,0,0,0,2,5
513,Xavier Sneed\sneedxa01,SF,24,MEM,2,0,8,0,2,.000,0,2,.000,0,0,,.000,0,0,,1,1,2,0,0,0,0,2,0
513,Xavier Sneed\sneedxa01,SF,24,UTA,7,0,31,2,8,.250,1,6,.167,1,2,.500,.313,0,0,,1,3,4,1,0,0,0,0,5
514,Tony Snell\snellto01,SG,30,TOT,53,12,823,69,171,.404,45,128,.352,24,43,.558,.535,4,4,1.000,16,87,103,28,16,9,19,70,187
514,Tony Snell\snellto01,SG,30,POR,38,10,546,36,97,.371,24,75,.320,12,22,.545,.495,3,3,1.000,11,61,72,20,8,7,11,44,99
514,Tony Snell\snellto01,SG,30,NOP,15,2,277,33,74,.446,21,53,.396,12,21,.571,.588,1,1,1.000,5,26,31,8,8,2,8,26,88
515,Jaden Springer\sprinja01,SG,19,PHI,2,0,6,1,1,1.000,0,0,,1,1,1.000,1.000,0,0,,1,1,2,0,0,2,1,0,2
516,Cassius Stanley\stanlca01,SG,22,DET,9,1,155,19,46,.413,4,17,.235,15,29,.517,.457,10,10,1.000,5,14,19,4,5,2,6,17,52
517,Nik Stauskas\stausni01,SG,28,TOT,8,0,39,5,14,.357,4,10,.400,1,4,.250,.500,4,6,.667,1,2,3,2,0,0,1,1,18
517,Nik Stauskas\stausni01,SG,28,MIA,2,0,24,3,8,.375,2,4,.500,1,4,.250,.500,3,4,.750,1,2,3,1,0,0,0,1,11
517,Nik Stauskas\stausni01,SG,28,BOS,6,0,15,2,6,.333,2,6,.333,0,0,,.500,1,2,.500,0,0,0,1,0,0,1,0,7
518,Lance Stephenson\stephla01,SG-SF,31,TOT,46,1,814,147,323,.455,27,90,.300,120,233,.515,.497,63,80,.788,12,115,127,165,24,4,72,96,384
518,Lance Stephenson\stephla01,SF,31,ATL,6,0,70,5,13,.385,0,3,.000,5,10,.500,.385,1,2,.500,1,14,15,11,0,0,4,8,11
518,Lance Stephenson\stephla01,SG,31,IND,40,1,744,142,310,.458,27,87,.310,115,223,.516,.502,62,78,.795,11,101,112,154,24,4,68,88,373
519,Lamar Stevens\stevela01,PF,24,CLE,63,13,1015,156,319,.489,18,65,.277,138,254,.543,.517,53,75,.707,47,117,164,44,31,18,41,106,383
520,Isaiah Stewart\stewais01,C,20,DET,71,71,1816,250,490,.510,15,46,.326,235,444,.529,.526,74,103,.718,226,391,617,82,22,78,85,211,589
521,Max Strus\strusma01,SF,25,MIA,68,16,1587,249,564,.441,181,442,.410,68,122,.557,.602,42,53,.792,24,178,202,92,28,16,57,116,721
522,Jalen Suggs\suggsja01,PG,20,ORL,48,45,1307,198,548,.361,42,196,.214,156,352,.443,.400,126,163,.773,26,145,171,209,59,19,143,142,564
523,Craig Sword\swordcr01,SG,28,WAS,3,0,19,3,4,.750,0,1,.000,3,3,1.000,.750,0,0,,0,0,0,1,4,0,1,7,6
524,Keifer Sykes\sykeske01,PG,28,IND,32,11,566,69,190,.363,27,90,.300,42,100,.420,.434,15,17,.882,8,37,45,62,12,4,33,51,180
525,Jae'Sean Tate\tateja01,SF,26,HOU,78,77,2056,363,729,.498,63,202,.312,300,527,.569,.541,130,184,.707,135,285,420,222,72,41,139,286,919
526,Jayson Tatum\tatumja01,SF,23,BOS,76,76,2731,708,1564,.453,230,651,.353,478,913,.524,.526,400,469,.853,85,524,609,334,75,49,217,174,2046
527,Terry Taylor\taylote01,SG,22,IND,33,7,714,135,220,.614,12,38,.316,123,182,.676,.641,36,51,.706,95,77,172,41,14,8,23,61,318
528,Garrett Temple\templga01,SG,35,NOP,59,16,1098,111,295,.376,59,185,.319,52,110,.473,.476,28,41,.683,29,114,143,74,43,23,42,81,309
529,Emanuel Terry\terryem01,PF,25,PHO,3,0,18,0,5,.000,0,0,,0,5,.000,.000,0,0,,8,7,15,2,1,0,5,4,0
530,Tyrell Terry\terryty01,PG,21,MEM,2,0,3,1,1,1.000,0,0,,1,1,1.000,1.000,0,0,,0,0,0,0,0,0,0,1,2
531,Jon Teske\teskejo01,C,24,MEM,3,0,8,0,1,.000,0,0,,0,1,.000,.000,0,2,.000,0,2,2,1,1,0,0,1,0
532,Daniel Theis\theisda01,C,29,TOT,47,27,977,151,291,.519,33,107,.308,118,184,.641,.576,49,72,.681,59,169,228,41,20,31,46,111,384
532,Daniel Theis\theisda01,C,29,HOU,26,21,584,84,179,.469,23,79,.291,61,100,.610,.534,27,40,.675,32,98,130,20,11,17,31,62,218
532,Daniel Theis\theisda01,C,29,BOS,21,6,393,67,112,.598,10,28,.357,57,84,.679,.643,22,32,.688,27,71,98,21,9,14,15,49,166
533,Brodric Thomas\thomabr01,SG,25,BOS,12,0,60,8,18,.444,2,9,.222,6,9,.667,.500,3,5,.600,2,8,10,11,1,1,6,7,21
534,Cam Thomas\thomaca02,SG,20,BRK,67,2,1176,218,503,.433,47,174,.270,171,329,.520,.480,87,105,.829,16,145,161,78,33,8,55,66,570
535,Isaiah Thomas\thomais02,PG,32,TOT,22,1,333,67,167,.401,28,83,.337,39,84,.464,.485,22,26,.846,4,25,29,34,7,5,15,34,184
535,Isaiah Thomas\thomais02,PG,32,LAL,4,1,101,12,39,.308,5,22,.227,7,17,.412,.372,8,11,.727,1,7,8,6,0,2,5,12,37
535,Isaiah Thomas\thomais02,PG,32,DAL,1,0,13,3,8,.375,0,3,.000,3,5,.600,.375,0,0,,0,0,0,4,0,0,0,0,6
535,Isaiah Thomas\thomais02,PG,32,CHO,17,0,219,52,120,.433,23,58,.397,29,62,.468,.529,14,15,.933,3,18,21,24,7,3,10,22,141
536,Matt Thomas\thomama02,SG,27,CHI,40,0,459,55,134,.410,35,91,.385,20,43,.465,.541,16,20,.800,3,47,50,20,8,3,8,18,161
537,Klay Thompson\thompkl01,SG,31,GSW,32,32,941,246,573,.429,114,296,.385,132,277,.477,.529,46,51,.902,15,110,125,88,16,17,43,54,652
538,Tristan Thompson\thomptr01,PF,30,TOT,57,6,897,141,267,.528,1,3,.333,140,264,.530,.530,61,116,.526,120,168,288,34,23,21,45,98,344
538,Tristan Thompson\thomptr01,PF,30,SAC,30,3,455,76,151,.503,1,1,1.000,75,150,.500,.507,32,60,.533,72,89,161,18,11,12,29,52,185
538,Tristan Thompson\thomptr01,PF,30,IND,4,0,66,13,24,.542,0,0,,13,24,.542,.542,3,8,.375,7,11,18,2,0,2,4,7,29
538,Tristan Thompson\thomptr01,PF,30,CHI,23,3,376,52,92,.565,0,2,.000,52,90,.578,.565,26,48,.542,41,68,109,14,12,7,12,39,130
539,JT Thor\thorjt01,PF,19,CHO,33,0,262,24,55,.436,7,27,.259,17,28,.607,.500,12,20,.600,11,32,43,19,8,11,10,26,67
540,Matisse Thybulle\thybuma01,SG,24,PHI,66,50,1685,150,300,.500,45,144,.313,105,156,.673,.575,34,43,.791,42,109,151,75,115,71,39,158,379
541,Killian Tillie\tilliki02,C,23,MEM,36,3,461,43,127,.339,27,86,.314,16,41,.390,.445,5,8,.625,21,39,60,22,23,15,13,58,118
542,Xavier Tillman Sr.\tillmxa01,PF,23,MEM,53,2,701,98,216,.454,10,49,.204,88,167,.527,.477,46,71,.648,66,95,161,62,49,15,34,63,252
543,Isaiah Todd\toddis01,PF,20,WAS,12,0,74,7,26,.269,4,16,.250,3,10,.300,.346,2,6,.333,3,9,12,4,4,2,4,4,20
544,Obi Toppin\toppiob01,PF,23,NYK,72,10,1230,251,473,.531,52,169,.308,199,304,.655,.586,94,124,.758,69,199,268,77,25,33,56,102,648
545,Juan Toscano-Anderson\toscaju01,SF,28,GSW,73,6,994,115,235,.489,28,87,.322,87,148,.588,.549,40,70,.571,28,148,176,127,48,17,68,115,298
546,Karl-Anthony Towns\townska01,C,26,MIN,74,74,2476,642,1214,.529,150,366,.410,492,848,.580,.591,384,467,.822,194,533,727,269,72,83,226,267,1818
547,Gary Trent Jr.\trentga02,SG,23,TOR,70,69,2448,450,1086,.414,209,545,.383,241,541,.445,.511,174,204,.853,26,165,191,141,122,19,73,144,1283
548,P.J. Tucker\tuckepj01,PF,36,MIA,71,70,1981,207,428,.484,80,193,.415,127,235,.540,.577,45,61,.738,100,287,387,149,58,15,66,161,539
549,Rayjon Tucker\tuckera01,SG,24,TOT,5,0,71,6,9,.667,4,5,.800,2,4,.500,.889,5,7,.714,3,5,8,10,4,0,1,5,21
549,Rayjon Tucker\tuckera01,SG,24,DEN,3,0,29,1,2,.500,1,2,.500,0,0,,.750,3,4,.750,1,3,4,4,1,0,0,3,6
549,Rayjon Tucker\tuckera01,SG,24,MIL,2,0,42,5,7,.714,3,3,1.000,2,4,.500,.929,2,3,.667,2,2,4,6,3,0,1,2,15
550,Myles Turner\turnemy01,C,25,IND,42,42,1235,200,393,.509,61,183,.333,139,210,.662,.587,79,105,.752,65,232,297,44,28,118,54,119,540
551,Jonas Valančiūnas\valanjo01,C,29,NOP,74,74,2240,510,938,.544,57,158,.361,453,780,.581,.574,237,289,.820,226,617,843,190,41,60,179,247,1314
552,Denzel Valentine\valende01,SG,28,TOT,24,0,222,25,66,.379,19,47,.404,6,19,.316,.523,0,0,,9,33,42,11,8,0,12,20,69
552,Denzel Valentine\valende01,SG,28,CLE,22,0,204,23,62,.371,18,44,.409,5,18,.278,.516,0,0,,9,29,38,11,7,0,10,17,64
552,Denzel Valentine\valende01,SG,28,UTA,2,0,18,2,4,.500,1,3,.333,1,1,1.000,.625,0,0,,0,4,4,0,1,0,2,3,5
553,Jarred Vanderbilt\vandeja01,PF,22,MIN,74,67,1880,212,361,.587,2,14,.143,210,347,.605,.590,86,131,.656,215,409,624,94,99,46,73,181,512
554,Fred VanVleet\vanvlfr01,PG,27,TOR,65,65,2462,442,1097,.403,242,642,.377,200,455,.440,.513,194,222,.874,44,245,289,434,111,35,170,162,1320
555,Devin Vassell\vassede01,SF,21,SAS,71,32,1937,326,764,.427,137,380,.361,189,384,.492,.516,83,99,.838,44,262,306,136,76,41,58,143,872
556,Gabe Vincent\vincega01,PG,25,MIA,68,27,1589,214,513,.417,119,323,.368,95,190,.500,.533,44,54,.815,22,104,126,210,62,12,98,158,591
557,Nikola Vučević\vucevni01,C,31,CHI,73,73,2418,546,1154,.473,104,331,.314,442,823,.537,.518,92,121,.760,142,662,804,236,70,71,136,181,1288
558,Dean Wade\wadede01,PF,25,CLE,51,28,980,99,217,.456,51,142,.359,48,75,.640,.574,20,30,.667,31,119,150,52,29,7,16,88,269
559,Franz Wagner\wagnefr01,SF,20,ORL,79,79,2429,456,975,.468,96,271,.354,360,704,.511,.517,189,219,.863,84,272,356,231,68,34,119,164,1197
560,Moritz Wagner\wagnemo01,C,24,ORL,63,3,960,197,396,.497,66,201,.328,131,195,.672,.581,104,129,.806,42,190,232,87,20,13,56,123,564
561,Ish Wainright\wainris01,PF,27,PHO,45,0,359,41,104,.394,19,59,.322,22,45,.489,.486,7,12,.583,27,27,54,15,20,6,13,49,108
562,Kemba Walker\walkeke02,PG,31,NYK,37,37,948,149,370,.403,73,199,.367,76,171,.444,.501,60,71,.845,14,97,111,131,26,7,48,37,431
563,Lonnie Walker IV\walkelo01,SG,23,SAS,70,6,1612,311,764,.407,111,353,.314,200,411,.487,.480,116,148,.784,18,163,181,152,44,19,71,98,849
564,M.J. Walker\walkemj01,SG,23,PHO,2,0,8,0,4,.000,0,2,.000,0,2,.000,.000,0,0,,0,1,1,1,2,0,0,1,0
565,Tyrone Wallace\wallaty01,SG,27,NOP,6,0,75,7,20,.350,2,8,.250,5,12,.417,.400,1,5,.200,0,8,8,1,3,1,2,7,17
566,Derrick Walton\waltode01,PG,26,DET,3,3,108,6,26,.231,3,13,.231,3,13,.231,.288,4,4,1.000,2,8,10,21,7,4,11,8,19
567,Brad Wanamaker\wanambr01,PG,32,TOT,23,2,320,28,77,.364,4,17,.235,24,60,.400,.390,23,25,.920,6,33,39,55,7,6,23,45,83
567,Brad Wanamaker\wanambr01,PG,32,IND,22,1,293,26,72,.361,4,17,.235,22,55,.400,.389,20,22,.909,6,29,35,48,5,6,23,42,76
567,Brad Wanamaker\wanambr01,PG,32,WAS,1,1,27,2,5,.400,0,0,,2,5,.400,.400,3,3,1.000,0,4,4,7,2,0,0,3,7
568,Duane Washington Jr.\washidu02,PG,21,IND,48,7,968,173,427,.405,81,215,.377,92,212,.434,.500,46,61,.754,4,79,83,85,26,3,57,66,473
569,P.J. Washington\washipj01,PF,23,CHO,65,28,1768,250,532,.470,110,301,.365,140,231,.606,.573,58,81,.716,82,255,337,147,57,61,82,152,668
570,Yuta Watanabe\watanyu01,SF,27,TOR,38,4,445,56,138,.406,27,79,.342,29,59,.492,.504,24,40,.600,18,74,92,21,11,16,19,38,163
571,Lindy Waters III\waterli01,SG,24,OKC,25,1,465,71,175,.406,53,146,.363,18,29,.621,.557,4,5,.800,6,67,73,24,19,8,11,31,199
572,Tremont Waters\watertr01,PG,24,TOT,3,0,50,4,14,.286,2,9,.222,2,5,.400,.357,0,0,,0,4,4,7,5,0,4,4,10
572,Tremont Waters\watertr01,PG,24,TOR,2,0,42,3,12,.250,2,9,.222,1,3,.333,.333,0,0,,0,4,4,7,4,0,4,2,8
572,Tremont Waters\watertr01,PG,24,WAS,1,0,8,1,2,.500,0,0,,1,2,.500,.500,0,0,,0,0,0,0,1,0,0,2,2
573,Trendon Watford\watfotr01,SF,21,POR,48,10,869,142,267,.532,9,38,.237,133,229,.581,.549,71,94,.755,57,142,199,81,25,28,44,116,364
574,Paul Watson\watsopa01,SF,27,OKC,9,3,156,12,35,.343,6,26,.231,6,9,.667,.429,1,2,.500,3,24,27,8,3,3,4,10,31
575,Quinndary Weatherspoon\weathqu01,SG,25,GSW,11,0,73,12,21,.571,1,5,.200,11,16,.688,.595,5,5,1.000,2,12,14,5,1,1,3,15,30
576,Russell Westbrook\westbru01,PG,33,LAL,78,78,2678,548,1233,.444,79,265,.298,469,968,.485,.476,266,399,.667,110,470,580,550,75,20,295,235,1441
577,Coby White\whiteco01,PG,21,CHI,61,17,1675,279,644,.433,136,353,.385,143,291,.491,.539,78,91,.857,17,165,182,176,29,11,70,137,772
578,Derrick White\whitede01,SG,27,TOT,75,52,2199,337,800,.421,115,369,.312,222,431,.515,.493,203,235,.864,38,223,261,366,64,58,119,172,992
578,Derrick White\whitede01,SG,27,SAS,49,48,1486,243,570,.426,81,258,.314,162,312,.519,.497,139,160,.869,25,148,173,274,49,42,87,116,706
578,Derrick White\whitede01,SG,27,BOS,26,4,713,94,230,.409,34,111,.306,60,119,.504,.483,64,75,.853,13,75,88,92,15,16,32,56,286
579,Hassan Whiteside\whiteha01,C,32,UTA,65,8,1162,215,330,.652,0,0,,215,330,.652,.652,104,167,.623,166,328,494,26,22,103,53,179,534
580,Joe Wieskamp\wieskjo01,SG,22,SAS,29,0,205,20,56,.357,14,43,.326,6,13,.462,.482,7,13,.538,4,10,14,9,4,3,2,14,61
581,Aaron Wiggins\wiggiaa01,SG,23,OKC,50,35,1209,156,337,.463,42,138,.304,114,199,.573,.525,62,85,.729,51,127,178,68,30,10,54,93,416
582,Andrew Wiggins\wiggian01,SF,26,GSW,73,73,2329,475,1019,.466,157,399,.393,318,620,.513,.543,149,235,.634,85,240,325,161,76,51,111,158,1256
583,Lindell Wigginton\wiggili01,PG,23,MIL,19,0,199,26,61,.426,9,26,.346,17,35,.486,.500,19,35,.543,3,22,25,23,5,1,12,17,80
584,Brandon Williams\willibr03,PG,22,POR,24,16,640,105,282,.372,31,106,.292,74,176,.420,.427,68,97,.701,19,55,74,94,24,10,58,52,309
585,Grant Williams\willigr01,PF,23,BOS,77,21,1875,205,432,.475,106,258,.411,99,174,.569,.597,86,95,.905,64,210,274,78,38,57,62,186,602
586,Kenrich Williams\willike04,SF,27,OKC,49,0,1072,146,317,.461,41,121,.339,105,196,.536,.525,30,55,.545,75,145,220,108,44,10,46,81,363
587,Lou Williams\willilo02,PG,35,ATL,56,0,799,125,320,.391,37,102,.363,88,218,.404,.448,67,78,.859,16,71,87,105,28,3,43,48,354
588,Patrick Williams\willipa01,PF,20,CHI,17,9,422,54,102,.529,15,29,.517,39,73,.534,.603,30,41,.732,17,52,69,15,9,9,16,28,153
589,Robert Williams\williro04,C,24,BOS,61,61,1804,271,368,.736,0,1,.000,271,367,.738,.736,65,90,.722,238,350,588,121,56,134,63,137,607
590,Ziaire Williams\willizi02,SF,20,MEM,62,31,1346,191,424,.450,76,242,.314,115,182,.632,.540,43,55,.782,26,103,129,65,35,12,41,113,501
591,D.J. Wilson\wilsodj01,PF,25,TOR,4,1,54,11,15,.733,0,2,.000,11,13,.846,.733,8,10,.800,1,15,16,5,5,1,2,6,30
592,Dylan Windler\windldy01,SF,25,CLE,50,0,459,37,98,.378,21,70,.300,16,28,.571,.485,15,18,.833,21,68,89,34,14,3,16,47,110
593,Justise Winslow\winslju01,SF,25,TOT,48,11,774,110,257,.428,15,66,.227,95,191,.497,.457,39,66,.591,50,152,202,84,35,25,49,67,274
593,Justise Winslow\winslju01,SF,25,LAC,37,1,479,63,141,.447,5,29,.172,58,112,.518,.465,25,41,.610,30,103,133,52,21,18,37,46,156
593,Justise Winslow\winslju01,SF,25,POR,11,10,295,47,116,.405,10,37,.270,37,79,.468,.448,14,25,.560,20,49,69,32,14,7,12,21,118
594,Cassius Winston\winstca01,PG,23,WAS,7,0,39,4,11,.364,2,6,.333,2,5,.400,.455,4,4,1.000,0,1,1,7,0,0,3,9,14
595,Christian Wood\woodch01,C,26,HOU,68,67,2094,440,878,.501,131,336,.390,309,542,.570,.576,207,332,.623,110,576,686,155,54,65,126,171,1218
596,Robert Woodard II\woodaro01,SF,22,SAC,12,0,42,2,16,.125,1,4,.250,1,12,.083,.156,2,2,1.000,5,6,11,3,1,1,1,3,7
597,Delon Wright\wrighde01,SG,29,ATL,77,8,1452,122,269,.454,44,116,.379,78,153,.510,.535,54,63,.857,50,170,220,188,93,19,45,56,342
598,McKinley Wright IV\wrighmc01,PG,23,MIN,5,0,19,2,3,.667,1,2,.500,1,1,1.000,.833,0,0,,0,0,0,3,0,0,1,1,5
599,Moses Wright\wrighmo01,PF,23,TOT,4,0,14,1,4,.250,0,1,.000,1,3,.333,.250,3,3,1.000,1,2,3,2,0,1,0,0,5
599,Moses Wright\wrighmo01,PF,23,LAC,1,0,1,0,0,,0,0,,0,0,,,0,0,,0,0,0,1,0,0,0,0,0
599,Moses Wright\wrighmo01,PF,23,DAL,3,0,13,1,4,.250,0,1,.000,1,3,.333,.250,3,3,1.000,1,2,3,1,0,1,0,0,5
600,Gabe York\yorkga01,SG,28,IND,2,0,21,2,7,.286,1,6,.167,1,1,1.000,.357,3,5,.600,0,2,2,4,2,1,1,4,8
601,Thaddeus Young\youngth01,PF,33,TOT,52,1,845,141,272,.518,17,48,.354,124,224,.554,.550,23,49,.469,80,128,208,104,54,18,52,81,322
601,Thaddeus Young\youngth01,PF,33,SAS,26,1,370,74,128,.578,0,5,.000,74,123,.602,.578,10,22,.455,40,53,93,59,23,7,30,38,158
601,Thaddeus Young\youngth01,PF,33,TOR,26,0,475,67,144,.465,17,43,.395,50,101,.495,.524,13,27,.481,40,75,115,45,31,11,22,43,164
602,Trae Young\youngtr01,PG,23,ATL,76,76,2652,711,1544,.460,233,610,.382,478,934,.512,.536,500,553,.904,50,234,284,737,72,7,303,128,2155
603,Omer Yurtseven\yurtsom01,C,23,MIA,56,12,706,130,247,.526,1,11,.091,129,236,.547,.528,38,61,.623,85,209,294,49,17,20,41,84,299
604,Cody Zeller\zelleco01,C,29,POR,27,0,355,51,90,.567,0,4,.000,51,86,.593,.567,38,49,.776,50,75,125,22,8,6,19,56,140
605,Ivica Zubac\zubaciv01,C,24,LAC,76,76,1852,310,495,.626,0,0,,310,495,.626,.626,165,227,.727,217,427,644,120,36,77,114,203,785